node_costs,computation_time_ms,instance,selected_nodes_count,total_nodes,path_length,algorithm,objective_value,base_algorithm
48670,17,TSPA,100,200,22843,GreedyCycle2Regret_w1_1_start0,71513,GreedyCycle2Regret_w1_1
48478,16,TSPA,100,200,23455,GreedyCycle2Regret_w1_1_start1,71933,GreedyCycle2Regret_w1_1
48326,21,TSPA,100,200,23579,GreedyCycle2Regret_w1_1_start2,71905,GreedyCycle2Regret_w1_1
48404,14,TSPA,100,200,23409,GreedyCycle2Regret_w1_1_start3,71813,GreedyCycle2Regret_w1_1
48329,4,TSPA,100,200,23606,GreedyCycle2Regret_w1_1_start4,71935,GreedyCycle2Regret_w1_1
48369,5,TSPA,100,200,23388,GreedyCycle2Regret_w1_1_start5,71757,GreedyCycle2Regret_w1_1
49274,3,TSPA,100,200,23177,GreedyCycle2Regret_w1_1_start6,72451,GreedyCycle2Regret_w1_1
48631,4,TSPA,100,200,23658,GreedyCycle2Regret_w1_1_start7,72289,GreedyCycle2Regret_w1_1
48784,4,TSPA,100,200,23063,GreedyCycle2Regret_w1_1_start8,71847,GreedyCycle2Regret_w1_1
48326,4,TSPA,100,200,23197,GreedyCycle2Regret_w1_1_start9,71523,GreedyCycle2Regret_w1_1
47835,3,TSPA,100,200,24052,GreedyCycle2Regret_w1_1_start10,71887,GreedyCycle2Regret_w1_1
49157,4,TSPA,100,200,23796,GreedyCycle2Regret_w1_1_start11,72953,GreedyCycle2Regret_w1_1
49156,4,TSPA,100,200,24260,GreedyCycle2Regret_w1_1_start12,73416,GreedyCycle2Regret_w1_1
49234,4,TSPA,100,200,23520,GreedyCycle2Regret_w1_1_start13,72754,GreedyCycle2Regret_w1_1
48326,4,TSPA,100,200,23197,GreedyCycle2Regret_w1_1_start14,71523,GreedyCycle2Regret_w1_1
48286,4,TSPA,100,200,23316,GreedyCycle2Regret_w1_1_start15,71602,GreedyCycle2Regret_w1_1
48326,4,TSPA,100,200,23691,GreedyCycle2Regret_w1_1_start16,72017,GreedyCycle2Regret_w1_1
49546,4,TSPA,100,200,23392,GreedyCycle2Regret_w1_1_start17,72938,GreedyCycle2Regret_w1_1
48369,4,TSPA,100,200,23423,GreedyCycle2Regret_w1_1_start18,71792,GreedyCycle2Regret_w1_1
48954,4,TSPA,100,200,23941,GreedyCycle2Regret_w1_1_start19,72895,GreedyCycle2Regret_w1_1
48964,4,TSPA,100,200,23430,GreedyCycle2Regret_w1_1_start20,72394,GreedyCycle2Regret_w1_1
48169,4,TSPA,100,200,23819,GreedyCycle2Regret_w1_1_start21,71988,GreedyCycle2Regret_w1_1
48496,5,TSPA,100,200,23472,GreedyCycle2Regret_w1_1_start22,71968,GreedyCycle2Regret_w1_1
48127,6,TSPA,100,200,22981,GreedyCycle2Regret_w1_1_start23,71108,GreedyCycle2Regret_w1_1
48947,6,TSPA,100,200,23484,GreedyCycle2Regret_w1_1_start24,72431,GreedyCycle2Regret_w1_1
48326,7,TSPA,100,200,23579,GreedyCycle2Regret_w1_1_start25,71905,GreedyCycle2Regret_w1_1
48478,7,TSPA,100,200,23455,GreedyCycle2Regret_w1_1_start26,71933,GreedyCycle2Regret_w1_1
48369,6,TSPA,100,200,23343,GreedyCycle2Regret_w1_1_start27,71712,GreedyCycle2Regret_w1_1
49030,6,TSPA,100,200,23471,GreedyCycle2Regret_w1_1_start28,72501,GreedyCycle2Regret_w1_1
48897,6,TSPA,100,200,23401,GreedyCycle2Regret_w1_1_start29,72298,GreedyCycle2Regret_w1_1
48525,6,TSPA,100,200,23799,GreedyCycle2Regret_w1_1_start30,72324,GreedyCycle2Regret_w1_1
48326,6,TSPA,100,200,23691,GreedyCycle2Regret_w1_1_start31,72017,GreedyCycle2Regret_w1_1
48856,6,TSPA,100,200,23295,GreedyCycle2Regret_w1_1_start32,72151,GreedyCycle2Regret_w1_1
49250,4,TSPA,100,200,23015,GreedyCycle2Regret_w1_1_start33,72265,GreedyCycle2Regret_w1_1
47895,4,TSPA,100,200,23490,GreedyCycle2Regret_w1_1_start34,71385,GreedyCycle2Regret_w1_1
48406,4,TSPA,100,200,23860,GreedyCycle2Regret_w1_1_start35,72266,GreedyCycle2Regret_w1_1
49090,4,TSPA,100,200,23372,GreedyCycle2Regret_w1_1_start36,72462,GreedyCycle2Regret_w1_1
48664,5,TSPA,100,200,23015,GreedyCycle2Regret_w1_1_start37,71679,GreedyCycle2Regret_w1_1
48994,5,TSPA,100,200,23535,GreedyCycle2Regret_w1_1_start38,72529,GreedyCycle2Regret_w1_1
48461,4,TSPA,100,200,23264,GreedyCycle2Regret_w1_1_start39,71725,GreedyCycle2Regret_w1_1
48326,4,TSPA,100,200,23197,GreedyCycle2Regret_w1_1_start40,71523,GreedyCycle2Regret_w1_1
47895,4,TSPA,100,200,23788,GreedyCycle2Regret_w1_1_start41,71683,GreedyCycle2Regret_w1_1
47895,4,TSPA,100,200,23788,GreedyCycle2Regret_w1_1_start42,71683,GreedyCycle2Regret_w1_1
48422,4,TSPA,100,200,23661,GreedyCycle2Regret_w1_1_start43,72083,GreedyCycle2Regret_w1_1
48326,4,TSPA,100,200,23579,GreedyCycle2Regret_w1_1_start44,71905,GreedyCycle2Regret_w1_1
49333,4,TSPA,100,200,23748,GreedyCycle2Regret_w1_1_start45,73081,GreedyCycle2Regret_w1_1
48369,3,TSPA,100,200,23578,GreedyCycle2Regret_w1_1_start46,71947,GreedyCycle2Regret_w1_1
48654,5,TSPA,100,200,23594,GreedyCycle2Regret_w1_1_start47,72248,GreedyCycle2Regret_w1_1
48486,3,TSPA,100,200,23801,GreedyCycle2Regret_w1_1_start48,72287,GreedyCycle2Regret_w1_1
48326,4,TSPA,100,200,23197,GreedyCycle2Regret_w1_1_start49,71523,GreedyCycle2Regret_w1_1
49342,4,TSPA,100,200,23643,GreedyCycle2Regret_w1_1_start50,72985,GreedyCycle2Regret_w1_1
48484,4,TSPA,100,200,23456,GreedyCycle2Regret_w1_1_start51,71940,GreedyCycle2Regret_w1_1
48326,4,TSPA,100,200,23264,GreedyCycle2Regret_w1_1_start52,71590,GreedyCycle2Regret_w1_1
48346,3,TSPA,100,200,23374,GreedyCycle2Regret_w1_1_start53,71720,GreedyCycle2Regret_w1_1
48403,3,TSPA,100,200,23852,GreedyCycle2Regret_w1_1_start54,72255,GreedyCycle2Regret_w1_1
48326,3,TSPA,100,200,23361,GreedyCycle2Regret_w1_1_start55,71687,GreedyCycle2Regret_w1_1
48326,3,TSPA,100,200,23691,GreedyCycle2Regret_w1_1_start56,72017,GreedyCycle2Regret_w1_1
48326,4,TSPA,100,200,23378,GreedyCycle2Regret_w1_1_start57,71704,GreedyCycle2Regret_w1_1
48438,4,TSPA,100,200,24192,GreedyCycle2Regret_w1_1_start58,72630,GreedyCycle2Regret_w1_1
48369,4,TSPA,100,200,23578,GreedyCycle2Regret_w1_1_start59,71947,GreedyCycle2Regret_w1_1
49270,4,TSPA,100,200,23521,GreedyCycle2Regret_w1_1_start60,72791,GreedyCycle2Regret_w1_1
49390,4,TSPA,100,200,23085,GreedyCycle2Regret_w1_1_start61,72475,GreedyCycle2Regret_w1_1
48326,4,TSPA,100,200,23197,GreedyCycle2Regret_w1_1_start62,71523,GreedyCycle2Regret_w1_1
48570,4,TSPA,100,200,23180,GreedyCycle2Regret_w1_1_start63,71750,GreedyCycle2Regret_w1_1
49197,4,TSPA,100,200,23475,GreedyCycle2Regret_w1_1_start64,72672,GreedyCycle2Regret_w1_1
48422,3,TSPA,100,200,23605,GreedyCycle2Regret_w1_1_start65,72027,GreedyCycle2Regret_w1_1
49416,5,TSPA,100,200,23346,GreedyCycle2Regret_w1_1_start66,72762,GreedyCycle2Regret_w1_1
49281,4,TSPA,100,200,23364,GreedyCycle2Regret_w1_1_start67,72645,GreedyCycle2Regret_w1_1
47895,3,TSPA,100,200,23490,GreedyCycle2Regret_w1_1_start68,71385,GreedyCycle2Regret_w1_1
48837,4,TSPA,100,200,23381,GreedyCycle2Regret_w1_1_start69,72218,GreedyCycle2Regret_w1_1
48570,4,TSPA,100,200,23180,GreedyCycle2Regret_w1_1_start70,71750,GreedyCycle2Regret_w1_1
48528,4,TSPA,100,200,23636,GreedyCycle2Regret_w1_1_start71,72164,GreedyCycle2Regret_w1_1
48850,4,TSPA,100,200,23602,GreedyCycle2Regret_w1_1_start72,72452,GreedyCycle2Regret_w1_1
48902,4,TSPA,100,200,23554,GreedyCycle2Regret_w1_1_start73,72456,GreedyCycle2Regret_w1_1
49216,3,TSPA,100,200,23273,GreedyCycle2Regret_w1_1_start74,72489,GreedyCycle2Regret_w1_1
48528,4,TSPA,100,200,23817,GreedyCycle2Regret_w1_1_start75,72345,GreedyCycle2Regret_w1_1
49584,4,TSPA,100,200,23737,GreedyCycle2Regret_w1_1_start76,73321,GreedyCycle2Regret_w1_1
48817,4,TSPA,100,200,23752,GreedyCycle2Regret_w1_1_start77,72569,GreedyCycle2Regret_w1_1
48326,4,TSPA,100,200,23579,GreedyCycle2Regret_w1_1_start78,71905,GreedyCycle2Regret_w1_1
48621,4,TSPA,100,200,23680,GreedyCycle2Regret_w1_1_start79,72301,GreedyCycle2Regret_w1_1
48484,4,TSPA,100,200,23456,GreedyCycle2Regret_w1_1_start80,71940,GreedyCycle2Regret_w1_1
48326,4,TSPA,100,200,23304,GreedyCycle2Regret_w1_1_start81,71630,GreedyCycle2Regret_w1_1
48528,4,TSPA,100,200,23507,GreedyCycle2Regret_w1_1_start82,72035,GreedyCycle2Regret_w1_1
49419,4,TSPA,100,200,22842,GreedyCycle2Regret_w1_1_start83,72261,GreedyCycle2Regret_w1_1
48406,3,TSPA,100,200,23860,GreedyCycle2Regret_w1_1_start84,72266,GreedyCycle2Regret_w1_1
49013,4,TSPA,100,200,23540,GreedyCycle2Regret_w1_1_start85,72553,GreedyCycle2Regret_w1_1
48478,4,TSPA,100,200,23455,GreedyCycle2Regret_w1_1_start86,71933,GreedyCycle2Regret_w1_1
49389,4,TSPA,100,200,23746,GreedyCycle2Regret_w1_1_start87,73135,GreedyCycle2Regret_w1_1
49261,4,TSPA,100,200,23626,GreedyCycle2Regret_w1_1_start88,72887,GreedyCycle2Regret_w1_1
48466,4,TSPA,100,200,22742,GreedyCycle2Regret_w1_1_start89,71208,GreedyCycle2Regret_w1_1
48326,4,TSPA,100,200,23347,GreedyCycle2Regret_w1_1_start90,71673,GreedyCycle2Regret_w1_1
48957,4,TSPA,100,200,23947,GreedyCycle2Regret_w1_1_start91,72904,GreedyCycle2Regret_w1_1
48326,3,TSPA,100,200,23378,GreedyCycle2Regret_w1_1_start92,71704,GreedyCycle2Regret_w1_1
48422,4,TSPA,100,200,23286,GreedyCycle2Regret_w1_1_start93,71708,GreedyCycle2Regret_w1_1
48570,4,TSPA,100,200,23180,GreedyCycle2Regret_w1_1_start94,71750,GreedyCycle2Regret_w1_1
48805,4,TSPA,100,200,23305,GreedyCycle2Regret_w1_1_start95,72110,GreedyCycle2Regret_w1_1
48676,4,TSPA,100,200,23028,GreedyCycle2Regret_w1_1_start96,71704,GreedyCycle2Regret_w1_1
48478,4,TSPA,100,200,23455,GreedyCycle2Regret_w1_1_start97,71933,GreedyCycle2Regret_w1_1
49339,4,TSPA,100,200,23434,GreedyCycle2Regret_w1_1_start98,72773,GreedyCycle2Regret_w1_1
49147,4,TSPA,100,200,23520,GreedyCycle2Regret_w1_1_start99,72667,GreedyCycle2Regret_w1_1
48570,4,TSPA,100,200,23180,GreedyCycle2Regret_w1_1_start100,71750,GreedyCycle2Regret_w1_1
48478,4,TSPA,100,200,23455,GreedyCycle2Regret_w1_1_start101,71933,GreedyCycle2Regret_w1_1
48326,4,TSPA,100,200,23197,GreedyCycle2Regret_w1_1_start102,71523,GreedyCycle2Regret_w1_1
48362,4,TSPA,100,200,23235,GreedyCycle2Regret_w1_1_start103,71597,GreedyCycle2Regret_w1_1
49182,3,TSPA,100,200,23928,GreedyCycle2Regret_w1_1_start104,73110,GreedyCycle2Regret_w1_1
48849,4,TSPA,100,200,23604,GreedyCycle2Regret_w1_1_start105,72453,GreedyCycle2Regret_w1_1
48326,4,TSPA,100,200,23197,GreedyCycle2Regret_w1_1_start106,71523,GreedyCycle2Regret_w1_1
49426,4,TSPA,100,200,23519,GreedyCycle2Regret_w1_1_start107,72945,GreedyCycle2Regret_w1_1
48837,3,TSPA,100,200,23381,GreedyCycle2Regret_w1_1_start108,72218,GreedyCycle2Regret_w1_1
48668,4,TSPA,100,200,23436,GreedyCycle2Regret_w1_1_start109,72104,GreedyCycle2Regret_w1_1
48974,4,TSPA,100,200,23584,GreedyCycle2Regret_w1_1_start110,72558,GreedyCycle2Regret_w1_1
49286,4,TSPA,100,200,23241,GreedyCycle2Regret_w1_1_start111,72527,GreedyCycle2Regret_w1_1
48022,3,TSPA,100,200,23938,GreedyCycle2Regret_w1_1_start112,71960,GreedyCycle2Regret_w1_1
48183,4,TSPA,100,200,23795,GreedyCycle2Regret_w1_1_start113,71978,GreedyCycle2Regret_w1_1
48570,4,TSPA,100,200,23112,GreedyCycle2Regret_w1_1_start114,71682,GreedyCycle2Regret_w1_1
48369,4,TSPA,100,200,23578,GreedyCycle2Regret_w1_1_start115,71947,GreedyCycle2Regret_w1_1
48369,3,TSPA,100,200,23578,GreedyCycle2Regret_w1_1_start116,71947,GreedyCycle2Regret_w1_1
48127,4,TSPA,100,200,22981,GreedyCycle2Regret_w1_1_start117,71108,GreedyCycle2Regret_w1_1
48369,4,TSPA,100,200,23637,GreedyCycle2Regret_w1_1_start118,72006,GreedyCycle2Regret_w1_1
48459,4,TSPA,100,200,23013,GreedyCycle2Regret_w1_1_start119,71472,GreedyCycle2Regret_w1_1
48326,4,TSPA,100,200,23529,GreedyCycle2Regret_w1_1_start120,71855,GreedyCycle2Regret_w1_1
48570,3,TSPA,100,200,23297,GreedyCycle2Regret_w1_1_start121,71867,GreedyCycle2Regret_w1_1
49132,3,TSPA,100,200,23444,GreedyCycle2Regret_w1_1_start122,72576,GreedyCycle2Regret_w1_1
48484,4,TSPA,100,200,23745,GreedyCycle2Regret_w1_1_start123,72229,GreedyCycle2Regret_w1_1
48570,4,TSPA,100,200,23291,GreedyCycle2Regret_w1_1_start124,71861,GreedyCycle2Regret_w1_1
49884,4,TSPA,100,200,22940,GreedyCycle2Regret_w1_1_start125,72824,GreedyCycle2Regret_w1_1
49029,4,TSPA,100,200,23391,GreedyCycle2Regret_w1_1_start126,72420,GreedyCycle2Regret_w1_1
48584,3,TSPA,100,200,23609,GreedyCycle2Regret_w1_1_start127,72193,GreedyCycle2Regret_w1_1
48859,3,TSPA,100,200,23458,GreedyCycle2Regret_w1_1_start128,72317,GreedyCycle2Regret_w1_1
48326,4,TSPA,100,200,23378,GreedyCycle2Regret_w1_1_start129,71704,GreedyCycle2Regret_w1_1
49473,4,TSPA,100,200,24245,GreedyCycle2Regret_w1_1_start130,73718,GreedyCycle2Regret_w1_1
48484,4,TSPA,100,200,23509,GreedyCycle2Regret_w1_1_start131,71993,GreedyCycle2Regret_w1_1
49187,4,TSPA,100,200,23434,GreedyCycle2Regret_w1_1_start132,72621,GreedyCycle2Regret_w1_1
48621,4,TSPA,100,200,23615,GreedyCycle2Regret_w1_1_start133,72236,GreedyCycle2Regret_w1_1
49747,4,TSPA,100,200,23531,GreedyCycle2Regret_w1_1_start134,73278,GreedyCycle2Regret_w1_1
48570,3,TSPA,100,200,23180,GreedyCycle2Regret_w1_1_start135,71750,GreedyCycle2Regret_w1_1
48577,4,TSPA,100,200,23896,GreedyCycle2Regret_w1_1_start136,72473,GreedyCycle2Regret_w1_1
48777,4,TSPA,100,200,24281,GreedyCycle2Regret_w1_1_start137,73058,GreedyCycle2Regret_w1_1
48326,4,TSPA,100,200,23197,GreedyCycle2Regret_w1_1_start138,71523,GreedyCycle2Regret_w1_1
48369,4,TSPA,100,200,23578,GreedyCycle2Regret_w1_1_start139,71947,GreedyCycle2Regret_w1_1
48422,4,TSPA,100,200,23286,GreedyCycle2Regret_w1_1_start140,71708,GreedyCycle2Regret_w1_1
49398,3,TSPA,100,200,23290,GreedyCycle2Regret_w1_1_start141,72688,GreedyCycle2Regret_w1_1
49337,4,TSPA,100,200,23572,GreedyCycle2Regret_w1_1_start142,72909,GreedyCycle2Regret_w1_1
48127,4,TSPA,100,200,22981,GreedyCycle2Regret_w1_1_start143,71108,GreedyCycle2Regret_w1_1
48326,4,TSPA,100,200,23197,GreedyCycle2Regret_w1_1_start144,71523,GreedyCycle2Regret_w1_1
48326,3,TSPA,100,200,23735,GreedyCycle2Regret_w1_1_start145,72061,GreedyCycle2Regret_w1_1
47895,3,TSPA,100,200,23490,GreedyCycle2Regret_w1_1_start146,71385,GreedyCycle2Regret_w1_1
49458,4,TSPA,100,200,23933,GreedyCycle2Regret_w1_1_start147,73391,GreedyCycle2Regret_w1_1
48326,4,TSPA,100,200,23197,GreedyCycle2Regret_w1_1_start148,71523,GreedyCycle2Regret_w1_1
48369,4,TSPA,100,200,23578,GreedyCycle2Regret_w1_1_start149,71947,GreedyCycle2Regret_w1_1
49879,4,TSPA,100,200,23514,GreedyCycle2Regret_w1_1_start150,73393,GreedyCycle2Regret_w1_1
48484,4,TSPA,100,200,23456,GreedyCycle2Regret_w1_1_start151,71940,GreedyCycle2Regret_w1_1
48478,3,TSPA,100,200,23455,GreedyCycle2Regret_w1_1_start152,71933,GreedyCycle2Regret_w1_1
48807,4,TSPA,100,200,23029,GreedyCycle2Regret_w1_1_start153,71836,GreedyCycle2Regret_w1_1
48346,4,TSPA,100,200,23374,GreedyCycle2Regret_w1_1_start154,71720,GreedyCycle2Regret_w1_1
49019,4,TSPA,100,200,23020,GreedyCycle2Regret_w1_1_start155,72039,GreedyCycle2Regret_w1_1
49023,4,TSPA,100,200,23408,GreedyCycle2Regret_w1_1_start156,72431,GreedyCycle2Regret_w1_1
48501,3,TSPA,100,200,23507,GreedyCycle2Regret_w1_1_start157,72008,GreedyCycle2Regret_w1_1
48570,4,TSPA,100,200,23180,GreedyCycle2Regret_w1_1_start158,71750,GreedyCycle2Regret_w1_1
47838,4,TSPA,100,200,23605,GreedyCycle2Regret_w1_1_start159,71443,GreedyCycle2Regret_w1_1
47895,4,TSPA,100,200,23490,GreedyCycle2Regret_w1_1_start160,71385,GreedyCycle2Regret_w1_1
49691,4,TSPA,100,200,23693,GreedyCycle2Regret_w1_1_start161,73384,GreedyCycle2Regret_w1_1
48369,3,TSPA,100,200,23856,GreedyCycle2Regret_w1_1_start162,72225,GreedyCycle2Regret_w1_1
49227,4,TSPA,100,200,23328,GreedyCycle2Regret_w1_1_start163,72555,GreedyCycle2Regret_w1_1
48172,4,TSPA,100,200,24230,GreedyCycle2Regret_w1_1_start164,72402,GreedyCycle2Regret_w1_1
48326,4,TSPA,100,200,23197,GreedyCycle2Regret_w1_1_start165,71523,GreedyCycle2Regret_w1_1
49058,3,TSPA,100,200,23537,GreedyCycle2Regret_w1_1_start166,72595,GreedyCycle2Regret_w1_1
48576,4,TSPA,100,200,24137,GreedyCycle2Regret_w1_1_start167,72713,GreedyCycle2Regret_w1_1
49251,4,TSPA,100,200,23521,GreedyCycle2Regret_w1_1_start168,72772,GreedyCycle2Regret_w1_1
48923,4,TSPA,100,200,23479,GreedyCycle2Regret_w1_1_start169,72402,GreedyCycle2Regret_w1_1
48870,3,TSPA,100,200,22771,GreedyCycle2Regret_w1_1_start170,71641,GreedyCycle2Regret_w1_1
48326,4,TSPA,100,200,23691,GreedyCycle2Regret_w1_1_start171,72017,GreedyCycle2Regret_w1_1
49204,4,TSPA,100,200,23714,GreedyCycle2Regret_w1_1_start172,72918,GreedyCycle2Regret_w1_1
49636,4,TSPA,100,200,22851,GreedyCycle2Regret_w1_1_start173,72487,GreedyCycle2Regret_w1_1
49315,3,TSPA,100,200,23126,GreedyCycle2Regret_w1_1_start174,72441,GreedyCycle2Regret_w1_1
48326,4,TSPA,100,200,23691,GreedyCycle2Regret_w1_1_start175,72017,GreedyCycle2Regret_w1_1
48721,4,TSPA,100,200,24331,GreedyCycle2Regret_w1_1_start176,73052,GreedyCycle2Regret_w1_1
48486,4,TSPA,100,200,23801,GreedyCycle2Regret_w1_1_start177,72287,GreedyCycle2Regret_w1_1
48326,4,TSPA,100,200,23197,GreedyCycle2Regret_w1_1_start178,71523,GreedyCycle2Regret_w1_1
48528,3,TSPA,100,200,23960,GreedyCycle2Regret_w1_1_start179,72488,GreedyCycle2Regret_w1_1
48570,4,TSPA,100,200,23180,GreedyCycle2Regret_w1_1_start180,71750,GreedyCycle2Regret_w1_1
47895,4,TSPA,100,200,23490,GreedyCycle2Regret_w1_1_start181,71385,GreedyCycle2Regret_w1_1
48854,4,TSPA,100,200,23811,GreedyCycle2Regret_w1_1_start182,72665,GreedyCycle2Regret_w1_1
48470,4,TSPA,100,200,23553,GreedyCycle2Regret_w1_1_start183,72023,GreedyCycle2Regret_w1_1
47895,4,TSPA,100,200,23490,GreedyCycle2Regret_w1_1_start184,71385,GreedyCycle2Regret_w1_1
48326,3,TSPA,100,200,23304,GreedyCycle2Regret_w1_1_start185,71630,GreedyCycle2Regret_w1_1
48127,4,TSPA,100,200,22981,GreedyCycle2Regret_w1_1_start186,71108,GreedyCycle2Regret_w1_1
49030,4,TSPA,100,200,23214,GreedyCycle2Regret_w1_1_start187,72244,GreedyCycle2Regret_w1_1
49388,3,TSPA,100,200,23657,GreedyCycle2Regret_w1_1_start188,73045,GreedyCycle2Regret_w1_1
49060,4,TSPA,100,200,22885,GreedyCycle2Regret_w1_1_start189,71945,GreedyCycle2Regret_w1_1
48619,4,TSPA,100,200,23617,GreedyCycle2Regret_w1_1_start190,72236,GreedyCycle2Regret_w1_1
49039,4,TSPA,100,200,23490,GreedyCycle2Regret_w1_1_start191,72529,GreedyCycle2Regret_w1_1
49180,3,TSPA,100,200,23609,GreedyCycle2Regret_w1_1_start192,72789,GreedyCycle2Regret_w1_1
48369,4,TSPA,100,200,23578,GreedyCycle2Regret_w1_1_start193,71947,GreedyCycle2Regret_w1_1
48755,4,TSPA,100,200,23249,GreedyCycle2Regret_w1_1_start194,72004,GreedyCycle2Regret_w1_1
48738,4,TSPA,100,200,23656,GreedyCycle2Regret_w1_1_start195,72394,GreedyCycle2Regret_w1_1
48860,4,TSPA,100,200,23517,GreedyCycle2Regret_w1_1_start196,72377,GreedyCycle2Regret_w1_1
49190,3,TSPA,100,200,23554,GreedyCycle2Regret_w1_1_start197,72744,GreedyCycle2Regret_w1_1
48839,4,TSPA,100,200,23377,GreedyCycle2Regret_w1_1_start198,72216,GreedyCycle2Regret_w1_1
48595,4,TSPA,100,200,23291,GreedyCycle2Regret_w1_1_start199,71886,GreedyCycle2Regret_w1_1
47496,14,TSPA,100,200,23098,NearestNeighborAny2Regret_w1_1_start0,70594,NearestNeighborAny2Regret_w1_1
48414,18,TSPA,100,200,22311,NearestNeighborAny2Regret_w1_1_start1,70725,NearestNeighborAny2Regret_w1_1
48414,13,TSPA,100,200,22311,NearestNeighborAny2Regret_w1_1_start2,70725,NearestNeighborAny2Regret_w1_1
48450,11,TSPA,100,200,25488,NearestNeighborAny2Regret_w1_1_start3,73938,NearestNeighborAny2Regret_w1_1
47996,13,TSPA,100,200,22156,NearestNeighborAny2Regret_w1_1_start4,70152,NearestNeighborAny2Regret_w1_1
48414,13,TSPA,100,200,22311,NearestNeighborAny2Regret_w1_1_start5,70725,NearestNeighborAny2Regret_w1_1
49342,12,TSPA,100,200,22096,NearestNeighborAny2Regret_w1_1_start6,71438,NearestNeighborAny2Regret_w1_1
47917,13,TSPA,100,200,24719,NearestNeighborAny2Regret_w1_1_start7,72636,NearestNeighborAny2Regret_w1_1
48550,13,TSPA,100,200,25072,NearestNeighborAny2Regret_w1_1_start8,73622,NearestNeighborAny2Regret_w1_1
48292,6,TSPA,100,200,25673,NearestNeighborAny2Regret_w1_1_start9,73965,NearestNeighborAny2Regret_w1_1
48224,3,TSPA,100,200,24761,NearestNeighborAny2Regret_w1_1_start10,72985,NearestNeighborAny2Regret_w1_1
48801,4,TSPA,100,200,22810,NearestNeighborAny2Regret_w1_1_start11,71611,NearestNeighborAny2Regret_w1_1
48681,3,TSPA,100,200,23877,NearestNeighborAny2Regret_w1_1_start12,72558,NearestNeighborAny2Regret_w1_1
48886,3,TSPA,100,200,25822,NearestNeighborAny2Regret_w1_1_start13,74708,NearestNeighborAny2Regret_w1_1
48372,2,TSPA,100,200,25609,NearestNeighborAny2Regret_w1_1_start14,73981,NearestNeighborAny2Regret_w1_1
47496,3,TSPA,100,200,23098,NearestNeighborAny2Regret_w1_1_start15,70594,NearestNeighborAny2Regret_w1_1
48377,3,TSPA,100,200,26292,NearestNeighborAny2Regret_w1_1_start16,74669,NearestNeighborAny2Regret_w1_1
49402,2,TSPA,100,200,22031,NearestNeighborAny2Regret_w1_1_start17,71433,NearestNeighborAny2Regret_w1_1
48414,3,TSPA,100,200,22311,NearestNeighborAny2Regret_w1_1_start18,70725,NearestNeighborAny2Regret_w1_1
48983,3,TSPA,100,200,21998,NearestNeighborAny2Regret_w1_1_start19,70981,NearestNeighborAny2Regret_w1_1
48629,3,TSPA,100,200,23403,NearestNeighborAny2Regret_w1_1_start20,72032,NearestNeighborAny2Regret_w1_1
48530,3,TSPA,100,200,25524,NearestNeighborAny2Regret_w1_1_start21,74054,NearestNeighborAny2Regret_w1_1
48070,2,TSPA,100,200,24226,NearestNeighborAny2Regret_w1_1_start22,72296,NearestNeighborAny2Regret_w1_1
48377,3,TSPA,100,200,24477,NearestNeighborAny2Regret_w1_1_start23,72854,NearestNeighborAny2Regret_w1_1
48607,2,TSPA,100,200,22102,NearestNeighborAny2Regret_w1_1_start24,70709,NearestNeighborAny2Regret_w1_1
48414,2,TSPA,100,200,22311,NearestNeighborAny2Regret_w1_1_start25,70725,NearestNeighborAny2Regret_w1_1
48577,3,TSPA,100,200,22000,NearestNeighborAny2Regret_w1_1_start26,70577,NearestNeighborAny2Regret_w1_1
49253,3,TSPA,100,200,24612,NearestNeighborAny2Regret_w1_1_start27,73865,NearestNeighborAny2Regret_w1_1
48530,2,TSPA,100,200,21979,NearestNeighborAny2Regret_w1_1_start28,70509,NearestNeighborAny2Regret_w1_1
48842,3,TSPA,100,200,23585,NearestNeighborAny2Regret_w1_1_start29,72427,NearestNeighborAny2Regret_w1_1
48321,3,TSPA,100,200,24252,NearestNeighborAny2Regret_w1_1_start30,72573,NearestNeighborAny2Regret_w1_1
48192,2,TSPA,100,200,25838,NearestNeighborAny2Regret_w1_1_start31,74030,NearestNeighborAny2Regret_w1_1
48902,3,TSPA,100,200,25517,NearestNeighborAny2Regret_w1_1_start32,74419,NearestNeighborAny2Regret_w1_1
48861,2,TSPA,100,200,25032,NearestNeighborAny2Regret_w1_1_start33,73893,NearestNeighborAny2Regret_w1_1
48240,3,TSPA,100,200,25595,NearestNeighborAny2Regret_w1_1_start34,73835,NearestNeighborAny2Regret_w1_1
48297,3,TSPA,100,200,21713,NearestNeighborAny2Regret_w1_1_start35,70010,NearestNeighborAny2Regret_w1_1
48846,3,TSPA,100,200,23838,NearestNeighborAny2Regret_w1_1_start36,72684,NearestNeighborAny2Regret_w1_1
48275,3,TSPA,100,200,25029,NearestNeighborAny2Regret_w1_1_start37,73304,NearestNeighborAny2Regret_w1_1
48646,2,TSPA,100,200,25837,NearestNeighborAny2Regret_w1_1_start38,74483,NearestNeighborAny2Regret_w1_1
48362,3,TSPA,100,200,24401,NearestNeighborAny2Regret_w1_1_start39,72763,NearestNeighborAny2Regret_w1_1
48062,2,TSPA,100,200,25021,NearestNeighborAny2Regret_w1_1_start40,73083,NearestNeighborAny2Regret_w1_1
47596,3,TSPA,100,200,24591,NearestNeighborAny2Regret_w1_1_start41,72187,NearestNeighborAny2Regret_w1_1
48414,2,TSPA,100,200,22311,NearestNeighborAny2Regret_w1_1_start42,70725,NearestNeighborAny2Regret_w1_1
48095,3,TSPA,100,200,26075,NearestNeighborAny2Regret_w1_1_start43,74170,NearestNeighborAny2Regret_w1_1
48414,3,TSPA,100,200,22311,NearestNeighborAny2Regret_w1_1_start44,70725,NearestNeighborAny2Regret_w1_1
49355,2,TSPA,100,200,23456,NearestNeighborAny2Regret_w1_1_start45,72811,NearestNeighborAny2Regret_w1_1
47496,3,TSPA,100,200,23098,NearestNeighborAny2Regret_w1_1_start46,70594,NearestNeighborAny2Regret_w1_1
48307,3,TSPA,100,200,26025,NearestNeighborAny2Regret_w1_1_start47,74332,NearestNeighborAny2Regret_w1_1
49372,2,TSPA,100,200,23494,NearestNeighborAny2Regret_w1_1_start48,72866,NearestNeighborAny2Regret_w1_1
47496,3,TSPA,100,200,23098,NearestNeighborAny2Regret_w1_1_start49,70594,NearestNeighborAny2Regret_w1_1
49590,3,TSPA,100,200,21988,NearestNeighborAny2Regret_w1_1_start50,71578,NearestNeighborAny2Regret_w1_1
47596,2,TSPA,100,200,24451,NearestNeighborAny2Regret_w1_1_start51,72047,NearestNeighborAny2Regret_w1_1
48438,3,TSPA,100,200,25562,NearestNeighborAny2Regret_w1_1_start52,74000,NearestNeighborAny2Regret_w1_1
48414,3,TSPA,100,200,22311,NearestNeighborAny2Regret_w1_1_start53,70725,NearestNeighborAny2Regret_w1_1
47996,3,TSPA,100,200,22251,NearestNeighborAny2Regret_w1_1_start54,70247,NearestNeighborAny2Regret_w1_1
48438,3,TSPA,100,200,25562,NearestNeighborAny2Regret_w1_1_start55,74000,NearestNeighborAny2Regret_w1_1
48377,3,TSPA,100,200,25228,NearestNeighborAny2Regret_w1_1_start56,73605,NearestNeighborAny2Regret_w1_1
48270,2,TSPA,100,200,27147,NearestNeighborAny2Regret_w1_1_start57,75417,NearestNeighborAny2Regret_w1_1
49019,3,TSPA,100,200,24706,NearestNeighborAny2Regret_w1_1_start58,73725,NearestNeighborAny2Regret_w1_1
48070,2,TSPA,100,200,24172,NearestNeighborAny2Regret_w1_1_start59,72242,NearestNeighborAny2Regret_w1_1
49177,3,TSPA,100,200,22445,NearestNeighborAny2Regret_w1_1_start60,71622,NearestNeighborAny2Regret_w1_1
48515,3,TSPA,100,200,23164,NearestNeighborAny2Regret_w1_1_start61,71679,NearestNeighborAny2Regret_w1_1
48220,2,TSPA,100,200,25588,NearestNeighborAny2Regret_w1_1_start62,73808,NearestNeighborAny2Regret_w1_1
48377,3,TSPA,100,200,24477,NearestNeighborAny2Regret_w1_1_start63,72854,NearestNeighborAny2Regret_w1_1
48205,2,TSPA,100,200,23096,NearestNeighborAny2Regret_w1_1_start64,71301,NearestNeighborAny2Regret_w1_1
48070,3,TSPA,100,200,24172,NearestNeighborAny2Regret_w1_1_start65,72242,NearestNeighborAny2Regret_w1_1
49036,3,TSPA,100,200,24445,NearestNeighborAny2Regret_w1_1_start66,73481,NearestNeighborAny2Regret_w1_1
48762,2,TSPA,100,200,22778,NearestNeighborAny2Regret_w1_1_start67,71540,NearestNeighborAny2Regret_w1_1
48280,2,TSPA,100,200,23950,NearestNeighborAny2Regret_w1_1_start68,72230,NearestNeighborAny2Regret_w1_1
48359,2,TSPA,100,200,24061,NearestNeighborAny2Regret_w1_1_start69,72420,NearestNeighborAny2Regret_w1_1
48414,3,TSPA,100,200,22311,NearestNeighborAny2Regret_w1_1_start70,70725,NearestNeighborAny2Regret_w1_1
49253,2,TSPA,100,200,24612,NearestNeighborAny2Regret_w1_1_start71,73865,NearestNeighborAny2Regret_w1_1
48673,3,TSPA,100,200,26190,NearestNeighborAny2Regret_w1_1_start72,74863,NearestNeighborAny2Regret_w1_1
48358,2,TSPA,100,200,23578,NearestNeighborAny2Regret_w1_1_start73,71936,NearestNeighborAny2Regret_w1_1
49109,3,TSPA,100,200,23607,NearestNeighborAny2Regret_w1_1_start74,72716,NearestNeighborAny2Regret_w1_1
48577,2,TSPA,100,200,22239,NearestNeighborAny2Regret_w1_1_start75,70816,NearestNeighborAny2Regret_w1_1
49320,3,TSPA,100,200,24459,NearestNeighborAny2Regret_w1_1_start76,73779,NearestNeighborAny2Regret_w1_1
48470,3,TSPA,100,200,26050,NearestNeighborAny2Regret_w1_1_start77,74520,NearestNeighborAny2Regret_w1_1
48414,2,TSPA,100,200,22311,NearestNeighborAny2Regret_w1_1_start78,70725,NearestNeighborAny2Regret_w1_1
48377,3,TSPA,100,200,24477,NearestNeighborAny2Regret_w1_1_start79,72854,NearestNeighborAny2Regret_w1_1
48377,2,TSPA,100,200,24477,NearestNeighborAny2Regret_w1_1_start80,72854,NearestNeighborAny2Regret_w1_1
48363,3,TSPA,100,200,25767,NearestNeighborAny2Regret_w1_1_start81,74130,NearestNeighborAny2Regret_w1_1
48375,2,TSPA,100,200,22487,NearestNeighborAny2Regret_w1_1_start82,70862,NearestNeighborAny2Regret_w1_1
48419,3,TSPA,100,200,23292,NearestNeighborAny2Regret_w1_1_start83,71711,NearestNeighborAny2Regret_w1_1
48002,2,TSPA,100,200,22541,NearestNeighborAny2Regret_w1_1_start84,70543,NearestNeighborAny2Regret_w1_1
48665,3,TSPA,100,200,25842,NearestNeighborAny2Regret_w1_1_start85,74507,NearestNeighborAny2Regret_w1_1
48577,3,TSPA,100,200,22239,NearestNeighborAny2Regret_w1_1_start86,70816,NearestNeighborAny2Regret_w1_1
48841,2,TSPA,100,200,23595,NearestNeighborAny2Regret_w1_1_start87,72436,NearestNeighborAny2Regret_w1_1
49298,3,TSPA,100,200,26154,NearestNeighborAny2Regret_w1_1_start88,75452,NearestNeighborAny2Regret_w1_1
48377,2,TSPA,100,200,24477,NearestNeighborAny2Regret_w1_1_start89,72854,NearestNeighborAny2Regret_w1_1
48062,3,TSPA,100,200,25021,NearestNeighborAny2Regret_w1_1_start90,73083,NearestNeighborAny2Regret_w1_1
48827,2,TSPA,100,200,25490,NearestNeighborAny2Regret_w1_1_start91,74317,NearestNeighborAny2Regret_w1_1
48270,3,TSPA,100,200,27147,NearestNeighborAny2Regret_w1_1_start92,75417,NearestNeighborAny2Regret_w1_1
48280,3,TSPA,100,200,23950,NearestNeighborAny2Regret_w1_1_start93,72230,NearestNeighborAny2Regret_w1_1
48037,2,TSPA,100,200,23978,NearestNeighborAny2Regret_w1_1_start94,72015,NearestNeighborAny2Regret_w1_1
49067,2,TSPA,100,200,24606,NearestNeighborAny2Regret_w1_1_start95,73673,NearestNeighborAny2Regret_w1_1
48871,3,TSPA,100,200,23579,NearestNeighborAny2Regret_w1_1_start96,72450,NearestNeighborAny2Regret_w1_1
48414,2,TSPA,100,200,22311,NearestNeighborAny2Regret_w1_1_start97,70725,NearestNeighborAny2Regret_w1_1
49658,3,TSPA,100,200,22191,NearestNeighborAny2Regret_w1_1_start98,71849,NearestNeighborAny2Regret_w1_1
49378,2,TSPA,100,200,22126,NearestNeighborAny2Regret_w1_1_start99,71504,NearestNeighborAny2Regret_w1_1
48577,2,TSPA,100,200,22000,NearestNeighborAny2Regret_w1_1_start100,70577,NearestNeighborAny2Regret_w1_1
48414,3,TSPA,100,200,22311,NearestNeighborAny2Regret_w1_1_start101,70725,NearestNeighborAny2Regret_w1_1
48220,2,TSPA,100,200,25624,NearestNeighborAny2Regret_w1_1_start102,73844,NearestNeighborAny2Regret_w1_1
48497,3,TSPA,100,200,23489,NearestNeighborAny2Regret_w1_1_start103,71986,NearestNeighborAny2Regret_w1_1
49272,2,TSPA,100,200,24306,NearestNeighborAny2Regret_w1_1_start104,73578,NearestNeighborAny2Regret_w1_1
48502,3,TSPA,100,200,25975,NearestNeighborAny2Regret_w1_1_start105,74477,NearestNeighborAny2Regret_w1_1
48220,2,TSPA,100,200,25588,NearestNeighborAny2Regret_w1_1_start106,73808,NearestNeighborAny2Regret_w1_1
49985,3,TSPA,100,200,24612,NearestNeighborAny2Regret_w1_1_start107,74597,NearestNeighborAny2Regret_w1_1
48132,2,TSPA,100,200,23438,NearestNeighborAny2Regret_w1_1_start108,71570,NearestNeighborAny2Regret_w1_1
48715,3,TSPA,100,200,26051,NearestNeighborAny2Regret_w1_1_start109,74766,NearestNeighborAny2Regret_w1_1
48028,2,TSPA,100,200,22685,NearestNeighborAny2Regret_w1_1_start110,70713,NearestNeighborAny2Regret_w1_1
49224,2,TSPA,100,200,22548,NearestNeighborAny2Regret_w1_1_start111,71772,NearestNeighborAny2Regret_w1_1
48002,2,TSPA,100,200,22541,NearestNeighborAny2Regret_w1_1_start112,70543,NearestNeighborAny2Regret_w1_1
48377,2,TSPA,100,200,25228,NearestNeighborAny2Regret_w1_1_start113,73605,NearestNeighborAny2Regret_w1_1
47496,3,TSPA,100,200,23098,NearestNeighborAny2Regret_w1_1_start114,70594,NearestNeighborAny2Regret_w1_1
47596,2,TSPA,100,200,24591,NearestNeighborAny2Regret_w1_1_start115,72187,NearestNeighborAny2Regret_w1_1
48070,3,TSPA,100,200,24226,NearestNeighborAny2Regret_w1_1_start116,72296,NearestNeighborAny2Regret_w1_1
47496,2,TSPA,100,200,23098,NearestNeighborAny2Regret_w1_1_start117,70594,NearestNeighborAny2Regret_w1_1
48292,3,TSPA,100,200,26155,NearestNeighborAny2Regret_w1_1_start118,74447,NearestNeighborAny2Regret_w1_1
48187,2,TSPA,100,200,24922,NearestNeighborAny2Regret_w1_1_start119,73109,NearestNeighborAny2Regret_w1_1
48414,2,TSPA,100,200,22311,NearestNeighborAny2Regret_w1_1_start120,70725,NearestNeighborAny2Regret_w1_1
48577,3,TSPA,100,200,22000,NearestNeighborAny2Regret_w1_1_start121,70577,NearestNeighborAny2Regret_w1_1
48598,2,TSPA,100,200,24558,NearestNeighborAny2Regret_w1_1_start122,73156,NearestNeighborAny2Regret_w1_1
48414,3,TSPA,100,200,22311,NearestNeighborAny2Regret_w1_1_start123,70725,NearestNeighborAny2Regret_w1_1
47815,2,TSPA,100,200,24001,NearestNeighborAny2Regret_w1_1_start124,71816,NearestNeighborAny2Regret_w1_1
49770,3,TSPA,100,200,21778,NearestNeighborAny2Regret_w1_1_start125,71548,NearestNeighborAny2Regret_w1_1
49036,2,TSPA,100,200,21912,NearestNeighborAny2Regret_w1_1_start126,70948,NearestNeighborAny2Regret_w1_1
48414,3,TSPA,100,200,22311,NearestNeighborAny2Regret_w1_1_start127,70725,NearestNeighborAny2Regret_w1_1
48864,2,TSPA,100,200,23134,NearestNeighborAny2Regret_w1_1_start128,71998,NearestNeighborAny2Regret_w1_1
48357,3,TSPA,100,200,23313,NearestNeighborAny2Regret_w1_1_start129,71670,NearestNeighborAny2Regret_w1_1
49115,2,TSPA,100,200,23886,NearestNeighborAny2Regret_w1_1_start130,73001,NearestNeighborAny2Regret_w1_1
48215,3,TSPA,100,200,23779,NearestNeighborAny2Regret_w1_1_start131,71994,NearestNeighborAny2Regret_w1_1
48760,2,TSPA,100,200,23611,NearestNeighborAny2Regret_w1_1_start132,72371,NearestNeighborAny2Regret_w1_1
47596,3,TSPA,100,200,24591,NearestNeighborAny2Regret_w1_1_start133,72187,NearestNeighborAny2Regret_w1_1
49222,2,TSPA,100,200,22578,NearestNeighborAny2Regret_w1_1_start134,71800,NearestNeighborAny2Regret_w1_1
48414,3,TSPA,100,200,22311,NearestNeighborAny2Regret_w1_1_start135,70725,NearestNeighborAny2Regret_w1_1
48785,2,TSPA,100,200,24537,NearestNeighborAny2Regret_w1_1_start136,73322,NearestNeighborAny2Regret_w1_1
48377,3,TSPA,100,200,24477,NearestNeighborAny2Regret_w1_1_start137,72854,NearestNeighborAny2Regret_w1_1
48372,2,TSPA,100,200,25609,NearestNeighborAny2Regret_w1_1_start138,73981,NearestNeighborAny2Regret_w1_1
47596,3,TSPA,100,200,24591,NearestNeighborAny2Regret_w1_1_start139,72187,NearestNeighborAny2Regret_w1_1
48280,2,TSPA,100,200,23950,NearestNeighborAny2Regret_w1_1_start140,72230,NearestNeighborAny2Regret_w1_1
49276,3,TSPA,100,200,23344,NearestNeighborAny2Regret_w1_1_start141,72620,NearestNeighborAny2Regret_w1_1
49354,2,TSPA,100,200,22249,NearestNeighborAny2Regret_w1_1_start142,71603,NearestNeighborAny2Regret_w1_1
47496,3,TSPA,100,200,23098,NearestNeighborAny2Regret_w1_1_start143,70594,NearestNeighborAny2Regret_w1_1
47496,2,TSPA,100,200,23098,NearestNeighborAny2Regret_w1_1_start144,70594,NearestNeighborAny2Regret_w1_1
48414,3,TSPA,100,200,22311,NearestNeighborAny2Regret_w1_1_start145,70725,NearestNeighborAny2Regret_w1_1
48030,2,TSPA,100,200,23744,NearestNeighborAny2Regret_w1_1_start146,71774,NearestNeighborAny2Regret_w1_1
49169,3,TSPA,100,200,24704,NearestNeighborAny2Regret_w1_1_start147,73873,NearestNeighborAny2Regret_w1_1
48070,3,TSPA,100,200,24226,NearestNeighborAny2Regret_w1_1_start148,72296,NearestNeighborAny2Regret_w1_1
48531,2,TSPA,100,200,22240,NearestNeighborAny2Regret_w1_1_start149,70771,NearestNeighborAny2Regret_w1_1
49347,3,TSPA,100,200,24512,NearestNeighborAny2Regret_w1_1_start150,73859,NearestNeighborAny2Regret_w1_1
47843,2,TSPA,100,200,23649,NearestNeighborAny2Regret_w1_1_start151,71492,NearestNeighborAny2Regret_w1_1
48170,3,TSPA,100,200,23606,NearestNeighborAny2Regret_w1_1_start152,71776,NearestNeighborAny2Regret_w1_1
47807,2,TSPA,100,200,23083,NearestNeighborAny2Regret_w1_1_start153,70890,NearestNeighborAny2Regret_w1_1
48414,3,TSPA,100,200,22311,NearestNeighborAny2Regret_w1_1_start154,70725,NearestNeighborAny2Regret_w1_1
49013,3,TSPA,100,200,25571,NearestNeighborAny2Regret_w1_1_start155,74584,NearestNeighborAny2Regret_w1_1
49178,3,TSPA,100,200,22722,NearestNeighborAny2Regret_w1_1_start156,71900,NearestNeighborAny2Regret_w1_1
48770,2,TSPA,100,200,25642,NearestNeighborAny2Regret_w1_1_start157,74412,NearestNeighborAny2Regret_w1_1
48699,3,TSPA,100,200,21924,NearestNeighborAny2Regret_w1_1_start158,70623,NearestNeighborAny2Regret_w1_1
48070,2,TSPA,100,200,24226,NearestNeighborAny2Regret_w1_1_start159,72296,NearestNeighborAny2Regret_w1_1
48240,3,TSPA,100,200,25595,NearestNeighborAny2Regret_w1_1_start160,73835,NearestNeighborAny2Regret_w1_1
48955,2,TSPA,100,200,23420,NearestNeighborAny2Regret_w1_1_start161,72375,NearestNeighborAny2Regret_w1_1
47843,3,TSPA,100,200,23649,NearestNeighborAny2Regret_w1_1_start162,71492,NearestNeighborAny2Regret_w1_1
47986,3,TSPA,100,200,24679,NearestNeighborAny2Regret_w1_1_start163,72665,NearestNeighborAny2Regret_w1_1
48638,2,TSPA,100,200,24806,NearestNeighborAny2Regret_w1_1_start164,73444,NearestNeighborAny2Regret_w1_1
48062,3,TSPA,100,200,25021,NearestNeighborAny2Regret_w1_1_start165,73083,NearestNeighborAny2Regret_w1_1
48377,2,TSPA,100,200,26387,NearestNeighborAny2Regret_w1_1_start166,74764,NearestNeighborAny2Regret_w1_1
48371,3,TSPA,100,200,24109,NearestNeighborAny2Regret_w1_1_start167,72480,NearestNeighborAny2Regret_w1_1
48715,2,TSPA,100,200,23538,NearestNeighborAny2Regret_w1_1_start168,72253,NearestNeighborAny2Regret_w1_1
48845,3,TSPA,100,200,25751,NearestNeighborAny2Regret_w1_1_start169,74596,NearestNeighborAny2Regret_w1_1
47870,2,TSPA,100,200,23003,NearestNeighborAny2Regret_w1_1_start170,70873,NearestNeighborAny2Regret_w1_1
48377,3,TSPA,100,200,26292,NearestNeighborAny2Regret_w1_1_start171,74669,NearestNeighborAny2Regret_w1_1
49047,3,TSPA,100,200,24669,NearestNeighborAny2Regret_w1_1_start172,73716,NearestNeighborAny2Regret_w1_1
49285,2,TSPA,100,200,22215,NearestNeighborAny2Regret_w1_1_start173,71500,NearestNeighborAny2Regret_w1_1
49033,3,TSPA,100,200,25560,NearestNeighborAny2Regret_w1_1_start174,74593,NearestNeighborAny2Regret_w1_1
48377,2,TSPA,100,200,26292,NearestNeighborAny2Regret_w1_1_start175,74669,NearestNeighborAny2Regret_w1_1
48377,3,TSPA,100,200,24477,NearestNeighborAny2Regret_w1_1_start176,72854,NearestNeighborAny2Regret_w1_1
47885,2,TSPA,100,200,24430,NearestNeighborAny2Regret_w1_1_start177,72315,NearestNeighborAny2Regret_w1_1
48220,3,TSPA,100,200,25588,NearestNeighborAny2Regret_w1_1_start178,73808,NearestNeighborAny2Regret_w1_1
48377,3,TSPA,100,200,26278,NearestNeighborAny2Regret_w1_1_start179,74655,NearestNeighborAny2Regret_w1_1
48414,2,TSPA,100,200,22311,NearestNeighborAny2Regret_w1_1_start180,70725,NearestNeighborAny2Regret_w1_1
48494,3,TSPA,100,200,25840,NearestNeighborAny2Regret_w1_1_start181,74334,NearestNeighborAny2Regret_w1_1
48810,3,TSPA,100,200,24538,NearestNeighborAny2Regret_w1_1_start182,73348,NearestNeighborAny2Regret_w1_1
47496,2,TSPA,100,200,23098,NearestNeighborAny2Regret_w1_1_start183,70594,NearestNeighborAny2Regret_w1_1
48005,3,TSPA,100,200,22747,NearestNeighborAny2Regret_w1_1_start184,70752,NearestNeighborAny2Regret_w1_1
48062,2,TSPA,100,200,25021,NearestNeighborAny2Regret_w1_1_start185,73083,NearestNeighborAny2Regret_w1_1
47792,3,TSPA,100,200,22820,NearestNeighborAny2Regret_w1_1_start186,70612,NearestNeighborAny2Regret_w1_1
49059,2,TSPA,100,200,25669,NearestNeighborAny2Regret_w1_1_start187,74728,NearestNeighborAny2Regret_w1_1
49823,3,TSPA,100,200,21923,NearestNeighborAny2Regret_w1_1_start188,71746,NearestNeighborAny2Regret_w1_1
48709,3,TSPA,100,200,22012,NearestNeighborAny2Regret_w1_1_start189,70721,NearestNeighborAny2Regret_w1_1
47794,2,TSPA,100,200,22308,NearestNeighborAny2Regret_w1_1_start190,70102,NearestNeighborAny2Regret_w1_1
48572,3,TSPA,100,200,23997,NearestNeighborAny2Regret_w1_1_start191,72569,NearestNeighborAny2Regret_w1_1
48668,2,TSPA,100,200,24077,NearestNeighborAny2Regret_w1_1_start192,72745,NearestNeighborAny2Regret_w1_1
47596,3,TSPA,100,200,24591,NearestNeighborAny2Regret_w1_1_start193,72187,NearestNeighborAny2Regret_w1_1
48823,3,TSPA,100,200,22283,NearestNeighborAny2Regret_w1_1_start194,71106,NearestNeighborAny2Regret_w1_1
48628,2,TSPA,100,200,22791,NearestNeighborAny2Regret_w1_1_start195,71419,NearestNeighborAny2Regret_w1_1
47748,3,TSPA,100,200,23589,NearestNeighborAny2Regret_w1_1_start196,71337,NearestNeighborAny2Regret_w1_1
48651,2,TSPA,100,200,25855,NearestNeighborAny2Regret_w1_1_start197,74506,NearestNeighborAny2Regret_w1_1
48066,3,TSPA,100,200,24390,NearestNeighborAny2Regret_w1_1_start198,72456,NearestNeighborAny2Regret_w1_1
48790,3,TSPA,100,200,22131,NearestNeighborAny2Regret_w1_1_start199,70921,NearestNeighborAny2Regret_w1_1
96931,3,TSPA,100,200,22018,GreedyCycle2Regret_w0_1_start0,118949,GreedyCycle2Regret_w0_1
88982,3,TSPA,100,200,22342,GreedyCycle2Regret_w0_1_start1,111324,GreedyCycle2Regret_w0_1
88982,4,TSPA,100,200,22342,GreedyCycle2Regret_w0_1_start2,111324,GreedyCycle2Regret_w0_1
96537,4,TSPA,100,200,21172,GreedyCycle2Regret_w0_1_start3,117709,GreedyCycle2Regret_w0_1
94138,4,TSPA,100,200,21030,GreedyCycle2Regret_w0_1_start4,115168,GreedyCycle2Regret_w0_1
94953,4,TSPA,100,200,20791,GreedyCycle2Regret_w0_1_start5,115744,GreedyCycle2Regret_w0_1
93231,4,TSPA,100,200,22114,GreedyCycle2Regret_w0_1_start6,115345,GreedyCycle2Regret_w0_1
98806,4,TSPA,100,200,20042,GreedyCycle2Regret_w0_1_start7,118848,GreedyCycle2Regret_w0_1
95859,3,TSPA,100,200,21396,GreedyCycle2Regret_w0_1_start8,117255,GreedyCycle2Regret_w0_1
98212,4,TSPA,100,200,21271,GreedyCycle2Regret_w0_1_start9,119483,GreedyCycle2Regret_w0_1
95027,4,TSPA,100,200,21338,GreedyCycle2Regret_w0_1_start10,116365,GreedyCycle2Regret_w0_1
98622,4,TSPA,100,200,21843,GreedyCycle2Regret_w0_1_start11,120465,GreedyCycle2Regret_w0_1
87700,4,TSPA,100,200,23114,GreedyCycle2Regret_w0_1_start12,110814,GreedyCycle2Regret_w0_1
100671,3,TSPA,100,200,21754,GreedyCycle2Regret_w0_1_start13,122425,GreedyCycle2Regret_w0_1
90223,4,TSPA,100,200,21079,GreedyCycle2Regret_w0_1_start14,111302,GreedyCycle2Regret_w0_1
99073,4,TSPA,100,200,21957,GreedyCycle2Regret_w0_1_start15,121030,GreedyCycle2Regret_w0_1
97177,4,TSPA,100,200,21543,GreedyCycle2Regret_w0_1_start16,118720,GreedyCycle2Regret_w0_1
95466,3,TSPA,100,200,21463,GreedyCycle2Regret_w0_1_start17,116929,GreedyCycle2Regret_w0_1
100447,4,TSPA,100,200,19575,GreedyCycle2Regret_w0_1_start18,120022,GreedyCycle2Regret_w0_1
90971,4,TSPA,100,200,21745,GreedyCycle2Regret_w0_1_start19,112716,GreedyCycle2Regret_w0_1
101319,4,TSPA,100,200,19027,GreedyCycle2Regret_w0_1_start20,120346,GreedyCycle2Regret_w0_1
96973,5,TSPA,100,200,19606,GreedyCycle2Regret_w0_1_start21,116579,GreedyCycle2Regret_w0_1
100041,4,TSPA,100,200,18644,GreedyCycle2Regret_w0_1_start22,118685,GreedyCycle2Regret_w0_1
92444,4,TSPA,100,200,21717,GreedyCycle2Regret_w0_1_start23,114161,GreedyCycle2Regret_w0_1
93941,5,TSPA,100,200,21610,GreedyCycle2Regret_w0_1_start24,115551,GreedyCycle2Regret_w0_1
95578,5,TSPA,100,200,21869,GreedyCycle2Regret_w0_1_start25,117447,GreedyCycle2Regret_w0_1
95979,4,TSPA,100,200,22152,GreedyCycle2Regret_w0_1_start26,118131,GreedyCycle2Regret_w0_1
94513,4,TSPA,100,200,20901,GreedyCycle2Regret_w0_1_start27,115414,GreedyCycle2Regret_w0_1
96468,3,TSPA,100,200,21415,GreedyCycle2Regret_w0_1_start28,117883,GreedyCycle2Regret_w0_1
92683,5,TSPA,100,200,20482,GreedyCycle2Regret_w0_1_start29,113165,GreedyCycle2Regret_w0_1
97409,3,TSPA,100,200,20999,GreedyCycle2Regret_w0_1_start30,118408,GreedyCycle2Regret_w0_1
97398,4,TSPA,100,200,21667,GreedyCycle2Regret_w0_1_start31,119065,GreedyCycle2Regret_w0_1
96915,4,TSPA,100,200,20449,GreedyCycle2Regret_w0_1_start32,117364,GreedyCycle2Regret_w0_1
98423,4,TSPA,100,200,22043,GreedyCycle2Regret_w0_1_start33,120466,GreedyCycle2Regret_w0_1
94632,4,TSPA,100,200,20296,GreedyCycle2Regret_w0_1_start34,114928,GreedyCycle2Regret_w0_1
96455,4,TSPA,100,200,20994,GreedyCycle2Regret_w0_1_start35,117449,GreedyCycle2Regret_w0_1
100444,3,TSPA,100,200,18743,GreedyCycle2Regret_w0_1_start36,119187,GreedyCycle2Regret_w0_1
97837,4,TSPA,100,200,22044,GreedyCycle2Regret_w0_1_start37,119881,GreedyCycle2Regret_w0_1
98060,4,TSPA,100,200,21616,GreedyCycle2Regret_w0_1_start38,119676,GreedyCycle2Regret_w0_1
96558,4,TSPA,100,200,19415,GreedyCycle2Regret_w0_1_start39,115973,GreedyCycle2Regret_w0_1
93076,4,TSPA,100,200,20191,GreedyCycle2Regret_w0_1_start40,113267,GreedyCycle2Regret_w0_1
96105,3,TSPA,100,200,20684,GreedyCycle2Regret_w0_1_start41,116789,GreedyCycle2Regret_w0_1
96757,4,TSPA,100,200,21653,GreedyCycle2Regret_w0_1_start42,118410,GreedyCycle2Regret_w0_1
91371,4,TSPA,100,200,21353,GreedyCycle2Regret_w0_1_start43,112724,GreedyCycle2Regret_w0_1
100372,3,TSPA,100,200,22323,GreedyCycle2Regret_w0_1_start44,122695,GreedyCycle2Regret_w0_1
92953,4,TSPA,100,200,21377,GreedyCycle2Regret_w0_1_start45,114330,GreedyCycle2Regret_w0_1
95006,4,TSPA,100,200,22110,GreedyCycle2Regret_w0_1_start46,117116,GreedyCycle2Regret_w0_1
97782,4,TSPA,100,200,21410,GreedyCycle2Regret_w0_1_start47,119192,GreedyCycle2Regret_w0_1
93214,4,TSPA,100,200,20728,GreedyCycle2Regret_w0_1_start48,113942,GreedyCycle2Regret_w0_1
93355,3,TSPA,100,200,21437,GreedyCycle2Regret_w0_1_start49,114792,GreedyCycle2Regret_w0_1
98037,3,TSPA,100,200,21907,GreedyCycle2Regret_w0_1_start50,119944,GreedyCycle2Regret_w0_1
94803,4,TSPA,100,200,22145,GreedyCycle2Regret_w0_1_start51,116948,GreedyCycle2Regret_w0_1
91558,4,TSPA,100,200,21136,GreedyCycle2Regret_w0_1_start52,112694,GreedyCycle2Regret_w0_1
96438,4,TSPA,100,200,21827,GreedyCycle2Regret_w0_1_start53,118265,GreedyCycle2Regret_w0_1
94797,3,TSPA,100,200,20719,GreedyCycle2Regret_w0_1_start54,115516,GreedyCycle2Regret_w0_1
94215,3,TSPA,100,200,21215,GreedyCycle2Regret_w0_1_start55,115430,GreedyCycle2Regret_w0_1
98050,4,TSPA,100,200,21741,GreedyCycle2Regret_w0_1_start56,119791,GreedyCycle2Regret_w0_1
91915,4,TSPA,100,200,22092,GreedyCycle2Regret_w0_1_start57,114007,GreedyCycle2Regret_w0_1
98165,3,TSPA,100,200,19918,GreedyCycle2Regret_w0_1_start58,118083,GreedyCycle2Regret_w0_1
95521,4,TSPA,100,200,21475,GreedyCycle2Regret_w0_1_start59,116996,GreedyCycle2Regret_w0_1
96108,4,TSPA,100,200,20900,GreedyCycle2Regret_w0_1_start60,117008,GreedyCycle2Regret_w0_1
97576,3,TSPA,100,200,21583,GreedyCycle2Regret_w0_1_start61,119159,GreedyCycle2Regret_w0_1
97618,4,TSPA,100,200,21274,GreedyCycle2Regret_w0_1_start62,118892,GreedyCycle2Regret_w0_1
86831,4,TSPA,100,200,22088,GreedyCycle2Regret_w0_1_start63,108919,GreedyCycle2Regret_w0_1
93940,3,TSPA,100,200,19653,GreedyCycle2Regret_w0_1_start64,113593,GreedyCycle2Regret_w0_1
92731,4,TSPA,100,200,20260,GreedyCycle2Regret_w0_1_start65,112991,GreedyCycle2Regret_w0_1
96863,4,TSPA,100,200,21269,GreedyCycle2Regret_w0_1_start66,118132,GreedyCycle2Regret_w0_1
100237,3,TSPA,100,200,18904,GreedyCycle2Regret_w0_1_start67,119141,GreedyCycle2Regret_w0_1
95823,4,TSPA,100,200,21623,GreedyCycle2Regret_w0_1_start68,117446,GreedyCycle2Regret_w0_1
102658,3,TSPA,100,200,20789,GreedyCycle2Regret_w0_1_start69,123447,GreedyCycle2Regret_w0_1
93765,4,TSPA,100,200,23109,GreedyCycle2Regret_w0_1_start70,116874,GreedyCycle2Regret_w0_1
95792,3,TSPA,100,200,20240,GreedyCycle2Regret_w0_1_start71,116032,GreedyCycle2Regret_w0_1
94763,4,TSPA,100,200,21156,GreedyCycle2Regret_w0_1_start72,115919,GreedyCycle2Regret_w0_1
96167,4,TSPA,100,200,19843,GreedyCycle2Regret_w0_1_start73,116010,GreedyCycle2Regret_w0_1
93210,4,TSPA,100,200,21767,GreedyCycle2Regret_w0_1_start74,114977,GreedyCycle2Regret_w0_1
90912,3,TSPA,100,200,21880,GreedyCycle2Regret_w0_1_start75,112792,GreedyCycle2Regret_w0_1
94281,4,TSPA,100,200,21944,GreedyCycle2Regret_w0_1_start76,116225,GreedyCycle2Regret_w0_1
92551,3,TSPA,100,200,21074,GreedyCycle2Regret_w0_1_start77,113625,GreedyCycle2Regret_w0_1
97264,4,TSPA,100,200,22066,GreedyCycle2Regret_w0_1_start78,119330,GreedyCycle2Regret_w0_1
95311,4,TSPA,100,200,21375,GreedyCycle2Regret_w0_1_start79,116686,GreedyCycle2Regret_w0_1
99173,3,TSPA,100,200,21651,GreedyCycle2Regret_w0_1_start80,120824,GreedyCycle2Regret_w0_1
93442,4,TSPA,100,200,20744,GreedyCycle2Regret_w0_1_start81,114186,GreedyCycle2Regret_w0_1
93917,4,TSPA,100,200,21028,GreedyCycle2Regret_w0_1_start82,114945,GreedyCycle2Regret_w0_1
94413,3,TSPA,100,200,22466,GreedyCycle2Regret_w0_1_start83,116879,GreedyCycle2Regret_w0_1
94166,4,TSPA,100,200,21048,GreedyCycle2Regret_w0_1_start84,115214,GreedyCycle2Regret_w0_1
96927,4,TSPA,100,200,21864,GreedyCycle2Regret_w0_1_start85,118791,GreedyCycle2Regret_w0_1
93677,4,TSPA,100,200,22414,GreedyCycle2Regret_w0_1_start86,116091,GreedyCycle2Regret_w0_1
101035,4,TSPA,100,200,21666,GreedyCycle2Regret_w0_1_start87,122701,GreedyCycle2Regret_w0_1
100275,3,TSPA,100,200,22021,GreedyCycle2Regret_w0_1_start88,122296,GreedyCycle2Regret_w0_1
92948,4,TSPA,100,200,21922,GreedyCycle2Regret_w0_1_start89,114870,GreedyCycle2Regret_w0_1
91787,4,TSPA,100,200,20526,GreedyCycle2Regret_w0_1_start90,112313,GreedyCycle2Regret_w0_1
96577,3,TSPA,100,200,21731,GreedyCycle2Regret_w0_1_start91,118308,GreedyCycle2Regret_w0_1
92429,4,TSPA,100,200,22203,GreedyCycle2Regret_w0_1_start92,114632,GreedyCycle2Regret_w0_1
95984,4,TSPA,100,200,19075,GreedyCycle2Regret_w0_1_start93,115059,GreedyCycle2Regret_w0_1
90305,3,TSPA,100,200,21631,GreedyCycle2Regret_w0_1_start94,111936,GreedyCycle2Regret_w0_1
97279,4,TSPA,100,200,20212,GreedyCycle2Regret_w0_1_start95,117491,GreedyCycle2Regret_w0_1
97249,4,TSPA,100,200,20084,GreedyCycle2Regret_w0_1_start96,117333,GreedyCycle2Regret_w0_1
91628,3,TSPA,100,200,22049,GreedyCycle2Regret_w0_1_start97,113677,GreedyCycle2Regret_w0_1
95336,4,TSPA,100,200,21627,GreedyCycle2Regret_w0_1_start98,116963,GreedyCycle2Regret_w0_1
94458,4,TSPA,100,200,21667,GreedyCycle2Regret_w0_1_start99,116125,GreedyCycle2Regret_w0_1
96240,4,TSPA,100,200,21198,GreedyCycle2Regret_w0_1_start100,117438,GreedyCycle2Regret_w0_1
93581,4,TSPA,100,200,22443,GreedyCycle2Regret_w0_1_start101,116024,GreedyCycle2Regret_w0_1
96672,3,TSPA,100,200,20664,GreedyCycle2Regret_w0_1_start102,117336,GreedyCycle2Regret_w0_1
99762,4,TSPA,100,200,19478,GreedyCycle2Regret_w0_1_start103,119240,GreedyCycle2Regret_w0_1
95232,4,TSPA,100,200,21560,GreedyCycle2Regret_w0_1_start104,116792,GreedyCycle2Regret_w0_1
93720,4,TSPA,100,200,21230,GreedyCycle2Regret_w0_1_start105,114950,GreedyCycle2Regret_w0_1
99073,3,TSPA,100,200,21134,GreedyCycle2Regret_w0_1_start106,120207,GreedyCycle2Regret_w0_1
95902,4,TSPA,100,200,20583,GreedyCycle2Regret_w0_1_start107,116485,GreedyCycle2Regret_w0_1
99583,4,TSPA,100,200,19052,GreedyCycle2Regret_w0_1_start108,118635,GreedyCycle2Regret_w0_1
96017,3,TSPA,100,200,22362,GreedyCycle2Regret_w0_1_start109,118379,GreedyCycle2Regret_w0_1
95603,4,TSPA,100,200,20771,GreedyCycle2Regret_w0_1_start110,116374,GreedyCycle2Regret_w0_1
94110,4,TSPA,100,200,21283,GreedyCycle2Regret_w0_1_start111,115393,GreedyCycle2Regret_w0_1
91473,3,TSPA,100,200,21774,GreedyCycle2Regret_w0_1_start112,113247,GreedyCycle2Regret_w0_1
97287,3,TSPA,100,200,21815,GreedyCycle2Regret_w0_1_start113,119102,GreedyCycle2Regret_w0_1
94301,4,TSPA,100,200,20521,GreedyCycle2Regret_w0_1_start114,114822,GreedyCycle2Regret_w0_1
93374,4,TSPA,100,200,20563,GreedyCycle2Regret_w0_1_start115,113937,GreedyCycle2Regret_w0_1
95163,3,TSPA,100,200,20692,GreedyCycle2Regret_w0_1_start116,115855,GreedyCycle2Regret_w0_1
98040,4,TSPA,100,200,19296,GreedyCycle2Regret_w0_1_start117,117336,GreedyCycle2Regret_w0_1
97829,3,TSPA,100,200,21014,GreedyCycle2Regret_w0_1_start118,118843,GreedyCycle2Regret_w0_1
93863,4,TSPA,100,200,20187,GreedyCycle2Regret_w0_1_start119,114050,GreedyCycle2Regret_w0_1
93014,4,TSPA,100,200,21033,GreedyCycle2Regret_w0_1_start120,114047,GreedyCycle2Regret_w0_1
96518,4,TSPA,100,200,21422,GreedyCycle2Regret_w0_1_start121,117940,GreedyCycle2Regret_w0_1
96142,4,TSPA,100,200,22383,GreedyCycle2Regret_w0_1_start122,118525,GreedyCycle2Regret_w0_1
92952,3,TSPA,100,200,21286,GreedyCycle2Regret_w0_1_start123,114238,GreedyCycle2Regret_w0_1
101477,4,TSPA,100,200,21591,GreedyCycle2Regret_w0_1_start124,123068,GreedyCycle2Regret_w0_1
96675,4,TSPA,100,200,21576,GreedyCycle2Regret_w0_1_start125,118251,GreedyCycle2Regret_w0_1
91989,4,TSPA,100,200,21659,GreedyCycle2Regret_w0_1_start126,113648,GreedyCycle2Regret_w0_1
95115,3,TSPA,100,200,20943,GreedyCycle2Regret_w0_1_start127,116058,GreedyCycle2Regret_w0_1
96221,4,TSPA,100,200,20964,GreedyCycle2Regret_w0_1_start128,117185,GreedyCycle2Regret_w0_1
94534,4,TSPA,100,200,21897,GreedyCycle2Regret_w0_1_start129,116431,GreedyCycle2Regret_w0_1
91507,3,TSPA,100,200,22011,GreedyCycle2Regret_w0_1_start130,113518,GreedyCycle2Regret_w0_1
95650,4,TSPA,100,200,21234,GreedyCycle2Regret_w0_1_start131,116884,GreedyCycle2Regret_w0_1
95040,4,TSPA,100,200,19511,GreedyCycle2Regret_w0_1_start132,114551,GreedyCycle2Regret_w0_1
96223,4,TSPA,100,200,21355,GreedyCycle2Regret_w0_1_start133,117578,GreedyCycle2Regret_w0_1
101489,3,TSPA,100,200,19677,GreedyCycle2Regret_w0_1_start134,121166,GreedyCycle2Regret_w0_1
95752,4,TSPA,100,200,22043,GreedyCycle2Regret_w0_1_start135,117795,GreedyCycle2Regret_w0_1
94625,4,TSPA,100,200,21770,GreedyCycle2Regret_w0_1_start136,116395,GreedyCycle2Regret_w0_1
96033,4,TSPA,100,200,21458,GreedyCycle2Regret_w0_1_start137,117491,GreedyCycle2Regret_w0_1
95364,4,TSPA,100,200,21619,GreedyCycle2Regret_w0_1_start138,116983,GreedyCycle2Regret_w0_1
94319,3,TSPA,100,200,21149,GreedyCycle2Regret_w0_1_start139,115468,GreedyCycle2Regret_w0_1
98640,4,TSPA,100,200,18852,GreedyCycle2Regret_w0_1_start140,117492,GreedyCycle2Regret_w0_1
92849,4,TSPA,100,200,21828,GreedyCycle2Regret_w0_1_start141,114677,GreedyCycle2Regret_w0_1
98226,3,TSPA,100,200,21018,GreedyCycle2Regret_w0_1_start142,119244,GreedyCycle2Regret_w0_1
93497,4,TSPA,100,200,22212,GreedyCycle2Regret_w0_1_start143,115709,GreedyCycle2Regret_w0_1
95679,3,TSPA,100,200,21088,GreedyCycle2Regret_w0_1_start144,116767,GreedyCycle2Regret_w0_1
96599,4,TSPA,100,200,21546,GreedyCycle2Regret_w0_1_start145,118145,GreedyCycle2Regret_w0_1
100591,4,TSPA,100,200,19267,GreedyCycle2Regret_w0_1_start146,119858,GreedyCycle2Regret_w0_1
96328,4,TSPA,100,200,21432,GreedyCycle2Regret_w0_1_start147,117760,GreedyCycle2Regret_w0_1
86602,3,TSPA,100,200,22202,GreedyCycle2Regret_w0_1_start148,108804,GreedyCycle2Regret_w0_1
96573,4,TSPA,100,200,21522,GreedyCycle2Regret_w0_1_start149,118095,GreedyCycle2Regret_w0_1
91038,4,TSPA,100,200,21396,GreedyCycle2Regret_w0_1_start150,112434,GreedyCycle2Regret_w0_1
93221,4,TSPA,100,200,21662,GreedyCycle2Regret_w0_1_start151,114883,GreedyCycle2Regret_w0_1
94801,4,TSPA,100,200,21721,GreedyCycle2Regret_w0_1_start152,116522,GreedyCycle2Regret_w0_1
94383,3,TSPA,100,200,21195,GreedyCycle2Regret_w0_1_start153,115578,GreedyCycle2Regret_w0_1
95056,4,TSPA,100,200,22283,GreedyCycle2Regret_w0_1_start154,117339,GreedyCycle2Regret_w0_1
97618,4,TSPA,100,200,21145,GreedyCycle2Regret_w0_1_start155,118763,GreedyCycle2Regret_w0_1
93078,4,TSPA,100,200,20495,GreedyCycle2Regret_w0_1_start156,113573,GreedyCycle2Regret_w0_1
97926,4,TSPA,100,200,21623,GreedyCycle2Regret_w0_1_start157,119549,GreedyCycle2Regret_w0_1
95707,3,TSPA,100,200,22118,GreedyCycle2Regret_w0_1_start158,117825,GreedyCycle2Regret_w0_1
96136,4,TSPA,100,200,20482,GreedyCycle2Regret_w0_1_start159,116618,GreedyCycle2Regret_w0_1
93325,5,TSPA,100,200,20976,GreedyCycle2Regret_w0_1_start160,114301,GreedyCycle2Regret_w0_1
94155,4,TSPA,100,200,21654,GreedyCycle2Regret_w0_1_start161,115809,GreedyCycle2Regret_w0_1
95076,4,TSPA,100,200,21574,GreedyCycle2Regret_w0_1_start162,116650,GreedyCycle2Regret_w0_1
95741,5,TSPA,100,200,21809,GreedyCycle2Regret_w0_1_start163,117550,GreedyCycle2Regret_w0_1
98231,5,TSPA,100,200,19908,GreedyCycle2Regret_w0_1_start164,118139,GreedyCycle2Regret_w0_1
96504,4,TSPA,100,200,20955,GreedyCycle2Regret_w0_1_start165,117459,GreedyCycle2Regret_w0_1
96096,4,TSPA,100,200,21640,GreedyCycle2Regret_w0_1_start166,117736,GreedyCycle2Regret_w0_1
93073,4,TSPA,100,200,22054,GreedyCycle2Regret_w0_1_start167,115127,GreedyCycle2Regret_w0_1
95680,4,TSPA,100,200,21682,GreedyCycle2Regret_w0_1_start168,117362,GreedyCycle2Regret_w0_1
96017,4,TSPA,100,200,21231,GreedyCycle2Regret_w0_1_start169,117248,GreedyCycle2Regret_w0_1
95525,4,TSPA,100,200,21705,GreedyCycle2Regret_w0_1_start170,117230,GreedyCycle2Regret_w0_1
95178,5,TSPA,100,200,21750,GreedyCycle2Regret_w0_1_start171,116928,GreedyCycle2Regret_w0_1
94238,4,TSPA,100,200,20633,GreedyCycle2Regret_w0_1_start172,114871,GreedyCycle2Regret_w0_1
91706,4,TSPA,100,200,21864,GreedyCycle2Regret_w0_1_start173,113570,GreedyCycle2Regret_w0_1
94360,4,TSPA,100,200,20271,GreedyCycle2Regret_w0_1_start174,114631,GreedyCycle2Regret_w0_1
99070,4,TSPA,100,200,22127,GreedyCycle2Regret_w0_1_start175,121197,GreedyCycle2Regret_w0_1
94460,4,TSPA,100,200,22591,GreedyCycle2Regret_w0_1_start176,117051,GreedyCycle2Regret_w0_1
94530,4,TSPA,100,200,21391,GreedyCycle2Regret_w0_1_start177,115921,GreedyCycle2Regret_w0_1
94575,4,TSPA,100,200,20933,GreedyCycle2Regret_w0_1_start178,115508,GreedyCycle2Regret_w0_1
96817,4,TSPA,100,200,21637,GreedyCycle2Regret_w0_1_start179,118454,GreedyCycle2Regret_w0_1
94772,4,TSPA,100,200,22570,GreedyCycle2Regret_w0_1_start180,117342,GreedyCycle2Regret_w0_1
98258,4,TSPA,100,200,21201,GreedyCycle2Regret_w0_1_start181,119459,GreedyCycle2Regret_w0_1
96451,4,TSPA,100,200,21389,GreedyCycle2Regret_w0_1_start182,117840,GreedyCycle2Regret_w0_1
94014,4,TSPA,100,200,22245,GreedyCycle2Regret_w0_1_start183,116259,GreedyCycle2Regret_w0_1
94431,4,TSPA,100,200,21361,GreedyCycle2Regret_w0_1_start184,115792,GreedyCycle2Regret_w0_1
93979,4,TSPA,100,200,20790,GreedyCycle2Regret_w0_1_start185,114769,GreedyCycle2Regret_w0_1
94471,4,TSPA,100,200,21161,GreedyCycle2Regret_w0_1_start186,115632,GreedyCycle2Regret_w0_1
94279,4,TSPA,100,200,20370,GreedyCycle2Regret_w0_1_start187,114649,GreedyCycle2Regret_w0_1
98813,4,TSPA,100,200,21797,GreedyCycle2Regret_w0_1_start188,120610,GreedyCycle2Regret_w0_1
92287,4,TSPA,100,200,21923,GreedyCycle2Regret_w0_1_start189,114210,GreedyCycle2Regret_w0_1
94435,4,TSPA,100,200,21156,GreedyCycle2Regret_w0_1_start190,115591,GreedyCycle2Regret_w0_1
94739,5,TSPA,100,200,20328,GreedyCycle2Regret_w0_1_start191,115067,GreedyCycle2Regret_w0_1
94163,5,TSPA,100,200,21129,GreedyCycle2Regret_w0_1_start192,115292,GreedyCycle2Regret_w0_1
94704,4,TSPA,100,200,20552,GreedyCycle2Regret_w0_1_start193,115256,GreedyCycle2Regret_w0_1
95438,4,TSPA,100,200,21447,GreedyCycle2Regret_w0_1_start194,116885,GreedyCycle2Regret_w0_1
101103,4,TSPA,100,200,19420,GreedyCycle2Regret_w0_1_start195,120523,GreedyCycle2Regret_w0_1
94374,4,TSPA,100,200,21501,GreedyCycle2Regret_w0_1_start196,115875,GreedyCycle2Regret_w0_1
94649,4,TSPA,100,200,20583,GreedyCycle2Regret_w0_1_start197,115232,GreedyCycle2Regret_w0_1
96107,4,TSPA,100,200,21711,GreedyCycle2Regret_w0_1_start198,117818,GreedyCycle2Regret_w0_1
99045,4,TSPA,100,200,18589,GreedyCycle2Regret_w0_1_start199,117634,GreedyCycle2Regret_w0_1
89194,3,TSPA,100,200,23597,NearestNeighborAny2Regret_w0_1_start0,112791,NearestNeighborAny2Regret_w0_1
89194,3,TSPA,100,200,23597,NearestNeighborAny2Regret_w0_1_start1,112791,NearestNeighborAny2Regret_w0_1
89535,3,TSPA,100,200,23288,NearestNeighborAny2Regret_w0_1_start2,112823,NearestNeighborAny2Regret_w0_1
97588,2,TSPA,100,200,21542,NearestNeighborAny2Regret_w0_1_start3,119130,NearestNeighborAny2Regret_w0_1
91893,3,TSPA,100,200,23957,NearestNeighborAny2Regret_w0_1_start4,115850,NearestNeighborAny2Regret_w0_1
92238,3,TSPA,100,200,25838,NearestNeighborAny2Regret_w0_1_start5,118076,NearestNeighborAny2Regret_w0_1
93888,2,TSPA,100,200,22313,NearestNeighborAny2Regret_w0_1_start6,116201,NearestNeighborAny2Regret_w0_1
93776,3,TSPA,100,200,23580,NearestNeighborAny2Regret_w0_1_start7,117356,NearestNeighborAny2Regret_w0_1
96901,3,TSPA,100,200,22624,NearestNeighborAny2Regret_w0_1_start8,119525,NearestNeighborAny2Regret_w0_1
91775,3,TSPA,100,200,23164,NearestNeighborAny2Regret_w0_1_start9,114939,NearestNeighborAny2Regret_w0_1
93776,2,TSPA,100,200,23580,NearestNeighborAny2Regret_w0_1_start10,117356,NearestNeighborAny2Regret_w0_1
99209,3,TSPA,100,200,21894,NearestNeighborAny2Regret_w0_1_start11,121103,NearestNeighborAny2Regret_w0_1
92403,3,TSPA,100,200,22588,NearestNeighborAny2Regret_w0_1_start12,114991,NearestNeighborAny2Regret_w0_1
93848,2,TSPA,100,200,22665,NearestNeighborAny2Regret_w0_1_start13,116513,NearestNeighborAny2Regret_w0_1
89877,3,TSPA,100,200,22727,NearestNeighborAny2Regret_w0_1_start14,112604,NearestNeighborAny2Regret_w0_1
94768,3,TSPA,100,200,23343,NearestNeighborAny2Regret_w0_1_start15,118111,NearestNeighborAny2Regret_w0_1
94678,2,TSPA,100,200,23519,NearestNeighborAny2Regret_w0_1_start16,118197,NearestNeighborAny2Regret_w0_1
99717,3,TSPA,100,200,23575,NearestNeighborAny2Regret_w0_1_start17,123292,NearestNeighborAny2Regret_w0_1
89207,3,TSPA,100,200,21702,NearestNeighborAny2Regret_w0_1_start18,110909,NearestNeighborAny2Regret_w0_1
90950,2,TSPA,100,200,22357,NearestNeighborAny2Regret_w0_1_start19,113307,NearestNeighborAny2Regret_w0_1
97932,3,TSPA,100,200,23946,NearestNeighborAny2Regret_w0_1_start20,121878,NearestNeighborAny2Regret_w0_1
91200,3,TSPA,100,200,24625,NearestNeighborAny2Regret_w0_1_start21,115825,NearestNeighborAny2Regret_w0_1
94215,3,TSPA,100,200,22182,NearestNeighborAny2Regret_w0_1_start22,116397,NearestNeighborAny2Regret_w0_1
98165,3,TSPA,100,200,23229,NearestNeighborAny2Regret_w0_1_start23,121394,NearestNeighborAny2Regret_w0_1
100019,2,TSPA,100,200,23154,NearestNeighborAny2Regret_w0_1_start24,123173,NearestNeighborAny2Regret_w0_1
92940,3,TSPA,100,200,23572,NearestNeighborAny2Regret_w0_1_start25,116512,NearestNeighborAny2Regret_w0_1
94259,3,TSPA,100,200,23866,NearestNeighborAny2Regret_w0_1_start26,118125,NearestNeighborAny2Regret_w0_1
95165,2,TSPA,100,200,22206,NearestNeighborAny2Regret_w0_1_start27,117371,NearestNeighborAny2Regret_w0_1
100996,3,TSPA,100,200,22378,NearestNeighborAny2Regret_w0_1_start28,123374,NearestNeighborAny2Regret_w0_1
100184,3,TSPA,100,200,22566,NearestNeighborAny2Regret_w0_1_start29,122750,NearestNeighborAny2Regret_w0_1
91200,2,TSPA,100,200,24625,NearestNeighborAny2Regret_w0_1_start30,115825,NearestNeighborAny2Regret_w0_1
90931,3,TSPA,100,200,23150,NearestNeighborAny2Regret_w0_1_start31,114081,NearestNeighborAny2Regret_w0_1
97132,3,TSPA,100,200,21232,NearestNeighborAny2Regret_w0_1_start32,118364,NearestNeighborAny2Regret_w0_1
98479,2,TSPA,100,200,21899,NearestNeighborAny2Regret_w0_1_start33,120378,NearestNeighborAny2Regret_w0_1
94200,3,TSPA,100,200,24557,NearestNeighborAny2Regret_w0_1_start34,118757,NearestNeighborAny2Regret_w0_1
98458,3,TSPA,100,200,21911,NearestNeighborAny2Regret_w0_1_start35,120369,NearestNeighborAny2Regret_w0_1
93122,2,TSPA,100,200,21526,NearestNeighborAny2Regret_w0_1_start36,114648,NearestNeighborAny2Regret_w0_1
98556,3,TSPA,100,200,21997,NearestNeighborAny2Regret_w0_1_start37,120553,NearestNeighborAny2Regret_w0_1
98205,3,TSPA,100,200,22834,NearestNeighborAny2Regret_w0_1_start38,121039,NearestNeighborAny2Regret_w0_1
93930,2,TSPA,100,200,22423,NearestNeighborAny2Regret_w0_1_start39,116353,NearestNeighborAny2Regret_w0_1
95437,3,TSPA,100,200,21998,NearestNeighborAny2Regret_w0_1_start40,117435,NearestNeighborAny2Regret_w0_1
97275,2,TSPA,100,200,23016,NearestNeighborAny2Regret_w0_1_start41,120291,NearestNeighborAny2Regret_w0_1
96004,3,TSPA,100,200,24505,NearestNeighborAny2Regret_w0_1_start42,120509,NearestNeighborAny2Regret_w0_1
97123,3,TSPA,100,200,22213,NearestNeighborAny2Regret_w0_1_start43,119336,NearestNeighborAny2Regret_w0_1
92403,2,TSPA,100,200,22588,NearestNeighborAny2Regret_w0_1_start44,114991,NearestNeighborAny2Regret_w0_1
92532,3,TSPA,100,200,23621,NearestNeighborAny2Regret_w0_1_start45,116153,NearestNeighborAny2Regret_w0_1
91956,3,TSPA,100,200,23831,NearestNeighborAny2Regret_w0_1_start46,115787,NearestNeighborAny2Regret_w0_1
92436,2,TSPA,100,200,21649,NearestNeighborAny2Regret_w0_1_start47,114085,NearestNeighborAny2Regret_w0_1
93586,3,TSPA,100,200,25576,NearestNeighborAny2Regret_w0_1_start48,119162,NearestNeighborAny2Regret_w0_1
86694,3,TSPA,100,200,22889,NearestNeighborAny2Regret_w0_1_start49,109583,NearestNeighborAny2Regret_w0_1
93820,2,TSPA,100,200,23238,NearestNeighborAny2Regret_w0_1_start50,117058,NearestNeighborAny2Regret_w0_1
90135,3,TSPA,100,200,23935,NearestNeighborAny2Regret_w0_1_start51,114070,NearestNeighborAny2Regret_w0_1
95965,3,TSPA,100,200,21164,NearestNeighborAny2Regret_w0_1_start52,117129,NearestNeighborAny2Regret_w0_1
94472,2,TSPA,100,200,25674,NearestNeighborAny2Regret_w0_1_start53,120146,NearestNeighborAny2Regret_w0_1
92432,3,TSPA,100,200,24365,NearestNeighborAny2Regret_w0_1_start54,116797,NearestNeighborAny2Regret_w0_1
94858,3,TSPA,100,200,21251,NearestNeighborAny2Regret_w0_1_start55,116109,NearestNeighborAny2Regret_w0_1
94321,3,TSPA,100,200,22933,NearestNeighborAny2Regret_w0_1_start56,117254,NearestNeighborAny2Regret_w0_1
100793,2,TSPA,100,200,22734,NearestNeighborAny2Regret_w0_1_start57,123527,NearestNeighborAny2Regret_w0_1
90096,3,TSPA,100,200,23609,NearestNeighborAny2Regret_w0_1_start58,113705,NearestNeighborAny2Regret_w0_1
97620,3,TSPA,100,200,21481,NearestNeighborAny2Regret_w0_1_start59,119101,NearestNeighborAny2Regret_w0_1
99853,2,TSPA,100,200,23709,NearestNeighborAny2Regret_w0_1_start60,123562,NearestNeighborAny2Regret_w0_1
95605,3,TSPA,100,200,21064,NearestNeighborAny2Regret_w0_1_start61,116669,NearestNeighborAny2Regret_w0_1
86316,3,TSPA,100,200,22828,NearestNeighborAny2Regret_w0_1_start62,109144,NearestNeighborAny2Regret_w0_1
93603,2,TSPA,100,200,23808,NearestNeighborAny2Regret_w0_1_start63,117411,NearestNeighborAny2Regret_w0_1
91263,3,TSPA,100,200,21118,NearestNeighborAny2Regret_w0_1_start64,112381,NearestNeighborAny2Regret_w0_1
91575,3,TSPA,100,200,20993,NearestNeighborAny2Regret_w0_1_start65,112568,NearestNeighborAny2Regret_w0_1
91250,2,TSPA,100,200,23698,NearestNeighborAny2Regret_w0_1_start66,114948,NearestNeighborAny2Regret_w0_1
86909,3,TSPA,100,200,21242,NearestNeighborAny2Regret_w0_1_start67,108151,NearestNeighborAny2Regret_w0_1
98856,3,TSPA,100,200,21815,NearestNeighborAny2Regret_w0_1_start68,120671,NearestNeighborAny2Regret_w0_1
91859,2,TSPA,100,200,24677,NearestNeighborAny2Regret_w0_1_start69,116536,NearestNeighborAny2Regret_w0_1
101277,3,TSPA,100,200,23247,NearestNeighborAny2Regret_w0_1_start70,124524,NearestNeighborAny2Regret_w0_1
95008,3,TSPA,100,200,21913,NearestNeighborAny2Regret_w0_1_start71,116921,NearestNeighborAny2Regret_w0_1
94071,3,TSPA,100,200,24135,NearestNeighborAny2Regret_w0_1_start72,118206,NearestNeighborAny2Regret_w0_1
91574,2,TSPA,100,200,22168,NearestNeighborAny2Regret_w0_1_start73,113742,NearestNeighborAny2Regret_w0_1
89465,3,TSPA,100,200,22067,NearestNeighborAny2Regret_w0_1_start74,111532,NearestNeighborAny2Regret_w0_1
91602,3,TSPA,100,200,22888,NearestNeighborAny2Regret_w0_1_start75,114490,NearestNeighborAny2Regret_w0_1
89736,3,TSPA,100,200,21342,NearestNeighborAny2Regret_w0_1_start76,111078,NearestNeighborAny2Regret_w0_1
96230,2,TSPA,100,200,21198,NearestNeighborAny2Regret_w0_1_start77,117428,NearestNeighborAny2Regret_w0_1
93617,3,TSPA,100,200,22142,NearestNeighborAny2Regret_w0_1_start78,115759,NearestNeighborAny2Regret_w0_1
91933,3,TSPA,100,200,23256,NearestNeighborAny2Regret_w0_1_start79,115189,NearestNeighborAny2Regret_w0_1
95097,2,TSPA,100,200,23947,NearestNeighborAny2Regret_w0_1_start80,119044,NearestNeighborAny2Regret_w0_1
91775,3,TSPA,100,200,23164,NearestNeighborAny2Regret_w0_1_start81,114939,NearestNeighborAny2Regret_w0_1
92396,3,TSPA,100,200,23162,NearestNeighborAny2Regret_w0_1_start82,115558,NearestNeighborAny2Regret_w0_1
95650,2,TSPA,100,200,24316,NearestNeighborAny2Regret_w0_1_start83,119966,NearestNeighborAny2Regret_w0_1
98414,3,TSPA,100,200,24902,NearestNeighborAny2Regret_w0_1_start84,123316,NearestNeighborAny2Regret_w0_1
94023,3,TSPA,100,200,22959,NearestNeighborAny2Regret_w0_1_start85,116982,NearestNeighborAny2Regret_w0_1
93748,2,TSPA,100,200,24039,NearestNeighborAny2Regret_w0_1_start86,117787,NearestNeighborAny2Regret_w0_1
100325,3,TSPA,100,200,23542,NearestNeighborAny2Regret_w0_1_start87,123867,NearestNeighborAny2Regret_w0_1
95973,3,TSPA,100,200,23670,NearestNeighborAny2Regret_w0_1_start88,119643,NearestNeighborAny2Regret_w0_1
92733,3,TSPA,100,200,23588,NearestNeighborAny2Regret_w0_1_start89,116321,NearestNeighborAny2Regret_w0_1
95605,2,TSPA,100,200,21064,NearestNeighborAny2Regret_w0_1_start90,116669,NearestNeighborAny2Regret_w0_1
93511,3,TSPA,100,200,21734,NearestNeighborAny2Regret_w0_1_start91,115245,NearestNeighborAny2Regret_w0_1
90992,2,TSPA,100,200,23680,NearestNeighborAny2Regret_w0_1_start92,114672,NearestNeighborAny2Regret_w0_1
96801,3,TSPA,100,200,22151,NearestNeighborAny2Regret_w0_1_start93,118952,NearestNeighborAny2Regret_w0_1
89340,3,TSPA,100,200,22483,NearestNeighborAny2Regret_w0_1_start94,111823,NearestNeighborAny2Regret_w0_1
93616,2,TSPA,100,200,23083,NearestNeighborAny2Regret_w0_1_start95,116699,NearestNeighborAny2Regret_w0_1
94436,3,TSPA,100,200,24693,NearestNeighborAny2Regret_w0_1_start96,119129,NearestNeighborAny2Regret_w0_1
92487,3,TSPA,100,200,22395,NearestNeighborAny2Regret_w0_1_start97,114882,NearestNeighborAny2Regret_w0_1
96259,2,TSPA,100,200,23169,NearestNeighborAny2Regret_w0_1_start98,119428,NearestNeighborAny2Regret_w0_1
94765,3,TSPA,100,200,25585,NearestNeighborAny2Regret_w0_1_start99,120350,NearestNeighborAny2Regret_w0_1
92165,3,TSPA,100,200,23781,NearestNeighborAny2Regret_w0_1_start100,115946,NearestNeighborAny2Regret_w0_1
91827,6,TSPA,100,200,24748,NearestNeighborAny2Regret_w0_1_start101,116575,NearestNeighborAny2Regret_w0_1
93276,3,TSPA,100,200,21277,NearestNeighborAny2Regret_w0_1_start102,114553,NearestNeighborAny2Regret_w0_1
99328,3,TSPA,100,200,22812,NearestNeighborAny2Regret_w0_1_start103,122140,NearestNeighborAny2Regret_w0_1
99849,3,TSPA,100,200,22591,NearestNeighborAny2Regret_w0_1_start104,122440,NearestNeighborAny2Regret_w0_1
90929,2,TSPA,100,200,21791,NearestNeighborAny2Regret_w0_1_start105,112720,NearestNeighborAny2Regret_w0_1
96233,3,TSPA,100,200,21808,NearestNeighborAny2Regret_w0_1_start106,118041,NearestNeighborAny2Regret_w0_1
96149,3,TSPA,100,200,22219,NearestNeighborAny2Regret_w0_1_start107,118368,NearestNeighborAny2Regret_w0_1
90806,3,TSPA,100,200,21926,NearestNeighborAny2Regret_w0_1_start108,112732,NearestNeighborAny2Regret_w0_1
96094,3,TSPA,100,200,23863,NearestNeighborAny2Regret_w0_1_start109,119957,NearestNeighborAny2Regret_w0_1
94795,2,TSPA,100,200,22301,NearestNeighborAny2Regret_w0_1_start110,117096,NearestNeighborAny2Regret_w0_1
92413,4,TSPA,100,200,22940,NearestNeighborAny2Regret_w0_1_start111,115353,NearestNeighborAny2Regret_w0_1
98876,3,TSPA,100,200,24685,NearestNeighborAny2Regret_w0_1_start112,123561,NearestNeighborAny2Regret_w0_1
92413,3,TSPA,100,200,22940,NearestNeighborAny2Regret_w0_1_start113,115353,NearestNeighborAny2Regret_w0_1
96102,3,TSPA,100,200,22010,NearestNeighborAny2Regret_w0_1_start114,118112,NearestNeighborAny2Regret_w0_1
95527,3,TSPA,100,200,24350,NearestNeighborAny2Regret_w0_1_start115,119877,NearestNeighborAny2Regret_w0_1
92306,3,TSPA,100,200,20869,NearestNeighborAny2Regret_w0_1_start116,113175,NearestNeighborAny2Regret_w0_1
93901,4,TSPA,100,200,25807,NearestNeighborAny2Regret_w0_1_start117,119708,NearestNeighborAny2Regret_w0_1
95909,2,TSPA,100,200,21644,NearestNeighborAny2Regret_w0_1_start118,117553,NearestNeighborAny2Regret_w0_1
96224,4,TSPA,100,200,21990,NearestNeighborAny2Regret_w0_1_start119,118214,NearestNeighborAny2Regret_w0_1
91181,3,TSPA,100,200,22671,NearestNeighborAny2Regret_w0_1_start120,113852,NearestNeighborAny2Regret_w0_1
95573,3,TSPA,100,200,24428,NearestNeighborAny2Regret_w0_1_start121,120001,NearestNeighborAny2Regret_w0_1
90658,3,TSPA,100,200,22696,NearestNeighborAny2Regret_w0_1_start122,113354,NearestNeighborAny2Regret_w0_1
96970,3,TSPA,100,200,21867,NearestNeighborAny2Regret_w0_1_start123,118837,NearestNeighborAny2Regret_w0_1
86995,3,TSPA,100,200,24356,NearestNeighborAny2Regret_w0_1_start124,111351,NearestNeighborAny2Regret_w0_1
89846,3,TSPA,100,200,22338,NearestNeighborAny2Regret_w0_1_start125,112184,NearestNeighborAny2Regret_w0_1
101524,3,TSPA,100,200,21335,NearestNeighborAny2Regret_w0_1_start126,122859,NearestNeighborAny2Regret_w0_1
93343,3,TSPA,100,200,22939,NearestNeighborAny2Regret_w0_1_start127,116282,NearestNeighborAny2Regret_w0_1
89343,4,TSPA,100,200,24600,NearestNeighborAny2Regret_w0_1_start128,113943,NearestNeighborAny2Regret_w0_1
90537,2,TSPA,100,200,23117,NearestNeighborAny2Regret_w0_1_start129,113654,NearestNeighborAny2Regret_w0_1
93644,2,TSPA,100,200,22531,NearestNeighborAny2Regret_w0_1_start130,116175,NearestNeighborAny2Regret_w0_1
97937,3,TSPA,100,200,24410,NearestNeighborAny2Regret_w0_1_start131,122347,NearestNeighborAny2Regret_w0_1
99328,3,TSPA,100,200,22812,NearestNeighborAny2Regret_w0_1_start132,122140,NearestNeighborAny2Regret_w0_1
93926,3,TSPA,100,200,24222,NearestNeighborAny2Regret_w0_1_start133,118148,NearestNeighborAny2Regret_w0_1
90994,4,TSPA,100,200,22552,NearestNeighborAny2Regret_w0_1_start134,113546,NearestNeighborAny2Regret_w0_1
90271,5,TSPA,100,200,25275,NearestNeighborAny2Regret_w0_1_start135,115546,NearestNeighborAny2Regret_w0_1
89192,3,TSPA,100,200,23717,NearestNeighborAny2Regret_w0_1_start136,112909,NearestNeighborAny2Regret_w0_1
93368,5,TSPA,100,200,24813,NearestNeighborAny2Regret_w0_1_start137,118181,NearestNeighborAny2Regret_w0_1
92359,3,TSPA,100,200,23314,NearestNeighborAny2Regret_w0_1_start138,115673,NearestNeighborAny2Regret_w0_1
92619,3,TSPA,100,200,22882,NearestNeighborAny2Regret_w0_1_start139,115501,NearestNeighborAny2Regret_w0_1
100385,3,TSPA,100,200,22564,NearestNeighborAny2Regret_w0_1_start140,122949,NearestNeighborAny2Regret_w0_1
92998,3,TSPA,100,200,22369,NearestNeighborAny2Regret_w0_1_start141,115367,NearestNeighborAny2Regret_w0_1
93586,2,TSPA,100,200,22727,NearestNeighborAny2Regret_w0_1_start142,116313,NearestNeighborAny2Regret_w0_1
94523,3,TSPA,100,200,23468,NearestNeighborAny2Regret_w0_1_start143,117991,NearestNeighborAny2Regret_w0_1
98622,3,TSPA,100,200,23543,NearestNeighborAny2Regret_w0_1_start144,122165,NearestNeighborAny2Regret_w0_1
95431,3,TSPA,100,200,21555,NearestNeighborAny2Regret_w0_1_start145,116986,NearestNeighborAny2Regret_w0_1
91574,3,TSPA,100,200,22168,NearestNeighborAny2Regret_w0_1_start146,113742,NearestNeighborAny2Regret_w0_1
94183,3,TSPA,100,200,24420,NearestNeighborAny2Regret_w0_1_start147,118603,NearestNeighborAny2Regret_w0_1
100575,2,TSPA,100,200,22162,NearestNeighborAny2Regret_w0_1_start148,122737,NearestNeighborAny2Regret_w0_1
98014,3,TSPA,100,200,22151,NearestNeighborAny2Regret_w0_1_start149,120165,NearestNeighborAny2Regret_w0_1
92189,3,TSPA,100,200,23252,NearestNeighborAny2Regret_w0_1_start150,115441,NearestNeighborAny2Regret_w0_1
91042,3,TSPA,100,200,23052,NearestNeighborAny2Regret_w0_1_start151,114094,NearestNeighborAny2Regret_w0_1
88147,3,TSPA,100,200,22076,NearestNeighborAny2Regret_w0_1_start152,110223,NearestNeighborAny2Regret_w0_1
94086,2,TSPA,100,200,21979,NearestNeighborAny2Regret_w0_1_start153,116065,NearestNeighborAny2Regret_w0_1
91823,3,TSPA,100,200,23447,NearestNeighborAny2Regret_w0_1_start154,115270,NearestNeighborAny2Regret_w0_1
94499,3,TSPA,100,200,23336,NearestNeighborAny2Regret_w0_1_start155,117835,NearestNeighborAny2Regret_w0_1
99504,3,TSPA,100,200,22268,NearestNeighborAny2Regret_w0_1_start156,121772,NearestNeighborAny2Regret_w0_1
99072,2,TSPA,100,200,22262,NearestNeighborAny2Regret_w0_1_start157,121334,NearestNeighborAny2Regret_w0_1
86347,2,TSPA,100,200,24184,NearestNeighborAny2Regret_w0_1_start158,110531,NearestNeighborAny2Regret_w0_1
99844,3,TSPA,100,200,22922,NearestNeighborAny2Regret_w0_1_start159,122766,NearestNeighborAny2Regret_w0_1
97018,4,TSPA,100,200,22235,NearestNeighborAny2Regret_w0_1_start160,119253,NearestNeighborAny2Regret_w0_1
91527,3,TSPA,100,200,21906,NearestNeighborAny2Regret_w0_1_start161,113433,NearestNeighborAny2Regret_w0_1
89961,3,TSPA,100,200,22497,NearestNeighborAny2Regret_w0_1_start162,112458,NearestNeighborAny2Regret_w0_1
97939,4,TSPA,100,200,22746,NearestNeighborAny2Regret_w0_1_start163,120685,NearestNeighborAny2Regret_w0_1
90350,5,TSPA,100,200,23757,NearestNeighborAny2Regret_w0_1_start164,114107,NearestNeighborAny2Regret_w0_1
90949,3,TSPA,100,200,22099,NearestNeighborAny2Regret_w0_1_start165,113048,NearestNeighborAny2Regret_w0_1
101807,3,TSPA,100,200,22555,NearestNeighborAny2Regret_w0_1_start166,124362,NearestNeighborAny2Regret_w0_1
97521,3,TSPA,100,200,23466,NearestNeighborAny2Regret_w0_1_start167,120987,NearestNeighborAny2Regret_w0_1
93728,3,TSPA,100,200,21648,NearestNeighborAny2Regret_w0_1_start168,115376,NearestNeighborAny2Regret_w0_1
93105,2,TSPA,100,200,23192,NearestNeighborAny2Regret_w0_1_start169,116297,NearestNeighborAny2Regret_w0_1
97443,3,TSPA,100,200,22620,NearestNeighborAny2Regret_w0_1_start170,120063,NearestNeighborAny2Regret_w0_1
92481,3,TSPA,100,200,22607,NearestNeighborAny2Regret_w0_1_start171,115088,NearestNeighborAny2Regret_w0_1
96327,3,TSPA,100,200,24188,NearestNeighborAny2Regret_w0_1_start172,120515,NearestNeighborAny2Regret_w0_1
92511,3,TSPA,100,200,22356,NearestNeighborAny2Regret_w0_1_start173,114867,NearestNeighborAny2Regret_w0_1
93531,3,TSPA,100,200,21855,NearestNeighborAny2Regret_w0_1_start174,115386,NearestNeighborAny2Regret_w0_1
97521,2,TSPA,100,200,23466,NearestNeighborAny2Regret_w0_1_start175,120987,NearestNeighborAny2Regret_w0_1
94975,3,TSPA,100,200,22928,NearestNeighborAny2Regret_w0_1_start176,117903,NearestNeighborAny2Regret_w0_1
100006,3,TSPA,100,200,22508,NearestNeighborAny2Regret_w0_1_start177,122514,NearestNeighborAny2Regret_w0_1
97157,2,TSPA,100,200,21654,NearestNeighborAny2Regret_w0_1_start178,118811,NearestNeighborAny2Regret_w0_1
93922,3,TSPA,100,200,21472,NearestNeighborAny2Regret_w0_1_start179,115394,NearestNeighborAny2Regret_w0_1
89971,3,TSPA,100,200,23314,NearestNeighborAny2Regret_w0_1_start180,113285,NearestNeighborAny2Regret_w0_1
102275,2,TSPA,100,200,22646,NearestNeighborAny2Regret_w0_1_start181,124921,NearestNeighborAny2Regret_w0_1
90384,3,TSPA,100,200,23566,NearestNeighborAny2Regret_w0_1_start182,113950,NearestNeighborAny2Regret_w0_1
94115,3,TSPA,100,200,23272,NearestNeighborAny2Regret_w0_1_start183,117387,NearestNeighborAny2Regret_w0_1
98673,3,TSPA,100,200,22473,NearestNeighborAny2Regret_w0_1_start184,121146,NearestNeighborAny2Regret_w0_1
87503,2,TSPA,100,200,22912,NearestNeighborAny2Regret_w0_1_start185,110415,NearestNeighborAny2Regret_w0_1
88199,3,TSPA,100,200,23554,NearestNeighborAny2Regret_w0_1_start186,111753,NearestNeighborAny2Regret_w0_1
99269,3,TSPA,100,200,20854,NearestNeighborAny2Regret_w0_1_start187,120123,NearestNeighborAny2Regret_w0_1
94707,3,TSPA,100,200,22965,NearestNeighborAny2Regret_w0_1_start188,117672,NearestNeighborAny2Regret_w0_1
92416,2,TSPA,100,200,22979,NearestNeighborAny2Regret_w0_1_start189,115395,NearestNeighborAny2Regret_w0_1
93251,3,TSPA,100,200,22912,NearestNeighborAny2Regret_w0_1_start190,116163,NearestNeighborAny2Regret_w0_1
96014,3,TSPA,100,200,22778,NearestNeighborAny2Regret_w0_1_start191,118792,NearestNeighborAny2Regret_w0_1
96469,2,TSPA,100,200,22909,NearestNeighborAny2Regret_w0_1_start192,119378,NearestNeighborAny2Regret_w0_1
96469,3,TSPA,100,200,22909,NearestNeighborAny2Regret_w0_1_start193,119378,NearestNeighborAny2Regret_w0_1
95463,3,TSPA,100,200,21118,NearestNeighborAny2Regret_w0_1_start194,116581,NearestNeighborAny2Regret_w0_1
89994,3,TSPA,100,200,22709,NearestNeighborAny2Regret_w0_1_start195,112703,NearestNeighborAny2Regret_w0_1
86406,2,TSPA,100,200,22483,NearestNeighborAny2Regret_w0_1_start196,108889,NearestNeighborAny2Regret_w0_1
100856,2,TSPA,100,200,23175,NearestNeighborAny2Regret_w0_1_start197,124031,NearestNeighborAny2Regret_w0_1
96044,3,TSPA,100,200,22839,NearestNeighborAny2Regret_w0_1_start198,118883,NearestNeighborAny2Regret_w0_1
90780,3,TSPA,100,200,22792,NearestNeighborAny2Regret_w0_1_start199,113572,NearestNeighborAny2Regret_w0_1
