algorithm,instance,objective_value,path_length,node_costs,computation_time_ms,selected_nodes,total_nodes
GreedyCycle2Regret_w1_1_start0,TSPB,51749,18657,33092,5,100,200
GreedyCycle2Regret_w1_1_start1,TSPB,51886,19591,32295,4,100,200
GreedyCycle2Regret_w1_1_start2,TSPB,49288,20242,29046,5,100,200
GreedyCycle2Regret_w1_1_start3,TSPB,50083,17572,32511,4,100,200
GreedyCycle2Regret_w1_1_start4,TSPB,47550,20891,26659,4,100,200
GreedyCycle2Regret_w1_1_start5,TSPB,52253,19921,32332,5,100,200
GreedyCycle2Regret_w1_1_start6,TSPB,50821,20739,30082,4,100,200
GreedyCycle2Regret_w1_1_start7,TSPB,53033,19821,33212,4,100,200
GreedyCycle2Regret_w1_1_start8,TSPB,49197,20542,28655,4,100,200
GreedyCycle2Regret_w1_1_start9,TSPB,47424,21202,26222,4,100,200
GreedyCycle2Regret_w1_1_start10,TSPB,53213,18892,34321,4,100,200
GreedyCycle2Regret_w1_1_start11,TSPB,51749,18657,33092,5,100,200
GreedyCycle2Regret_w1_1_start12,TSPB,51914,18824,33090,4,100,200
GreedyCycle2Regret_w1_1_start13,TSPB,49084,20332,28752,4,100,200
GreedyCycle2Regret_w1_1_start14,TSPB,52001,20501,31500,4,100,200
GreedyCycle2Regret_w1_1_start15,TSPB,50083,17572,32511,4,100,200
GreedyCycle2Regret_w1_1_start16,TSPB,53956,19040,34916,4,100,200
GreedyCycle2Regret_w1_1_start17,TSPB,52706,19106,33600,4,100,200
GreedyCycle2Regret_w1_1_start18,TSPB,51009,17976,33033,5,100,200
GreedyCycle2Regret_w1_1_start19,TSPB,54018,19102,34916,4,100,200
GreedyCycle2Regret_w1_1_start20,TSPB,47199,21075,26124,4,100,200
GreedyCycle2Regret_w1_1_start21,TSPB,51988,19327,32661,4,100,200
GreedyCycle2Regret_w1_1_start22,TSPB,48156,20514,27642,4,100,200
GreedyCycle2Regret_w1_1_start23,TSPB,47660,21074,26586,4,100,200
GreedyCycle2Regret_w1_1_start24,TSPB,52667,18391,34276,4,100,200
GreedyCycle2Regret_w1_1_start25,TSPB,53794,20314,33480,4,100,200
GreedyCycle2Regret_w1_1_start26,TSPB,51704,21475,30229,4,100,200
GreedyCycle2Regret_w1_1_start27,TSPB,54018,19102,34916,4,100,200
GreedyCycle2Regret_w1_1_start28,TSPB,47550,20891,26659,4,100,200
GreedyCycle2Regret_w1_1_start29,TSPB,51749,18657,33092,4,100,200
GreedyCycle2Regret_w1_1_start30,TSPB,52898,20435,32463,4,100,200
GreedyCycle2Regret_w1_1_start31,TSPB,51743,20490,31253,4,100,200
GreedyCycle2Regret_w1_1_start32,TSPB,52683,19033,33650,4,100,200
GreedyCycle2Regret_w1_1_start33,TSPB,51749,18657,33092,4,100,200
GreedyCycle2Regret_w1_1_start34,TSPB,50969,21661,29308,4,100,200
GreedyCycle2Regret_w1_1_start35,TSPB,51749,18657,33092,4,100,200
GreedyCycle2Regret_w1_1_start36,TSPB,52598,20266,32332,4,100,200
GreedyCycle2Regret_w1_1_start37,TSPB,49684,21125,28559,4,100,200
GreedyCycle2Regret_w1_1_start38,TSPB,53651,19561,34090,4,100,200
GreedyCycle2Regret_w1_1_start39,TSPB,51917,18829,33088,4,100,200
GreedyCycle2Regret_w1_1_start40,TSPB,52654,19069,33585,4,100,200
GreedyCycle2Regret_w1_1_start41,TSPB,49532,21139,28393,4,100,200
GreedyCycle2Regret_w1_1_start42,TSPB,52796,20596,32200,4,100,200
GreedyCycle2Regret_w1_1_start43,TSPB,51003,20914,30089,4,100,200
GreedyCycle2Regret_w1_1_start44,TSPB,53554,18861,34693,4,100,200
GreedyCycle2Regret_w1_1_start45,TSPB,52253,19921,32332,4,100,200
GreedyCycle2Regret_w1_1_start46,TSPB,52098,19917,32181,4,100,200
GreedyCycle2Regret_w1_1_start47,TSPB,47922,21263,26659,4,100,200
GreedyCycle2Regret_w1_1_start48,TSPB,49042,20992,28050,4,100,200
GreedyCycle2Regret_w1_1_start49,TSPB,49238,21139,28099,4,100,200
GreedyCycle2Regret_w1_1_start50,TSPB,52048,20554,31494,4,100,200
GreedyCycle2Regret_w1_1_start51,TSPB,52453,20393,32060,4,100,200
GreedyCycle2Regret_w1_1_start52,TSPB,48343,20562,27781,5,100,200
GreedyCycle2Regret_w1_1_start53,TSPB,48309,20472,27837,4,100,200
GreedyCycle2Regret_w1_1_start54,TSPB,51743,20490,31253,4,100,200
GreedyCycle2Regret_w1_1_start55,TSPB,48054,21600,26454,4,100,200
GreedyCycle2Regret_w1_1_start56,TSPB,52326,19720,32606,4,100,200
GreedyCycle2Regret_w1_1_start57,TSPB,47550,20891,26659,4,100,200
GreedyCycle2Regret_w1_1_start58,TSPB,52261,19929,32332,4,100,200
GreedyCycle2Regret_w1_1_start59,TSPB,47550,20891,26659,4,100,200
GreedyCycle2Regret_w1_1_start60,TSPB,47199,21075,26124,4,100,200
GreedyCycle2Regret_w1_1_start61,TSPB,52598,20266,32332,4,100,200
GreedyCycle2Regret_w1_1_start62,TSPB,48054,21600,26454,5,100,200
GreedyCycle2Regret_w1_1_start63,TSPB,53213,18892,34321,4,100,200
GreedyCycle2Regret_w1_1_start64,TSPB,51567,21182,30385,4,100,200
GreedyCycle2Regret_w1_1_start65,TSPB,50172,17520,32652,4,100,200
GreedyCycle2Regret_w1_1_start66,TSPB,47647,21246,26401,4,100,200
GreedyCycle2Regret_w1_1_start67,TSPB,52146,19669,32477,4,100,200
GreedyCycle2Regret_w1_1_start68,TSPB,54296,19699,34597,4,100,200
GreedyCycle2Regret_w1_1_start69,TSPB,52475,18615,33860,4,100,200
GreedyCycle2Regret_w1_1_start70,TSPB,50083,17572,32511,3,100,200
GreedyCycle2Regret_w1_1_start71,TSPB,51754,19410,32344,3,100,200
GreedyCycle2Regret_w1_1_start72,TSPB,52654,19069,33585,4,100,200
GreedyCycle2Regret_w1_1_start73,TSPB,51743,20490,31253,4,100,200
GreedyCycle2Regret_w1_1_start74,TSPB,52122,19792,32330,4,100,200
GreedyCycle2Regret_w1_1_start75,TSPB,52053,21468,30585,4,100,200
GreedyCycle2Regret_w1_1_start76,TSPB,51939,21231,30708,4,100,200
GreedyCycle2Regret_w1_1_start77,TSPB,56747,17821,38926,4,100,200
GreedyCycle2Regret_w1_1_start78,TSPB,52253,19921,32332,4,100,200
GreedyCycle2Regret_w1_1_start79,TSPB,53183,20132,33051,4,100,200
GreedyCycle2Regret_w1_1_start80,TSPB,51578,20325,31253,4,100,200
GreedyCycle2Regret_w1_1_start81,TSPB,51753,21460,30293,4,100,200
GreedyCycle2Regret_w1_1_start82,TSPB,51988,19327,32661,4,100,200
GreedyCycle2Regret_w1_1_start83,TSPB,48583,20796,27787,4,100,200
GreedyCycle2Regret_w1_1_start84,TSPB,51891,18320,33571,4,100,200
GreedyCycle2Regret_w1_1_start85,TSPB,51047,18933,32114,4,100,200
GreedyCycle2Regret_w1_1_start86,TSPB,48135,21090,27045,4,100,200
GreedyCycle2Regret_w1_1_start87,TSPB,51930,19324,32606,4,100,200
GreedyCycle2Regret_w1_1_start88,TSPB,51361,21219,30142,4,100,200
GreedyCycle2Regret_w1_1_start89,TSPB,51704,21475,30229,4,100,200
GreedyCycle2Regret_w1_1_start90,TSPB,52137,19212,32925,4,100,200
GreedyCycle2Regret_w1_1_start91,TSPB,52598,20266,32332,4,100,200
GreedyCycle2Regret_w1_1_start92,TSPB,51896,19113,32783,4,100,200
GreedyCycle2Regret_w1_1_start93,TSPB,52922,21469,31453,4,100,200
GreedyCycle2Regret_w1_1_start94,TSPB,47922,21263,26659,4,100,200
GreedyCycle2Regret_w1_1_start95,TSPB,48135,21090,27045,4,100,200
GreedyCycle2Regret_w1_1_start96,TSPB,52719,19040,33679,4,100,200
GreedyCycle2Regret_w1_1_start97,TSPB,51753,21460,30293,4,100,200
GreedyCycle2Regret_w1_1_start98,TSPB,51328,19765,31563,3,100,200
GreedyCycle2Regret_w1_1_start99,TSPB,47995,20918,27077,4,100,200
GreedyCycle2Regret_w1_1_start100,TSPB,52726,19141,33585,5,100,200
GreedyCycle2Regret_w1_1_start101,TSPB,48049,20699,27350,4,100,200
GreedyCycle2Regret_w1_1_start102,TSPB,52654,19069,33585,4,100,200
GreedyCycle2Regret_w1_1_start103,TSPB,51704,21475,30229,4,100,200
GreedyCycle2Regret_w1_1_start104,TSPB,49191,20990,28201,4,100,200
GreedyCycle2Regret_w1_1_start105,TSPB,52172,20058,32114,4,100,200
GreedyCycle2Regret_w1_1_start106,TSPB,48054,21600,26454,4,100,200
GreedyCycle2Regret_w1_1_start107,TSPB,52156,19304,32852,4,100,200
GreedyCycle2Regret_w1_1_start108,TSPB,53512,20660,32852,4,100,200
GreedyCycle2Regret_w1_1_start109,TSPB,51749,18657,33092,4,100,200
GreedyCycle2Regret_w1_1_start110,TSPB,52970,21005,31965,4,100,200
GreedyCycle2Regret_w1_1_start111,TSPB,49206,21005,28201,4,100,200
GreedyCycle2Regret_w1_1_start112,TSPB,53956,19040,34916,4,100,200
GreedyCycle2Regret_w1_1_start113,TSPB,48299,20657,27642,4,100,200
GreedyCycle2Regret_w1_1_start114,TSPB,48198,21255,26943,5,100,200
GreedyCycle2Regret_w1_1_start115,TSPB,53213,18892,34321,4,100,200
GreedyCycle2Regret_w1_1_start116,TSPB,53205,20446,32759,3,100,200
GreedyCycle2Regret_w1_1_start117,TSPB,51681,20428,31253,4,100,200
GreedyCycle2Regret_w1_1_start118,TSPB,53215,20044,33171,4,100,200
GreedyCycle2Regret_w1_1_start119,TSPB,51335,18193,33142,4,100,200
GreedyCycle2Regret_w1_1_start120,TSPB,52045,19665,32380,4,100,200
GreedyCycle2Regret_w1_1_start121,TSPB,54049,19133,34916,4,100,200
GreedyCycle2Regret_w1_1_start122,TSPB,52482,19481,33001,4,100,200
GreedyCycle2Regret_w1_1_start123,TSPB,53154,19973,33181,4,100,200
GreedyCycle2Regret_w1_1_start124,TSPB,47929,21475,26454,4,100,200
GreedyCycle2Regret_w1_1_start125,TSPB,52725,19193,33532,4,100,200
GreedyCycle2Regret_w1_1_start126,TSPB,49202,20314,28888,4,100,200
GreedyCycle2Regret_w1_1_start127,TSPB,51704,21475,30229,4,100,200
GreedyCycle2Regret_w1_1_start128,TSPB,51237,21147,30090,4,100,200
GreedyCycle2Regret_w1_1_start129,TSPB,50769,21168,29601,4,100,200
GreedyCycle2Regret_w1_1_start130,TSPB,47995,20918,27077,3,100,200
GreedyCycle2Regret_w1_1_start131,TSPB,51886,19591,32295,4,100,200
GreedyCycle2Regret_w1_1_start132,TSPB,49084,20332,28752,4,100,200
GreedyCycle2Regret_w1_1_start133,TSPB,52883,19298,33585,4,100,200
GreedyCycle2Regret_w1_1_start134,TSPB,51426,18275,33151,4,100,200
GreedyCycle2Regret_w1_1_start135,TSPB,52654,19069,33585,4,100,200
GreedyCycle2Regret_w1_1_start136,TSPB,51578,20325,31253,4,100,200
GreedyCycle2Regret_w1_1_start137,TSPB,51393,21239,30154,4,100,200
GreedyCycle2Regret_w1_1_start138,TSPB,51749,18657,33092,4,100,200
GreedyCycle2Regret_w1_1_start139,TSPB,51853,18396,33457,4,100,200
GreedyCycle2Regret_w1_1_start140,TSPB,47995,20918,27077,4,100,200
GreedyCycle2Regret_w1_1_start141,TSPB,51753,21460,30293,4,100,200
GreedyCycle2Regret_w1_1_start142,TSPB,52253,19921,32332,4,100,200
GreedyCycle2Regret_w1_1_start143,TSPB,52635,19758,32877,4,100,200
GreedyCycle2Regret_w1_1_start144,TSPB,49421,21240,28181,4,100,200
GreedyCycle2Regret_w1_1_start145,TSPB,50083,17572,32511,4,100,200
GreedyCycle2Regret_w1_1_start146,TSPB,51753,21460,30293,4,100,200
GreedyCycle2Regret_w1_1_start147,TSPB,51078,19884,31194,4,100,200
GreedyCycle2Regret_w1_1_start148,TSPB,47647,21246,26401,4,100,200
GreedyCycle2Regret_w1_1_start149,TSPB,47550,20891,26659,4,100,200
GreedyCycle2Regret_w1_1_start150,TSPB,51974,18663,33311,4,100,200
GreedyCycle2Regret_w1_1_start151,TSPB,52023,18514,33509,4,100,200
GreedyCycle2Regret_w1_1_start152,TSPB,47995,20918,27077,4,100,200
GreedyCycle2Regret_w1_1_start153,TSPB,51101,21461,29640,4,100,200
GreedyCycle2Regret_w1_1_start154,TSPB,48309,21083,27226,4,100,200
GreedyCycle2Regret_w1_1_start155,TSPB,52147,19055,33092,4,100,200
GreedyCycle2Regret_w1_1_start156,TSPB,52023,18514,33509,4,100,200
GreedyCycle2Regret_w1_1_start157,TSPB,50068,21355,28713,4,100,200
GreedyCycle2Regret_w1_1_start158,TSPB,50289,20485,29804,4,100,200
GreedyCycle2Regret_w1_1_start159,TSPB,51009,17976,33033,4,100,200
GreedyCycle2Regret_w1_1_start160,TSPB,51792,18828,32964,4,100,200
GreedyCycle2Regret_w1_1_start161,TSPB,50083,17572,32511,4,100,200
GreedyCycle2Regret_w1_1_start162,TSPB,51578,20325,31253,4,100,200
GreedyCycle2Regret_w1_1_start163,TSPB,51711,21482,30229,4,100,200
GreedyCycle2Regret_w1_1_start164,TSPB,51743,20490,31253,4,100,200
GreedyCycle2Regret_w1_1_start165,TSPB,51850,21621,30229,4,100,200
GreedyCycle2Regret_w1_1_start166,TSPB,48299,20657,27642,4,100,200
GreedyCycle2Regret_w1_1_start167,TSPB,51960,18469,33491,4,100,200
GreedyCycle2Regret_w1_1_start168,TSPB,50908,20854,30054,4,100,200
GreedyCycle2Regret_w1_1_start169,TSPB,49084,20332,28752,4,100,200
GreedyCycle2Regret_w1_1_start170,TSPB,47995,20918,27077,4,100,200
GreedyCycle2Regret_w1_1_start171,TSPB,53219,19999,33220,4,100,200
GreedyCycle2Regret_w1_1_start172,TSPB,48115,21070,27045,4,100,200
GreedyCycle2Regret_w1_1_start173,TSPB,51925,20320,31605,4,100,200
GreedyCycle2Regret_w1_1_start174,TSPB,49196,21310,27886,4,100,200
GreedyCycle2Regret_w1_1_start175,TSPB,52253,19921,32332,5,100,200
GreedyCycle2Regret_w1_1_start176,TSPB,50769,21168,29601,4,100,200
GreedyCycle2Regret_w1_1_start177,TSPB,52253,19921,32332,4,100,200
GreedyCycle2Regret_w1_1_start178,TSPB,53213,18892,34321,4,100,200
GreedyCycle2Regret_w1_1_start179,TSPB,48299,20657,27642,4,100,200
GreedyCycle2Regret_w1_1_start180,TSPB,48389,20496,27893,4,100,200
GreedyCycle2Regret_w1_1_start181,TSPB,47897,20595,27302,4,100,200
GreedyCycle2Regret_w1_1_start182,TSPB,51749,18657,33092,4,100,200
GreedyCycle2Regret_w1_1_start183,TSPB,47995,20918,27077,4,100,200
GreedyCycle2Regret_w1_1_start184,TSPB,48361,21932,26429,4,100,200
GreedyCycle2Regret_w1_1_start185,TSPB,48135,21090,27045,4,100,200
GreedyCycle2Regret_w1_1_start186,TSPB,51753,21460,30293,4,100,200
GreedyCycle2Regret_w1_1_start187,TSPB,51753,21460,30293,4,100,200
GreedyCycle2Regret_w1_1_start188,TSPB,49084,20332,28752,4,100,200
GreedyCycle2Regret_w1_1_start189,TSPB,51816,18317,33499,4,100,200
GreedyCycle2Regret_w1_1_start190,TSPB,51578,20325,31253,4,100,200
GreedyCycle2Regret_w1_1_start191,TSPB,51328,19765,31563,3,100,200
GreedyCycle2Regret_w1_1_start192,TSPB,51958,18659,33299,4,100,200
GreedyCycle2Regret_w1_1_start193,TSPB,51743,20490,31253,4,100,200
GreedyCycle2Regret_w1_1_start194,TSPB,48299,20657,27642,4,100,200
GreedyCycle2Regret_w1_1_start195,TSPB,49084,20332,28752,4,100,200
GreedyCycle2Regret_w1_1_start196,TSPB,53494,20355,33139,4,100,200
GreedyCycle2Regret_w1_1_start197,TSPB,52687,18404,34283,4,100,200
GreedyCycle2Regret_w1_1_start198,TSPB,51684,20431,31253,4,100,200
GreedyCycle2Regret_w1_1_start199,TSPB,47144,21152,25992,4,100,200
NearestNeighborAny2Regret_w1_1_start0,TSPB,46217,19452,26765,3,100,200
NearestNeighborAny2Regret_w1_1_start1,TSPB,44891,20139,24752,3,100,200
NearestNeighborAny2Regret_w1_1_start2,TSPB,46545,19125,27420,2,100,200
NearestNeighborAny2Regret_w1_1_start3,TSPB,48878,20730,28148,3,100,200
NearestNeighborAny2Regret_w1_1_start4,TSPB,48889,22026,26863,3,100,200
NearestNeighborAny2Regret_w1_1_start5,TSPB,48153,20608,27545,2,100,200
NearestNeighborAny2Regret_w1_1_start6,TSPB,46162,20957,25205,3,100,200
NearestNeighborAny2Regret_w1_1_start7,TSPB,50318,18855,31463,3,100,200
NearestNeighborAny2Regret_w1_1_start8,TSPB,46217,19452,26765,3,100,200
NearestNeighborAny2Regret_w1_1_start9,TSPB,46612,20258,26354,2,100,200
NearestNeighborAny2Regret_w1_1_start10,TSPB,47096,22351,24745,3,100,200
NearestNeighborAny2Regret_w1_1_start11,TSPB,50598,19832,30766,3,100,200
NearestNeighborAny2Regret_w1_1_start12,TSPB,46539,19490,27049,3,100,200
NearestNeighborAny2Regret_w1_1_start13,TSPB,48816,20423,28393,2,100,200
NearestNeighborAny2Regret_w1_1_start14,TSPB,48348,20134,28214,3,100,200
NearestNeighborAny2Regret_w1_1_start15,TSPB,48878,20730,28148,3,100,200
NearestNeighborAny2Regret_w1_1_start16,TSPB,44891,20139,24752,3,100,200
NearestNeighborAny2Regret_w1_1_start17,TSPB,45722,19869,25853,2,100,200
NearestNeighborAny2Regret_w1_1_start18,TSPB,48889,22026,26863,3,100,200
NearestNeighborAny2Regret_w1_1_start19,TSPB,45443,19918,25525,3,100,200
NearestNeighborAny2Regret_w1_1_start20,TSPB,48341,19783,28558,2,100,200
NearestNeighborAny2Regret_w1_1_start21,TSPB,47246,20423,26823,3,100,200
NearestNeighborAny2Regret_w1_1_start22,TSPB,48341,19783,28558,2,100,200
NearestNeighborAny2Regret_w1_1_start23,TSPB,49131,21978,27153,3,100,200
NearestNeighborAny2Regret_w1_1_start24,TSPB,45353,20290,25063,3,100,200
NearestNeighborAny2Regret_w1_1_start25,TSPB,48341,19783,28558,3,100,200
NearestNeighborAny2Regret_w1_1_start26,TSPB,45138,20124,25014,2,100,200
NearestNeighborAny2Regret_w1_1_start27,TSPB,46162,20957,25205,3,100,200
NearestNeighborAny2Regret_w1_1_start28,TSPB,48889,22026,26863,3,100,200
NearestNeighborAny2Regret_w1_1_start29,TSPB,46217,19452,26765,3,100,200
NearestNeighborAny2Regret_w1_1_start30,TSPB,45414,20341,25073,2,100,200
NearestNeighborAny2Regret_w1_1_start31,TSPB,46759,20593,26166,3,100,200
NearestNeighborAny2Regret_w1_1_start32,TSPB,48221,19639,28582,3,100,200
NearestNeighborAny2Regret_w1_1_start33,TSPB,46217,19452,26765,2,100,200
NearestNeighborAny2Regret_w1_1_start34,TSPB,46721,20336,26385,3,100,200
NearestNeighborAny2Regret_w1_1_start35,TSPB,46217,19452,26765,3,100,200
NearestNeighborAny2Regret_w1_1_start36,TSPB,48341,19783,28558,2,100,200
NearestNeighborAny2Regret_w1_1_start37,TSPB,49124,24082,25042,3,100,200
NearestNeighborAny2Regret_w1_1_start38,TSPB,46239,20932,25307,3,100,200
NearestNeighborAny2Regret_w1_1_start39,TSPB,51138,20186,30952,2,100,200
NearestNeighborAny2Regret_w1_1_start40,TSPB,48341,19783,28558,3,100,200
NearestNeighborAny2Regret_w1_1_start41,TSPB,48270,20155,28115,3,100,200
NearestNeighborAny2Regret_w1_1_start42,TSPB,45217,20392,24825,3,100,200
NearestNeighborAny2Regret_w1_1_start43,TSPB,48878,20730,28148,2,100,200
NearestNeighborAny2Regret_w1_1_start44,TSPB,48966,20722,28244,3,100,200
NearestNeighborAny2Regret_w1_1_start45,TSPB,48153,20608,27545,3,100,200
NearestNeighborAny2Regret_w1_1_start46,TSPB,46809,19525,27284,2,100,200
NearestNeighborAny2Regret_w1_1_start47,TSPB,48341,19783,28558,3,100,200
NearestNeighborAny2Regret_w1_1_start48,TSPB,55247,23790,31457,3,100,200
NearestNeighborAny2Regret_w1_1_start49,TSPB,46331,19255,27076,2,100,200
NearestNeighborAny2Regret_w1_1_start50,TSPB,48322,20114,28208,2,100,200
NearestNeighborAny2Regret_w1_1_start51,TSPB,46759,20593,26166,3,100,200
NearestNeighborAny2Regret_w1_1_start52,TSPB,48964,19811,29153,3,100,200
NearestNeighborAny2Regret_w1_1_start53,TSPB,46625,19962,26663,2,100,200
NearestNeighborAny2Regret_w1_1_start54,TSPB,46759,20593,26166,3,100,200
NearestNeighborAny2Regret_w1_1_start55,TSPB,48889,22026,26863,3,100,200
NearestNeighborAny2Regret_w1_1_start56,TSPB,48268,20296,27972,3,100,200
NearestNeighborAny2Regret_w1_1_start57,TSPB,48341,19783,28558,2,100,200
NearestNeighborAny2Regret_w1_1_start58,TSPB,49415,21049,28366,3,100,200
NearestNeighborAny2Regret_w1_1_start59,TSPB,48889,22026,26863,3,100,200
NearestNeighborAny2Regret_w1_1_start60,TSPB,48889,22026,26863,3,100,200
NearestNeighborAny2Regret_w1_1_start61,TSPB,48341,19783,28558,3,100,200
NearestNeighborAny2Regret_w1_1_start62,TSPB,48889,22026,26863,3,100,200
NearestNeighborAny2Regret_w1_1_start63,TSPB,48192,19675,28517,2,100,200
NearestNeighborAny2Regret_w1_1_start64,TSPB,46360,19703,26657,3,100,200
NearestNeighborAny2Regret_w1_1_start65,TSPB,49063,20420,28643,3,100,200
NearestNeighborAny2Regret_w1_1_start66,TSPB,48341,19783,28558,3,100,200
NearestNeighborAny2Regret_w1_1_start67,TSPB,46226,21000,25226,3,100,200
NearestNeighborAny2Regret_w1_1_start68,TSPB,51540,18686,32854,3,100,200
NearestNeighborAny2Regret_w1_1_start69,TSPB,46552,20294,26258,3,100,200
NearestNeighborAny2Regret_w1_1_start70,TSPB,48878,20730,28148,2,100,200
NearestNeighborAny2Regret_w1_1_start71,TSPB,47469,19132,28337,3,100,200
NearestNeighborAny2Regret_w1_1_start72,TSPB,45679,19942,25737,2,100,200
NearestNeighborAny2Regret_w1_1_start73,TSPB,45893,20477,25416,3,100,200
NearestNeighborAny2Regret_w1_1_start74,TSPB,48585,22572,26013,3,100,200
NearestNeighborAny2Regret_w1_1_start75,TSPB,46246,20902,25344,3,100,200
NearestNeighborAny2Regret_w1_1_start76,TSPB,53929,21331,32598,2,100,200
NearestNeighborAny2Regret_w1_1_start77,TSPB,44891,20139,24752,3,100,200
NearestNeighborAny2Regret_w1_1_start78,TSPB,48153,20608,27545,3,100,200
NearestNeighborAny2Regret_w1_1_start79,TSPB,48402,19764,28638,3,100,200
NearestNeighborAny2Regret_w1_1_start80,TSPB,46759,20593,26166,2,100,200
NearestNeighborAny2Regret_w1_1_start81,TSPB,48889,22026,26863,3,100,200
NearestNeighborAny2Regret_w1_1_start82,TSPB,47983,20935,27048,2,100,200
NearestNeighborAny2Regret_w1_1_start83,TSPB,49121,22022,27099,3,100,200
NearestNeighborAny2Regret_w1_1_start84,TSPB,46092,19488,26604,3,100,200
NearestNeighborAny2Regret_w1_1_start85,TSPB,46127,19456,26671,2,100,200
NearestNeighborAny2Regret_w1_1_start86,TSPB,48341,19783,28558,3,100,200
NearestNeighborAny2Regret_w1_1_start87,TSPB,47357,20397,26960,3,100,200
NearestNeighborAny2Regret_w1_1_start88,TSPB,48495,19801,28694,2,100,200
NearestNeighborAny2Regret_w1_1_start89,TSPB,48341,19783,28558,3,100,200
NearestNeighborAny2Regret_w1_1_start90,TSPB,45443,19918,25525,3,100,200
NearestNeighborAny2Regret_w1_1_start91,TSPB,48341,19783,28558,2,100,200
NearestNeighborAny2Regret_w1_1_start92,TSPB,48469,19790,28679,3,100,200
NearestNeighborAny2Regret_w1_1_start93,TSPB,52544,20927,31617,3,100,200
NearestNeighborAny2Regret_w1_1_start94,TSPB,48341,19783,28558,2,100,200
NearestNeighborAny2Regret_w1_1_start95,TSPB,51904,22934,28970,3,100,200
NearestNeighborAny2Regret_w1_1_start96,TSPB,48257,19646,28611,3,100,200
NearestNeighborAny2Regret_w1_1_start97,TSPB,45158,20223,24935,2,100,200
NearestNeighborAny2Regret_w1_1_start98,TSPB,45816,19490,26326,3,100,200
NearestNeighborAny2Regret_w1_1_start99,TSPB,48341,19783,28558,3,100,200
NearestNeighborAny2Regret_w1_1_start100,TSPB,48341,19783,28558,3,100,200
NearestNeighborAny2Regret_w1_1_start101,TSPB,49202,21938,27264,2,100,200
NearestNeighborAny2Regret_w1_1_start102,TSPB,48192,19675,28517,3,100,200
NearestNeighborAny2Regret_w1_1_start103,TSPB,44891,20139,24752,3,100,200
NearestNeighborAny2Regret_w1_1_start104,TSPB,46217,19452,26765,2,100,200
NearestNeighborAny2Regret_w1_1_start105,TSPB,46158,18553,27605,3,100,200
NearestNeighborAny2Regret_w1_1_start106,TSPB,48889,22026,26863,3,100,200
NearestNeighborAny2Regret_w1_1_start107,TSPB,48341,19783,28558,3,100,200
NearestNeighborAny2Regret_w1_1_start108,TSPB,48150,20779,27371,3,100,200
NearestNeighborAny2Regret_w1_1_start109,TSPB,46217,19452,26765,2,100,200
NearestNeighborAny2Regret_w1_1_start110,TSPB,46454,19293,27161,3,100,200
NearestNeighborAny2Regret_w1_1_start111,TSPB,50070,18776,31294,3,100,200
NearestNeighborAny2Regret_w1_1_start112,TSPB,45159,20381,24778,2,100,200
NearestNeighborAny2Regret_w1_1_start113,TSPB,48341,19783,28558,3,100,200
NearestNeighborAny2Regret_w1_1_start114,TSPB,45788,19425,26363,3,100,200
NearestNeighborAny2Regret_w1_1_start115,TSPB,45748,19912,25836,3,100,200
NearestNeighborAny2Regret_w1_1_start116,TSPB,45309,19759,25550,2,100,200
NearestNeighborAny2Regret_w1_1_start117,TSPB,46759,20593,26166,3,100,200
NearestNeighborAny2Regret_w1_1_start118,TSPB,45745,19944,25801,3,100,200
NearestNeighborAny2Regret_w1_1_start119,TSPB,48341,21595,26746,3,100,200
NearestNeighborAny2Regret_w1_1_start120,TSPB,46129,21000,25129,2,100,200
NearestNeighborAny2Regret_w1_1_start121,TSPB,45443,19918,25525,3,100,200
NearestNeighborAny2Regret_w1_1_start122,TSPB,48192,19675,28517,3,100,200
NearestNeighborAny2Regret_w1_1_start123,TSPB,48544,19776,28768,2,100,200
NearestNeighborAny2Regret_w1_1_start124,TSPB,48889,22026,26863,5,100,200
NearestNeighborAny2Regret_w1_1_start125,TSPB,48192,19675,28517,3,100,200
NearestNeighborAny2Regret_w1_1_start126,TSPB,48767,20300,28467,3,100,200
NearestNeighborAny2Regret_w1_1_start127,TSPB,48341,19783,28558,2,100,200
NearestNeighborAny2Regret_w1_1_start128,TSPB,46879,20446,26433,3,100,200
NearestNeighborAny2Regret_w1_1_start129,TSPB,45446,20022,25424,3,100,200
NearestNeighborAny2Regret_w1_1_start130,TSPB,48834,21880,26954,2,100,200
NearestNeighborAny2Regret_w1_1_start131,TSPB,48341,19783,28558,3,100,200
NearestNeighborAny2Regret_w1_1_start132,TSPB,48816,20423,28393,3,100,200
NearestNeighborAny2Regret_w1_1_start133,TSPB,48785,20784,28001,2,100,200
NearestNeighborAny2Regret_w1_1_start134,TSPB,46286,19245,27041,3,100,200
NearestNeighborAny2Regret_w1_1_start135,TSPB,48192,19675,28517,3,100,200
NearestNeighborAny2Regret_w1_1_start136,TSPB,46919,20426,26493,2,100,200
NearestNeighborAny2Regret_w1_1_start137,TSPB,55043,23776,31267,3,100,200
NearestNeighborAny2Regret_w1_1_start138,TSPB,50937,20184,30753,3,100,200
NearestNeighborAny2Regret_w1_1_start139,TSPB,49571,19545,30026,3,100,200
NearestNeighborAny2Regret_w1_1_start140,TSPB,48889,22026,26863,2,100,200
NearestNeighborAny2Regret_w1_1_start141,TSPB,44891,20139,24752,3,100,200
NearestNeighborAny2Regret_w1_1_start142,TSPB,48153,20608,27545,3,100,200
NearestNeighborAny2Regret_w1_1_start143,TSPB,48255,19329,28926,2,100,200
NearestNeighborAny2Regret_w1_1_start144,TSPB,46295,19314,26981,3,100,200
NearestNeighborAny2Regret_w1_1_start145,TSPB,48878,20730,28148,3,100,200
NearestNeighborAny2Regret_w1_1_start146,TSPB,47588,20429,27159,2,100,200
NearestNeighborAny2Regret_w1_1_start147,TSPB,46759,20593,26166,3,100,200
NearestNeighborAny2Regret_w1_1_start148,TSPB,48341,19783,28558,2,100,200
NearestNeighborAny2Regret_w1_1_start149,TSPB,48889,22026,26863,3,100,200
NearestNeighborAny2Regret_w1_1_start150,TSPB,47224,20191,27033,3,100,200
NearestNeighborAny2Regret_w1_1_start151,TSPB,45402,19877,25525,3,100,200
NearestNeighborAny2Regret_w1_1_start152,TSPB,46286,19245,27041,2,100,200
NearestNeighborAny2Regret_w1_1_start153,TSPB,44891,20139,24752,3,100,200
NearestNeighborAny2Regret_w1_1_start154,TSPB,47089,20197,26892,3,100,200
NearestNeighborAny2Regret_w1_1_start155,TSPB,46759,20593,26166,2,100,200
NearestNeighborAny2Regret_w1_1_start156,TSPB,45220,20393,24827,3,100,200
NearestNeighborAny2Regret_w1_1_start157,TSPB,46729,19583,27146,3,100,200
NearestNeighborAny2Regret_w1_1_start158,TSPB,48341,19783,28558,2,100,200
NearestNeighborAny2Regret_w1_1_start159,TSPB,48483,20523,27960,3,100,200
NearestNeighborAny2Regret_w1_1_start160,TSPB,50937,20184,30753,3,100,200
NearestNeighborAny2Regret_w1_1_start161,TSPB,46054,19261,26793,2,100,200
NearestNeighborAny2Regret_w1_1_start162,TSPB,48153,20608,27545,3,100,200
NearestNeighborAny2Regret_w1_1_start163,TSPB,44891,20139,24752,3,100,200
NearestNeighborAny2Regret_w1_1_start164,TSPB,46816,20430,26386,3,100,200
NearestNeighborAny2Regret_w1_1_start165,TSPB,45042,20202,24840,2,100,200
NearestNeighborAny2Regret_w1_1_start166,TSPB,48341,19783,28558,3,100,200
NearestNeighborAny2Regret_w1_1_start167,TSPB,47386,19714,27672,3,100,200
NearestNeighborAny2Regret_w1_1_start168,TSPB,48816,20423,28393,2,100,200
NearestNeighborAny2Regret_w1_1_start169,TSPB,48816,20423,28393,3,100,200
NearestNeighborAny2Regret_w1_1_start170,TSPB,46827,20142,26685,3,100,200
NearestNeighborAny2Regret_w1_1_start171,TSPB,48477,20182,28295,2,100,200
NearestNeighborAny2Regret_w1_1_start172,TSPB,44891,20139,24752,3,100,200
NearestNeighborAny2Regret_w1_1_start173,TSPB,45435,20397,25038,3,100,200
NearestNeighborAny2Regret_w1_1_start174,TSPB,49141,22017,27124,2,100,200
NearestNeighborAny2Regret_w1_1_start175,TSPB,48153,20608,27545,3,100,200
NearestNeighborAny2Regret_w1_1_start176,TSPB,48341,19783,28558,3,100,200
NearestNeighborAny2Regret_w1_1_start177,TSPB,48153,20608,27545,3,100,200
NearestNeighborAny2Regret_w1_1_start178,TSPB,45562,19812,25750,2,100,200
NearestNeighborAny2Regret_w1_1_start179,TSPB,44891,20139,24752,3,100,200
NearestNeighborAny2Regret_w1_1_start180,TSPB,48259,19770,28489,3,100,200
NearestNeighborAny2Regret_w1_1_start181,TSPB,49157,19834,29323,2,100,200
NearestNeighborAny2Regret_w1_1_start182,TSPB,50598,19832,30766,3,100,200
NearestNeighborAny2Regret_w1_1_start183,TSPB,48889,22026,26863,3,100,200
NearestNeighborAny2Regret_w1_1_start184,TSPB,46520,20528,25992,2,100,200
NearestNeighborAny2Regret_w1_1_start185,TSPB,48341,19783,28558,3,100,200
NearestNeighborAny2Regret_w1_1_start186,TSPB,45263,19775,25488,3,100,200
NearestNeighborAny2Regret_w1_1_start187,TSPB,47163,20504,26659,2,100,200
NearestNeighborAny2Regret_w1_1_start188,TSPB,48816,20423,28393,3,100,200
NearestNeighborAny2Regret_w1_1_start189,TSPB,48003,21036,26967,3,100,200
NearestNeighborAny2Regret_w1_1_start190,TSPB,46759,20593,26166,2,100,200
NearestNeighborAny2Regret_w1_1_start191,TSPB,47469,19132,28337,3,100,200
NearestNeighborAny2Regret_w1_1_start192,TSPB,47197,20176,27021,2,100,200
NearestNeighborAny2Regret_w1_1_start193,TSPB,45893,20477,25416,3,100,200
NearestNeighborAny2Regret_w1_1_start194,TSPB,48341,19783,28558,3,100,200
NearestNeighborAny2Regret_w1_1_start195,TSPB,48816,20423,28393,2,100,200
NearestNeighborAny2Regret_w1_1_start196,TSPB,47733,20630,27103,3,100,200
NearestNeighborAny2Regret_w1_1_start197,TSPB,45298,20128,25170,3,100,200
NearestNeighborAny2Regret_w1_1_start198,TSPB,45948,20532,25416,2,100,200
NearestNeighborAny2Regret_w1_1_start199,TSPB,49013,22019,26994,3,100,200
GreedyCycle2Regret_w0_1_start0,TSPB,70587,22231,48356,5,100,200
GreedyCycle2Regret_w0_1_start1,TSPB,70599,21509,49090,4,100,200
GreedyCycle2Regret_w0_1_start2,TSPB,70599,21509,49090,4,100,200
GreedyCycle2Regret_w0_1_start3,TSPB,71004,21455,49549,4,100,200
GreedyCycle2Regret_w0_1_start4,TSPB,68588,20284,48304,4,100,200
GreedyCycle2Regret_w0_1_start5,TSPB,71311,21158,50153,4,100,200
GreedyCycle2Regret_w0_1_start6,TSPB,67561,20760,46801,4,100,200
GreedyCycle2Regret_w0_1_start7,TSPB,69637,20668,48969,4,100,200
GreedyCycle2Regret_w0_1_start8,TSPB,69441,20073,49368,5,100,200
GreedyCycle2Regret_w0_1_start9,TSPB,71799,22854,48945,4,100,200
GreedyCycle2Regret_w0_1_start10,TSPB,71363,21709,49654,4,100,200
GreedyCycle2Regret_w0_1_start11,TSPB,71892,23271,48621,4,100,200
GreedyCycle2Regret_w0_1_start12,TSPB,68892,21475,47417,4,100,200
GreedyCycle2Regret_w0_1_start13,TSPB,69342,21362,47980,4,100,200
GreedyCycle2Regret_w0_1_start14,TSPB,68319,19656,48663,4,100,200
GreedyCycle2Regret_w0_1_start15,TSPB,69949,20903,49046,4,100,200
GreedyCycle2Regret_w0_1_start16,TSPB,71858,21927,49931,4,100,200
GreedyCycle2Regret_w0_1_start17,TSPB,72411,22296,50115,4,100,200
GreedyCycle2Regret_w0_1_start18,TSPB,74689,24275,50414,5,100,200
GreedyCycle2Regret_w0_1_start19,TSPB,68844,20496,48348,4,100,200
GreedyCycle2Regret_w0_1_start20,TSPB,69561,21550,48011,4,100,200
GreedyCycle2Regret_w0_1_start21,TSPB,72532,21385,51147,4,100,200
GreedyCycle2Regret_w0_1_start22,TSPB,68866,21265,47601,4,100,200
GreedyCycle2Regret_w0_1_start23,TSPB,71011,21935,49076,4,100,200
GreedyCycle2Regret_w0_1_start24,TSPB,73875,21930,51945,4,100,200
GreedyCycle2Regret_w0_1_start25,TSPB,71861,21543,50318,4,100,200
GreedyCycle2Regret_w0_1_start26,TSPB,67233,19132,48101,4,100,200
GreedyCycle2Regret_w0_1_start27,TSPB,71465,22620,48845,4,100,200
GreedyCycle2Regret_w0_1_start28,TSPB,69373,21504,47869,4,100,200
GreedyCycle2Regret_w0_1_start29,TSPB,70766,22953,47813,3,100,200
GreedyCycle2Regret_w0_1_start30,TSPB,74507,22448,52059,5,100,200
GreedyCycle2Regret_w0_1_start31,TSPB,71228,21084,50144,4,100,200
GreedyCycle2Regret_w0_1_start32,TSPB,72531,22359,50172,4,100,200
GreedyCycle2Regret_w0_1_start33,TSPB,68101,21124,46977,4,100,200
GreedyCycle2Regret_w0_1_start34,TSPB,69834,21158,48676,4,100,200
GreedyCycle2Regret_w0_1_start35,TSPB,66340,21165,45175,4,100,200
GreedyCycle2Regret_w0_1_start36,TSPB,70117,20944,49173,4,100,200
GreedyCycle2Regret_w0_1_start37,TSPB,70240,20897,49343,4,100,200
GreedyCycle2Regret_w0_1_start38,TSPB,72482,22173,50309,4,100,200
GreedyCycle2Regret_w0_1_start39,TSPB,70693,22801,47892,4,100,200
GreedyCycle2Regret_w0_1_start40,TSPB,71678,22221,49457,5,100,200
GreedyCycle2Regret_w0_1_start41,TSPB,68304,20001,48303,5,100,200
GreedyCycle2Regret_w0_1_start42,TSPB,70512,22226,48286,5,100,200
GreedyCycle2Regret_w0_1_start43,TSPB,70872,22084,48788,3,100,200
GreedyCycle2Regret_w0_1_start44,TSPB,73999,22191,51808,5,100,200
GreedyCycle2Regret_w0_1_start45,TSPB,73592,21102,52490,4,100,200
GreedyCycle2Regret_w0_1_start46,TSPB,70976,21382,49594,4,100,200
GreedyCycle2Regret_w0_1_start47,TSPB,72952,21631,51321,4,100,200
GreedyCycle2Regret_w0_1_start48,TSPB,66555,18608,47947,4,100,200
GreedyCycle2Regret_w0_1_start49,TSPB,72466,23198,49268,4,100,200
GreedyCycle2Regret_w0_1_start50,TSPB,69414,19901,49513,4,100,200
GreedyCycle2Regret_w0_1_start51,TSPB,71547,20568,50979,4,100,200
GreedyCycle2Regret_w0_1_start52,TSPB,70603,19746,50857,5,100,200
GreedyCycle2Regret_w0_1_start53,TSPB,70767,20315,50452,4,100,200
GreedyCycle2Regret_w0_1_start54,TSPB,72541,21892,50649,4,100,200
GreedyCycle2Regret_w0_1_start55,TSPB,70772,22036,48736,4,100,200
GreedyCycle2Regret_w0_1_start56,TSPB,69706,20445,49261,4,100,200
GreedyCycle2Regret_w0_1_start57,TSPB,67785,18830,48955,4,100,200
GreedyCycle2Regret_w0_1_start58,TSPB,69742,20278,49464,4,100,200
GreedyCycle2Regret_w0_1_start59,TSPB,68807,21528,47279,4,100,200
GreedyCycle2Regret_w0_1_start60,TSPB,70783,21872,48911,4,100,200
GreedyCycle2Regret_w0_1_start61,TSPB,67548,20546,47002,4,100,200
GreedyCycle2Regret_w0_1_start62,TSPB,71357,21197,50160,4,100,200
GreedyCycle2Regret_w0_1_start63,TSPB,71298,21763,49535,4,100,200
GreedyCycle2Regret_w0_1_start64,TSPB,69225,19952,49273,4,100,200
GreedyCycle2Regret_w0_1_start65,TSPB,70455,20081,50374,4,100,200
GreedyCycle2Regret_w0_1_start66,TSPB,75013,21950,53063,4,100,200
GreedyCycle2Regret_w0_1_start67,TSPB,71792,21051,50741,5,100,200
GreedyCycle2Regret_w0_1_start68,TSPB,71132,20364,50768,5,100,200
GreedyCycle2Regret_w0_1_start69,TSPB,69994,21519,48475,4,100,200
GreedyCycle2Regret_w0_1_start70,TSPB,69481,20623,48858,4,100,200
GreedyCycle2Regret_w0_1_start71,TSPB,71956,21383,50573,4,100,200
GreedyCycle2Regret_w0_1_start72,TSPB,72522,22408,50114,4,100,200
GreedyCycle2Regret_w0_1_start73,TSPB,71783,21561,50222,4,100,200
GreedyCycle2Regret_w0_1_start74,TSPB,69609,21747,47862,4,100,200
GreedyCycle2Regret_w0_1_start75,TSPB,67963,19188,48775,4,100,200
GreedyCycle2Regret_w0_1_start76,TSPB,68178,19064,49114,4,100,200
GreedyCycle2Regret_w0_1_start77,TSPB,70076,19977,50099,4,100,200
GreedyCycle2Regret_w0_1_start78,TSPB,72185,21679,50506,4,100,200
GreedyCycle2Regret_w0_1_start79,TSPB,68013,20540,47473,4,100,200
GreedyCycle2Regret_w0_1_start80,TSPB,71554,22133,49421,4,100,200
GreedyCycle2Regret_w0_1_start81,TSPB,68591,19777,48814,4,100,200
GreedyCycle2Regret_w0_1_start82,TSPB,69652,20250,49402,4,100,200
GreedyCycle2Regret_w0_1_start83,TSPB,75477,24733,50744,3,100,200
GreedyCycle2Regret_w0_1_start84,TSPB,71046,21133,49913,4,100,200
GreedyCycle2Regret_w0_1_start85,TSPB,69351,20835,48516,4,100,200
GreedyCycle2Regret_w0_1_start86,TSPB,68683,20794,47889,4,100,200
GreedyCycle2Regret_w0_1_start87,TSPB,66691,20106,46585,4,100,200
GreedyCycle2Regret_w0_1_start88,TSPB,65043,19066,45977,4,100,200
GreedyCycle2Regret_w0_1_start89,TSPB,66513,19125,47388,4,100,200
GreedyCycle2Regret_w0_1_start90,TSPB,70973,21392,49581,4,100,200
GreedyCycle2Regret_w0_1_start91,TSPB,70483,21168,49315,4,100,200
GreedyCycle2Regret_w0_1_start92,TSPB,72030,21960,50070,4,100,200
GreedyCycle2Regret_w0_1_start93,TSPB,67883,18862,49021,4,100,200
GreedyCycle2Regret_w0_1_start94,TSPB,73652,22236,51416,4,100,200
GreedyCycle2Regret_w0_1_start95,TSPB,69250,20739,48511,4,100,200
GreedyCycle2Regret_w0_1_start96,TSPB,73338,22655,50683,4,100,200
GreedyCycle2Regret_w0_1_start97,TSPB,70760,20138,50622,4,100,200
GreedyCycle2Regret_w0_1_start98,TSPB,70868,21459,49409,4,100,200
GreedyCycle2Regret_w0_1_start99,TSPB,73075,20212,52863,4,100,200
GreedyCycle2Regret_w0_1_start100,TSPB,72054,22148,49906,4,100,200
GreedyCycle2Regret_w0_1_start101,TSPB,69217,21513,47704,5,100,200
GreedyCycle2Regret_w0_1_start102,TSPB,73440,22506,50934,4,100,200
GreedyCycle2Regret_w0_1_start103,TSPB,68311,19306,49005,4,100,200
GreedyCycle2Regret_w0_1_start104,TSPB,67458,19666,47792,4,100,200
GreedyCycle2Regret_w0_1_start105,TSPB,72433,21998,50435,5,100,200
GreedyCycle2Regret_w0_1_start106,TSPB,68171,20134,48037,4,100,200
GreedyCycle2Regret_w0_1_start107,TSPB,72397,22657,49740,4,100,200
GreedyCycle2Regret_w0_1_start108,TSPB,70965,22320,48645,4,100,200
GreedyCycle2Regret_w0_1_start109,TSPB,70144,22351,47793,4,100,200
GreedyCycle2Regret_w0_1_start110,TSPB,69880,20410,49470,4,100,200
GreedyCycle2Regret_w0_1_start111,TSPB,70602,19967,50635,4,100,200
GreedyCycle2Regret_w0_1_start112,TSPB,67613,20767,46846,4,100,200
GreedyCycle2Regret_w0_1_start113,TSPB,65522,19246,46276,4,100,200
GreedyCycle2Regret_w0_1_start114,TSPB,67953,18874,49079,4,100,200
GreedyCycle2Regret_w0_1_start115,TSPB,71364,21632,49732,4,100,200
GreedyCycle2Regret_w0_1_start116,TSPB,72543,21852,50691,4,100,200
GreedyCycle2Regret_w0_1_start117,TSPB,73569,22457,51112,4,100,200
GreedyCycle2Regret_w0_1_start118,TSPB,68358,20486,47872,4,100,200
GreedyCycle2Regret_w0_1_start119,TSPB,67325,19319,48006,4,100,200
GreedyCycle2Regret_w0_1_start120,TSPB,72613,21666,50947,4,100,200
GreedyCycle2Regret_w0_1_start121,TSPB,73681,23068,50613,4,100,200
GreedyCycle2Regret_w0_1_start122,TSPB,71955,21428,50527,4,100,200
GreedyCycle2Regret_w0_1_start123,TSPB,71282,20638,50644,4,100,200
GreedyCycle2Regret_w0_1_start124,TSPB,70614,20489,50125,5,100,200
GreedyCycle2Regret_w0_1_start125,TSPB,69876,21824,48052,5,100,200
GreedyCycle2Regret_w0_1_start126,TSPB,70630,20954,49676,4,100,200
GreedyCycle2Regret_w0_1_start127,TSPB,67035,19111,47924,4,100,200
GreedyCycle2Regret_w0_1_start128,TSPB,69862,20372,49490,5,100,200
GreedyCycle2Regret_w0_1_start129,TSPB,67256,19112,48144,3,100,200
GreedyCycle2Regret_w0_1_start130,TSPB,74642,22963,51679,4,100,200
GreedyCycle2Regret_w0_1_start131,TSPB,70443,21703,48740,5,100,200
GreedyCycle2Regret_w0_1_start132,TSPB,71387,21949,49438,4,100,200
GreedyCycle2Regret_w0_1_start133,TSPB,74419,22289,52130,4,100,200
GreedyCycle2Regret_w0_1_start134,TSPB,70021,20702,49319,3,100,200
GreedyCycle2Regret_w0_1_start135,TSPB,71839,22372,49467,4,100,200
GreedyCycle2Regret_w0_1_start136,TSPB,71173,21959,49214,4,100,200
GreedyCycle2Regret_w0_1_start137,TSPB,67792,19357,48435,4,100,200
GreedyCycle2Regret_w0_1_start138,TSPB,71723,22807,48916,5,100,200
GreedyCycle2Regret_w0_1_start139,TSPB,71824,21887,49937,4,100,200
GreedyCycle2Regret_w0_1_start140,TSPB,68352,21029,47323,4,100,200
GreedyCycle2Regret_w0_1_start141,TSPB,70192,20285,49907,4,100,200
GreedyCycle2Regret_w0_1_start142,TSPB,73439,21084,52355,4,100,200
GreedyCycle2Regret_w0_1_start143,TSPB,69037,20081,48956,4,100,200
GreedyCycle2Regret_w0_1_start144,TSPB,69262,20529,48733,4,100,200
GreedyCycle2Regret_w0_1_start145,TSPB,68061,21154,46907,3,100,200
GreedyCycle2Regret_w0_1_start146,TSPB,67072,19605,47467,4,100,200
GreedyCycle2Regret_w0_1_start147,TSPB,70345,21733,48612,5,100,200
GreedyCycle2Regret_w0_1_start148,TSPB,72386,23006,49380,4,100,200
GreedyCycle2Regret_w0_1_start149,TSPB,68249,20466,47783,4,100,200
GreedyCycle2Regret_w0_1_start150,TSPB,70610,21059,49551,4,100,200
GreedyCycle2Regret_w0_1_start151,TSPB,72455,21676,50779,5,100,200
GreedyCycle2Regret_w0_1_start152,TSPB,69331,21223,48108,4,100,200
GreedyCycle2Regret_w0_1_start153,TSPB,67580,19807,47773,4,100,200
GreedyCycle2Regret_w0_1_start154,TSPB,76325,22525,53800,4,100,200
GreedyCycle2Regret_w0_1_start155,TSPB,69305,20588,48717,4,100,200
GreedyCycle2Regret_w0_1_start156,TSPB,70968,21688,49280,4,100,200
GreedyCycle2Regret_w0_1_start157,TSPB,69284,20942,48342,4,100,200
GreedyCycle2Regret_w0_1_start158,TSPB,72329,22222,50107,4,100,200
GreedyCycle2Regret_w0_1_start159,TSPB,66725,20688,46037,4,100,200
GreedyCycle2Regret_w0_1_start160,TSPB,68315,20755,47560,4,100,200
GreedyCycle2Regret_w0_1_start161,TSPB,71689,21578,50111,4,100,200
GreedyCycle2Regret_w0_1_start162,TSPB,70602,21344,49258,5,100,200
GreedyCycle2Regret_w0_1_start163,TSPB,65764,18961,46803,4,100,200
GreedyCycle2Regret_w0_1_start164,TSPB,73342,21105,52237,4,100,200
GreedyCycle2Regret_w0_1_start165,TSPB,67675,19395,48280,4,100,200
GreedyCycle2Regret_w0_1_start166,TSPB,66932,19481,47451,4,100,200
GreedyCycle2Regret_w0_1_start167,TSPB,67438,20527,46911,3,100,200
GreedyCycle2Regret_w0_1_start168,TSPB,66793,20031,46762,5,100,200
GreedyCycle2Regret_w0_1_start169,TSPB,68411,20614,47797,4,100,200
GreedyCycle2Regret_w0_1_start170,TSPB,70297,21405,48892,4,100,200
GreedyCycle2Regret_w0_1_start171,TSPB,70626,20311,50315,4,100,200
GreedyCycle2Regret_w0_1_start172,TSPB,70605,19865,50740,4,100,200
GreedyCycle2Regret_w0_1_start173,TSPB,71809,22043,49766,4,100,200
GreedyCycle2Regret_w0_1_start174,TSPB,69509,21522,47987,4,100,200
GreedyCycle2Regret_w0_1_start175,TSPB,72066,21881,50185,4,100,200
GreedyCycle2Regret_w0_1_start176,TSPB,65983,19056,46927,4,100,200
GreedyCycle2Regret_w0_1_start177,TSPB,68581,20885,47696,4,100,200
GreedyCycle2Regret_w0_1_start178,TSPB,69036,21540,47496,5,100,200
GreedyCycle2Regret_w0_1_start179,TSPB,68152,19294,48858,4,100,200
GreedyCycle2Regret_w0_1_start180,TSPB,66414,19160,47254,4,100,200
GreedyCycle2Regret_w0_1_start181,TSPB,73685,19253,54432,4,100,200
GreedyCycle2Regret_w0_1_start182,TSPB,72603,23213,49390,4,100,200
GreedyCycle2Regret_w0_1_start183,TSPB,68527,21039,47488,4,100,200
GreedyCycle2Regret_w0_1_start184,TSPB,69170,21250,47920,5,100,200
GreedyCycle2Regret_w0_1_start185,TSPB,70161,21159,49002,4,100,200
GreedyCycle2Regret_w0_1_start186,TSPB,66588,19769,46819,4,100,200
GreedyCycle2Regret_w0_1_start187,TSPB,67965,19820,48145,4,100,200
GreedyCycle2Regret_w0_1_start188,TSPB,69696,20032,49664,4,100,200
GreedyCycle2Regret_w0_1_start189,TSPB,69555,20707,48848,4,100,200
GreedyCycle2Regret_w0_1_start190,TSPB,69534,21961,47573,4,100,200
GreedyCycle2Regret_w0_1_start191,TSPB,72255,21708,50547,4,100,200
GreedyCycle2Regret_w0_1_start192,TSPB,69081,20822,48259,4,100,200
GreedyCycle2Regret_w0_1_start193,TSPB,70817,21080,49737,4,100,200
GreedyCycle2Regret_w0_1_start194,TSPB,66555,19225,47330,4,100,200
GreedyCycle2Regret_w0_1_start195,TSPB,69712,20869,48843,4,100,200
GreedyCycle2Regret_w0_1_start196,TSPB,71171,22364,48807,4,100,200
GreedyCycle2Regret_w0_1_start197,TSPB,72452,22145,50307,4,100,200
GreedyCycle2Regret_w0_1_start198,TSPB,73637,22152,51485,4,100,200
GreedyCycle2Regret_w0_1_start199,TSPB,68866,21235,47631,3,100,200
NearestNeighborAny2Regret_w0_1_start0,TSPB,76018,24151,51867,3,100,200
NearestNeighborAny2Regret_w0_1_start1,TSPB,76018,24151,51867,2,100,200
NearestNeighborAny2Regret_w0_1_start2,TSPB,71393,21373,50020,3,100,200
NearestNeighborAny2Regret_w0_1_start3,TSPB,73019,23392,49627,3,100,200
NearestNeighborAny2Regret_w0_1_start4,TSPB,74213,23900,50313,3,100,200
NearestNeighborAny2Regret_w0_1_start5,TSPB,73027,24842,48185,2,100,200
NearestNeighborAny2Regret_w0_1_start6,TSPB,74506,24097,50409,3,100,200
NearestNeighborAny2Regret_w0_1_start7,TSPB,70926,23336,47590,3,100,200
NearestNeighborAny2Regret_w0_1_start8,TSPB,77217,25114,52103,3,100,200
NearestNeighborAny2Regret_w0_1_start9,TSPB,73950,23587,50363,3,100,200
NearestNeighborAny2Regret_w0_1_start10,TSPB,73355,22719,50636,3,100,200
NearestNeighborAny2Regret_w0_1_start11,TSPB,73495,25354,48141,2,100,200
NearestNeighborAny2Regret_w0_1_start12,TSPB,76381,23813,52568,3,100,200
NearestNeighborAny2Regret_w0_1_start13,TSPB,74151,23281,50870,3,100,200
NearestNeighborAny2Regret_w0_1_start14,TSPB,76077,22945,53132,2,100,200
NearestNeighborAny2Regret_w0_1_start15,TSPB,74612,23688,50924,3,100,200
NearestNeighborAny2Regret_w0_1_start16,TSPB,76137,24143,51994,3,100,200
NearestNeighborAny2Regret_w0_1_start17,TSPB,74209,22489,51720,3,100,200
NearestNeighborAny2Regret_w0_1_start18,TSPB,71576,23074,48502,2,100,200
NearestNeighborAny2Regret_w0_1_start19,TSPB,75743,23442,52301,3,100,200
NearestNeighborAny2Regret_w0_1_start20,TSPB,73779,23464,50315,3,100,200
NearestNeighborAny2Regret_w0_1_start21,TSPB,76448,25501,50947,2,100,200
NearestNeighborAny2Regret_w0_1_start22,TSPB,72534,23790,48744,3,100,200
NearestNeighborAny2Regret_w0_1_start23,TSPB,76680,23847,52833,3,100,200
NearestNeighborAny2Regret_w0_1_start24,TSPB,75818,23124,52694,3,100,200
NearestNeighborAny2Regret_w0_1_start25,TSPB,79030,24561,54469,3,100,200
NearestNeighborAny2Regret_w0_1_start26,TSPB,75423,25279,50144,3,100,200
NearestNeighborAny2Regret_w0_1_start27,TSPB,77430,24143,53287,2,100,200
NearestNeighborAny2Regret_w0_1_start28,TSPB,70437,23158,47279,3,100,200
NearestNeighborAny2Regret_w0_1_start29,TSPB,72634,24030,48604,3,100,200
NearestNeighborAny2Regret_w0_1_start30,TSPB,76128,23185,52943,2,100,200
NearestNeighborAny2Regret_w0_1_start31,TSPB,74628,22303,52325,3,100,200
NearestNeighborAny2Regret_w0_1_start32,TSPB,73985,22217,51768,3,100,200
NearestNeighborAny2Regret_w0_1_start33,TSPB,69933,24265,45668,2,100,200
NearestNeighborAny2Regret_w0_1_start34,TSPB,73779,23464,50315,3,100,200
NearestNeighborAny2Regret_w0_1_start35,TSPB,73436,23779,49657,2,100,200
NearestNeighborAny2Regret_w0_1_start36,TSPB,71361,24635,46726,3,100,200
NearestNeighborAny2Regret_w0_1_start37,TSPB,74222,24156,50066,3,100,200
NearestNeighborAny2Regret_w0_1_start38,TSPB,71966,21510,50456,2,100,200
NearestNeighborAny2Regret_w0_1_start39,TSPB,74638,23594,51044,3,100,200
NearestNeighborAny2Regret_w0_1_start40,TSPB,71148,21323,49825,3,100,200
NearestNeighborAny2Regret_w0_1_start41,TSPB,72799,23416,49383,2,100,200
NearestNeighborAny2Regret_w0_1_start42,TSPB,76303,23663,52640,3,100,200
NearestNeighborAny2Regret_w0_1_start43,TSPB,76696,23427,53269,2,100,200
NearestNeighborAny2Regret_w0_1_start44,TSPB,75145,22144,53001,3,100,200
NearestNeighborAny2Regret_w0_1_start45,TSPB,74757,24770,49987,3,100,200
NearestNeighborAny2Regret_w0_1_start46,TSPB,76079,22704,53375,3,100,200
NearestNeighborAny2Regret_w0_1_start47,TSPB,77332,24207,53125,2,100,200
NearestNeighborAny2Regret_w0_1_start48,TSPB,73684,23577,50107,3,100,200
NearestNeighborAny2Regret_w0_1_start49,TSPB,75107,24218,50889,3,100,200
NearestNeighborAny2Regret_w0_1_start50,TSPB,74486,24830,49656,3,100,200
NearestNeighborAny2Regret_w0_1_start51,TSPB,72723,24269,48454,3,100,200
NearestNeighborAny2Regret_w0_1_start52,TSPB,75662,24556,51106,3,100,200
NearestNeighborAny2Regret_w0_1_start53,TSPB,76646,24086,52560,3,100,200
NearestNeighborAny2Regret_w0_1_start54,TSPB,74256,23029,51227,2,100,200
NearestNeighborAny2Regret_w0_1_start55,TSPB,76798,26606,50192,3,100,200
NearestNeighborAny2Regret_w0_1_start56,TSPB,73190,24254,48936,3,100,200
NearestNeighborAny2Regret_w0_1_start57,TSPB,72571,22436,50135,3,100,200
NearestNeighborAny2Regret_w0_1_start58,TSPB,77196,24807,52389,3,100,200
NearestNeighborAny2Regret_w0_1_start59,TSPB,73828,22939,50889,2,100,200
NearestNeighborAny2Regret_w0_1_start60,TSPB,80213,24081,56132,3,100,200
NearestNeighborAny2Regret_w0_1_start61,TSPB,71155,24542,46613,3,100,200
NearestNeighborAny2Regret_w0_1_start62,TSPB,74722,24501,50221,3,100,200
NearestNeighborAny2Regret_w0_1_start63,TSPB,72329,21585,50744,3,100,200
NearestNeighborAny2Regret_w0_1_start64,TSPB,76375,23938,52437,2,100,200
NearestNeighborAny2Regret_w0_1_start65,TSPB,75041,24034,51007,3,100,200
NearestNeighborAny2Regret_w0_1_start66,TSPB,76449,23975,52474,3,100,200
NearestNeighborAny2Regret_w0_1_start67,TSPB,75502,23737,51765,2,100,200
NearestNeighborAny2Regret_w0_1_start68,TSPB,73174,23538,49636,3,100,200
NearestNeighborAny2Regret_w0_1_start69,TSPB,73028,23849,49179,3,100,200
NearestNeighborAny2Regret_w0_1_start70,TSPB,76084,23190,52894,3,100,200
NearestNeighborAny2Regret_w0_1_start71,TSPB,73051,22429,50622,3,100,200
NearestNeighborAny2Regret_w0_1_start72,TSPB,73631,22309,51322,3,100,200
NearestNeighborAny2Regret_w0_1_start73,TSPB,72483,21189,51294,2,100,200
NearestNeighborAny2Regret_w0_1_start74,TSPB,72460,22245,50215,3,100,200
NearestNeighborAny2Regret_w0_1_start75,TSPB,77625,24639,52986,3,100,200
NearestNeighborAny2Regret_w0_1_start76,TSPB,74039,23546,50493,2,100,200
NearestNeighborAny2Regret_w0_1_start77,TSPB,72897,24459,48438,3,100,200
NearestNeighborAny2Regret_w0_1_start78,TSPB,72090,24262,47828,6,100,200
NearestNeighborAny2Regret_w0_1_start79,TSPB,71816,24460,47356,3,100,200
NearestNeighborAny2Regret_w0_1_start80,TSPB,74515,23173,51342,2,100,200
NearestNeighborAny2Regret_w0_1_start81,TSPB,74537,24859,49678,3,100,200
NearestNeighborAny2Regret_w0_1_start82,TSPB,73591,24372,49219,3,100,200
NearestNeighborAny2Regret_w0_1_start83,TSPB,74928,23773,51155,3,100,200
NearestNeighborAny2Regret_w0_1_start84,TSPB,76499,24683,51816,2,100,200
NearestNeighborAny2Regret_w0_1_start85,TSPB,71501,21472,50029,3,100,200
NearestNeighborAny2Regret_w0_1_start86,TSPB,77476,23864,53612,3,100,200
NearestNeighborAny2Regret_w0_1_start87,TSPB,74438,22451,51987,3,100,200
NearestNeighborAny2Regret_w0_1_start88,TSPB,78001,24047,53954,3,100,200
NearestNeighborAny2Regret_w0_1_start89,TSPB,74172,24861,49311,2,100,200
NearestNeighborAny2Regret_w0_1_start90,TSPB,73649,23614,50035,3,100,200
NearestNeighborAny2Regret_w0_1_start91,TSPB,73174,23165,50009,3,100,200
NearestNeighborAny2Regret_w0_1_start92,TSPB,73654,21323,52331,3,100,200
NearestNeighborAny2Regret_w0_1_start93,TSPB,74209,22489,51720,3,100,200
NearestNeighborAny2Regret_w0_1_start94,TSPB,77334,23768,53566,3,100,200
NearestNeighborAny2Regret_w0_1_start95,TSPB,71052,22975,48077,2,100,200
NearestNeighborAny2Regret_w0_1_start96,TSPB,76080,23244,52836,3,100,200
NearestNeighborAny2Regret_w0_1_start97,TSPB,74334,24530,49804,3,100,200
NearestNeighborAny2Regret_w0_1_start98,TSPB,76347,25136,51211,2,100,200
NearestNeighborAny2Regret_w0_1_start99,TSPB,75832,25028,50804,3,100,200
NearestNeighborAny2Regret_w0_1_start100,TSPB,71480,21190,50290,3,100,200
NearestNeighborAny2Regret_w0_1_start101,TSPB,71118,23162,47956,3,100,200
NearestNeighborAny2Regret_w0_1_start102,TSPB,72726,22999,49727,3,100,200
NearestNeighborAny2Regret_w0_1_start103,TSPB,74447,24994,49453,3,100,200
NearestNeighborAny2Regret_w0_1_start104,TSPB,73576,24823,48753,2,100,200
NearestNeighborAny2Regret_w0_1_start105,TSPB,76072,22387,53685,3,100,200
NearestNeighborAny2Regret_w0_1_start106,TSPB,74209,22489,51720,3,100,200
NearestNeighborAny2Regret_w0_1_start107,TSPB,71984,21520,50464,2,100,200
NearestNeighborAny2Regret_w0_1_start108,TSPB,75334,23617,51717,3,100,200
NearestNeighborAny2Regret_w0_1_start109,TSPB,74600,23890,50710,3,100,200
NearestNeighborAny2Regret_w0_1_start110,TSPB,73204,22700,50504,2,100,200
NearestNeighborAny2Regret_w0_1_start111,TSPB,71799,23023,48776,3,100,200
NearestNeighborAny2Regret_w0_1_start112,TSPB,74584,23265,51319,3,100,200
NearestNeighborAny2Regret_w0_1_start113,TSPB,74017,24611,49406,3,100,200
NearestNeighborAny2Regret_w0_1_start114,TSPB,75743,24218,51525,3,100,200
NearestNeighborAny2Regret_w0_1_start115,TSPB,71090,22738,48352,2,100,200
NearestNeighborAny2Regret_w0_1_start116,TSPB,74195,23844,50351,3,100,200
NearestNeighborAny2Regret_w0_1_start117,TSPB,71485,23388,48097,3,100,200
NearestNeighborAny2Regret_w0_1_start118,TSPB,77280,25631,51649,3,100,200
NearestNeighborAny2Regret_w0_1_start119,TSPB,72892,22255,50637,2,100,200
NearestNeighborAny2Regret_w0_1_start120,TSPB,75380,23712,51668,3,100,200
NearestNeighborAny2Regret_w0_1_start121,TSPB,76938,24194,52744,3,100,200
NearestNeighborAny2Regret_w0_1_start122,TSPB,75130,22985,52145,2,100,200
NearestNeighborAny2Regret_w0_1_start123,TSPB,73829,24760,49069,3,100,200
NearestNeighborAny2Regret_w0_1_start124,TSPB,73701,24662,49039,3,100,200
NearestNeighborAny2Regret_w0_1_start125,TSPB,77201,24934,52267,3,100,200
NearestNeighborAny2Regret_w0_1_start126,TSPB,76072,25456,50616,2,100,200
NearestNeighborAny2Regret_w0_1_start127,TSPB,76950,25364,51586,3,100,200
NearestNeighborAny2Regret_w0_1_start128,TSPB,75743,23387,52356,3,100,200
NearestNeighborAny2Regret_w0_1_start129,TSPB,73911,23118,50793,3,100,200
NearestNeighborAny2Regret_w0_1_start130,TSPB,74002,23329,50673,2,100,200
NearestNeighborAny2Regret_w0_1_start131,TSPB,73636,22430,51206,3,100,200
NearestNeighborAny2Regret_w0_1_start132,TSPB,77317,23860,53457,3,100,200
NearestNeighborAny2Regret_w0_1_start133,TSPB,73662,23068,50594,2,100,200
NearestNeighborAny2Regret_w0_1_start134,TSPB,75099,23803,51296,3,100,200
NearestNeighborAny2Regret_w0_1_start135,TSPB,72339,22236,50103,3,100,200
NearestNeighborAny2Regret_w0_1_start136,TSPB,73350,22561,50789,2,100,200
NearestNeighborAny2Regret_w0_1_start137,TSPB,73801,23773,50028,3,100,200
NearestNeighborAny2Regret_w0_1_start138,TSPB,73098,21819,51279,3,100,200
NearestNeighborAny2Regret_w0_1_start139,TSPB,72383,22446,49937,2,100,200
NearestNeighborAny2Regret_w0_1_start140,TSPB,73919,23235,50684,3,100,200
NearestNeighborAny2Regret_w0_1_start141,TSPB,74314,24265,50049,3,100,200
NearestNeighborAny2Regret_w0_1_start142,TSPB,73901,24495,49406,2,100,200
NearestNeighborAny2Regret_w0_1_start143,TSPB,75036,24519,50517,3,100,200
NearestNeighborAny2Regret_w0_1_start144,TSPB,74884,23941,50943,3,100,200
NearestNeighborAny2Regret_w0_1_start145,TSPB,74690,24950,49740,3,100,200
NearestNeighborAny2Regret_w0_1_start146,TSPB,77097,24495,52602,2,100,200
NearestNeighborAny2Regret_w0_1_start147,TSPB,78051,25152,52899,3,100,200
NearestNeighborAny2Regret_w0_1_start148,TSPB,74062,23097,50965,3,100,200
NearestNeighborAny2Regret_w0_1_start149,TSPB,73784,23711,50073,3,100,200
NearestNeighborAny2Regret_w0_1_start150,TSPB,76770,24013,52757,2,100,200
NearestNeighborAny2Regret_w0_1_start151,TSPB,74271,24753,49518,3,100,200
NearestNeighborAny2Regret_w0_1_start152,TSPB,70181,23134,47047,3,100,200
NearestNeighborAny2Regret_w0_1_start153,TSPB,77167,25654,51513,3,100,200
NearestNeighborAny2Regret_w0_1_start154,TSPB,75749,24155,51594,2,100,200
NearestNeighborAny2Regret_w0_1_start155,TSPB,80278,25790,54488,3,100,200
NearestNeighborAny2Regret_w0_1_start156,TSPB,75546,23247,52299,3,100,200
NearestNeighborAny2Regret_w0_1_start157,TSPB,73780,23322,50458,3,100,200
NearestNeighborAny2Regret_w0_1_start158,TSPB,74724,22848,51876,2,100,200
NearestNeighborAny2Regret_w0_1_start159,TSPB,74039,23546,50493,3,100,200
NearestNeighborAny2Regret_w0_1_start160,TSPB,72316,23411,48905,3,100,200
NearestNeighborAny2Regret_w0_1_start161,TSPB,76386,22987,53399,2,100,200
NearestNeighborAny2Regret_w0_1_start162,TSPB,75915,23864,52051,3,100,200
NearestNeighborAny2Regret_w0_1_start163,TSPB,74289,24947,49342,3,100,200
NearestNeighborAny2Regret_w0_1_start164,TSPB,73251,21596,51655,3,100,200
NearestNeighborAny2Regret_w0_1_start165,TSPB,73784,22854,50930,2,100,200
NearestNeighborAny2Regret_w0_1_start166,TSPB,71461,22402,49059,3,100,200
NearestNeighborAny2Regret_w0_1_start167,TSPB,75551,23425,52126,3,100,200
NearestNeighborAny2Regret_w0_1_start168,TSPB,71698,22681,49017,3,100,200
NearestNeighborAny2Regret_w0_1_start169,TSPB,75881,24847,51034,2,100,200
NearestNeighborAny2Regret_w0_1_start170,TSPB,73512,23362,50150,3,100,200
NearestNeighborAny2Regret_w0_1_start171,TSPB,71457,24323,47134,3,100,200
NearestNeighborAny2Regret_w0_1_start172,TSPB,75674,25019,50655,2,100,200
NearestNeighborAny2Regret_w0_1_start173,TSPB,74866,23686,51180,3,100,200
NearestNeighborAny2Regret_w0_1_start174,TSPB,73293,23487,49806,3,100,200
NearestNeighborAny2Regret_w0_1_start175,TSPB,73498,24485,49013,3,100,200
NearestNeighborAny2Regret_w0_1_start176,TSPB,76926,24383,52543,2,100,200
NearestNeighborAny2Regret_w0_1_start177,TSPB,73434,24697,48737,3,100,200
NearestNeighborAny2Regret_w0_1_start178,TSPB,70633,22298,48335,3,100,200
NearestNeighborAny2Regret_w0_1_start179,TSPB,73558,24859,48699,3,100,200
NearestNeighborAny2Regret_w0_1_start180,TSPB,77557,24385,53172,2,100,200
NearestNeighborAny2Regret_w0_1_start181,TSPB,70499,22361,48138,3,100,200
NearestNeighborAny2Regret_w0_1_start182,TSPB,74722,24501,50221,3,100,200
NearestNeighborAny2Regret_w0_1_start183,TSPB,72439,22956,49483,3,100,200
NearestNeighborAny2Regret_w0_1_start184,TSPB,74906,24679,50227,3,100,200
NearestNeighborAny2Regret_w0_1_start185,TSPB,73295,24278,49017,2,100,200
NearestNeighborAny2Regret_w0_1_start186,TSPB,76224,24122,52102,3,100,200
NearestNeighborAny2Regret_w0_1_start187,TSPB,77523,25328,52195,3,100,200
NearestNeighborAny2Regret_w0_1_start188,TSPB,75085,23195,51890,2,100,200
NearestNeighborAny2Regret_w0_1_start189,TSPB,73477,23314,50163,3,100,200
NearestNeighborAny2Regret_w0_1_start190,TSPB,75065,22525,52540,3,100,200
NearestNeighborAny2Regret_w0_1_start191,TSPB,75073,23905,51168,2,100,200
NearestNeighborAny2Regret_w0_1_start192,TSPB,76175,23170,53005,3,100,200
NearestNeighborAny2Regret_w0_1_start193,TSPB,72991,23151,49840,3,100,200
NearestNeighborAny2Regret_w0_1_start194,TSPB,75036,24519,50517,2,100,200
NearestNeighborAny2Regret_w0_1_start195,TSPB,76381,23606,52775,3,100,200
NearestNeighborAny2Regret_w0_1_start196,TSPB,76680,23847,52833,3,100,200
NearestNeighborAny2Regret_w0_1_start197,TSPB,76967,23985,52982,2,100,200
NearestNeighborAny2Regret_w0_1_start198,TSPB,74481,22406,52075,3,100,200
NearestNeighborAny2Regret_w0_1_start199,TSPB,73108,23539,49569,3,100,200
