node_costs,computation_time_ms,instance,selected_nodes_count,total_nodes,path_length,algorithm,objective_value,base_algorithm
33092,5,TSPB,100,200,18657,GreedyCycle2Regret_w1_1_start0,51749,GreedyCycle2Regret_w1_1
32295,4,TSPB,100,200,19591,GreedyCycle2Regret_w1_1_start1,51886,GreedyCycle2Regret_w1_1
29046,5,TSPB,100,200,20242,GreedyCycle2Regret_w1_1_start2,49288,GreedyCycle2Regret_w1_1
32511,4,TSPB,100,200,17572,GreedyCycle2Regret_w1_1_start3,50083,GreedyCycle2Regret_w1_1
26659,4,TSPB,100,200,20891,GreedyCycle2Regret_w1_1_start4,47550,GreedyCycle2Regret_w1_1
32332,5,TSPB,100,200,19921,GreedyCycle2Regret_w1_1_start5,52253,GreedyCycle2Regret_w1_1
30082,4,TSPB,100,200,20739,GreedyCycle2Regret_w1_1_start6,50821,GreedyCycle2Regret_w1_1
33212,4,TSPB,100,200,19821,GreedyCycle2Regret_w1_1_start7,53033,GreedyCycle2Regret_w1_1
28655,4,TSPB,100,200,20542,GreedyCycle2Regret_w1_1_start8,49197,GreedyCycle2Regret_w1_1
26222,4,TSPB,100,200,21202,GreedyCycle2Regret_w1_1_start9,47424,GreedyCycle2Regret_w1_1
34321,4,TSPB,100,200,18892,GreedyCycle2Regret_w1_1_start10,53213,GreedyCycle2Regret_w1_1
33092,5,TSPB,100,200,18657,GreedyCycle2Regret_w1_1_start11,51749,GreedyCycle2Regret_w1_1
33090,4,TSPB,100,200,18824,GreedyCycle2Regret_w1_1_start12,51914,GreedyCycle2Regret_w1_1
28752,4,TSPB,100,200,20332,GreedyCycle2Regret_w1_1_start13,49084,GreedyCycle2Regret_w1_1
31500,4,TSPB,100,200,20501,GreedyCycle2Regret_w1_1_start14,52001,GreedyCycle2Regret_w1_1
32511,4,TSPB,100,200,17572,GreedyCycle2Regret_w1_1_start15,50083,GreedyCycle2Regret_w1_1
34916,4,TSPB,100,200,19040,GreedyCycle2Regret_w1_1_start16,53956,GreedyCycle2Regret_w1_1
33600,4,TSPB,100,200,19106,GreedyCycle2Regret_w1_1_start17,52706,GreedyCycle2Regret_w1_1
33033,5,TSPB,100,200,17976,GreedyCycle2Regret_w1_1_start18,51009,GreedyCycle2Regret_w1_1
34916,4,TSPB,100,200,19102,GreedyCycle2Regret_w1_1_start19,54018,GreedyCycle2Regret_w1_1
26124,4,TSPB,100,200,21075,GreedyCycle2Regret_w1_1_start20,47199,GreedyCycle2Regret_w1_1
32661,4,TSPB,100,200,19327,GreedyCycle2Regret_w1_1_start21,51988,GreedyCycle2Regret_w1_1
27642,4,TSPB,100,200,20514,GreedyCycle2Regret_w1_1_start22,48156,GreedyCycle2Regret_w1_1
26586,4,TSPB,100,200,21074,GreedyCycle2Regret_w1_1_start23,47660,GreedyCycle2Regret_w1_1
34276,4,TSPB,100,200,18391,GreedyCycle2Regret_w1_1_start24,52667,GreedyCycle2Regret_w1_1
33480,4,TSPB,100,200,20314,GreedyCycle2Regret_w1_1_start25,53794,GreedyCycle2Regret_w1_1
30229,4,TSPB,100,200,21475,GreedyCycle2Regret_w1_1_start26,51704,GreedyCycle2Regret_w1_1
34916,4,TSPB,100,200,19102,GreedyCycle2Regret_w1_1_start27,54018,GreedyCycle2Regret_w1_1
26659,4,TSPB,100,200,20891,GreedyCycle2Regret_w1_1_start28,47550,GreedyCycle2Regret_w1_1
33092,4,TSPB,100,200,18657,GreedyCycle2Regret_w1_1_start29,51749,GreedyCycle2Regret_w1_1
32463,4,TSPB,100,200,20435,GreedyCycle2Regret_w1_1_start30,52898,GreedyCycle2Regret_w1_1
31253,4,TSPB,100,200,20490,GreedyCycle2Regret_w1_1_start31,51743,GreedyCycle2Regret_w1_1
33650,4,TSPB,100,200,19033,GreedyCycle2Regret_w1_1_start32,52683,GreedyCycle2Regret_w1_1
33092,4,TSPB,100,200,18657,GreedyCycle2Regret_w1_1_start33,51749,GreedyCycle2Regret_w1_1
29308,4,TSPB,100,200,21661,GreedyCycle2Regret_w1_1_start34,50969,GreedyCycle2Regret_w1_1
33092,4,TSPB,100,200,18657,GreedyCycle2Regret_w1_1_start35,51749,GreedyCycle2Regret_w1_1
32332,4,TSPB,100,200,20266,GreedyCycle2Regret_w1_1_start36,52598,GreedyCycle2Regret_w1_1
28559,4,TSPB,100,200,21125,GreedyCycle2Regret_w1_1_start37,49684,GreedyCycle2Regret_w1_1
34090,4,TSPB,100,200,19561,GreedyCycle2Regret_w1_1_start38,53651,GreedyCycle2Regret_w1_1
33088,4,TSPB,100,200,18829,GreedyCycle2Regret_w1_1_start39,51917,GreedyCycle2Regret_w1_1
33585,4,TSPB,100,200,19069,GreedyCycle2Regret_w1_1_start40,52654,GreedyCycle2Regret_w1_1
28393,4,TSPB,100,200,21139,GreedyCycle2Regret_w1_1_start41,49532,GreedyCycle2Regret_w1_1
32200,4,TSPB,100,200,20596,GreedyCycle2Regret_w1_1_start42,52796,GreedyCycle2Regret_w1_1
30089,4,TSPB,100,200,20914,GreedyCycle2Regret_w1_1_start43,51003,GreedyCycle2Regret_w1_1
34693,4,TSPB,100,200,18861,GreedyCycle2Regret_w1_1_start44,53554,GreedyCycle2Regret_w1_1
32332,4,TSPB,100,200,19921,GreedyCycle2Regret_w1_1_start45,52253,GreedyCycle2Regret_w1_1
32181,4,TSPB,100,200,19917,GreedyCycle2Regret_w1_1_start46,52098,GreedyCycle2Regret_w1_1
26659,4,TSPB,100,200,21263,GreedyCycle2Regret_w1_1_start47,47922,GreedyCycle2Regret_w1_1
28050,4,TSPB,100,200,20992,GreedyCycle2Regret_w1_1_start48,49042,GreedyCycle2Regret_w1_1
28099,4,TSPB,100,200,21139,GreedyCycle2Regret_w1_1_start49,49238,GreedyCycle2Regret_w1_1
31494,4,TSPB,100,200,20554,GreedyCycle2Regret_w1_1_start50,52048,GreedyCycle2Regret_w1_1
32060,4,TSPB,100,200,20393,GreedyCycle2Regret_w1_1_start51,52453,GreedyCycle2Regret_w1_1
27781,5,TSPB,100,200,20562,GreedyCycle2Regret_w1_1_start52,48343,GreedyCycle2Regret_w1_1
27837,4,TSPB,100,200,20472,GreedyCycle2Regret_w1_1_start53,48309,GreedyCycle2Regret_w1_1
31253,4,TSPB,100,200,20490,GreedyCycle2Regret_w1_1_start54,51743,GreedyCycle2Regret_w1_1
26454,4,TSPB,100,200,21600,GreedyCycle2Regret_w1_1_start55,48054,GreedyCycle2Regret_w1_1
32606,4,TSPB,100,200,19720,GreedyCycle2Regret_w1_1_start56,52326,GreedyCycle2Regret_w1_1
26659,4,TSPB,100,200,20891,GreedyCycle2Regret_w1_1_start57,47550,GreedyCycle2Regret_w1_1
32332,4,TSPB,100,200,19929,GreedyCycle2Regret_w1_1_start58,52261,GreedyCycle2Regret_w1_1
26659,4,TSPB,100,200,20891,GreedyCycle2Regret_w1_1_start59,47550,GreedyCycle2Regret_w1_1
26124,4,TSPB,100,200,21075,GreedyCycle2Regret_w1_1_start60,47199,GreedyCycle2Regret_w1_1
32332,4,TSPB,100,200,20266,GreedyCycle2Regret_w1_1_start61,52598,GreedyCycle2Regret_w1_1
26454,5,TSPB,100,200,21600,GreedyCycle2Regret_w1_1_start62,48054,GreedyCycle2Regret_w1_1
34321,4,TSPB,100,200,18892,GreedyCycle2Regret_w1_1_start63,53213,GreedyCycle2Regret_w1_1
30385,4,TSPB,100,200,21182,GreedyCycle2Regret_w1_1_start64,51567,GreedyCycle2Regret_w1_1
32652,4,TSPB,100,200,17520,GreedyCycle2Regret_w1_1_start65,50172,GreedyCycle2Regret_w1_1
26401,4,TSPB,100,200,21246,GreedyCycle2Regret_w1_1_start66,47647,GreedyCycle2Regret_w1_1
32477,4,TSPB,100,200,19669,GreedyCycle2Regret_w1_1_start67,52146,GreedyCycle2Regret_w1_1
34597,4,TSPB,100,200,19699,GreedyCycle2Regret_w1_1_start68,54296,GreedyCycle2Regret_w1_1
33860,4,TSPB,100,200,18615,GreedyCycle2Regret_w1_1_start69,52475,GreedyCycle2Regret_w1_1
32511,3,TSPB,100,200,17572,GreedyCycle2Regret_w1_1_start70,50083,GreedyCycle2Regret_w1_1
32344,3,TSPB,100,200,19410,GreedyCycle2Regret_w1_1_start71,51754,GreedyCycle2Regret_w1_1
33585,4,TSPB,100,200,19069,GreedyCycle2Regret_w1_1_start72,52654,GreedyCycle2Regret_w1_1
31253,4,TSPB,100,200,20490,GreedyCycle2Regret_w1_1_start73,51743,GreedyCycle2Regret_w1_1
32330,4,TSPB,100,200,19792,GreedyCycle2Regret_w1_1_start74,52122,GreedyCycle2Regret_w1_1
30585,4,TSPB,100,200,21468,GreedyCycle2Regret_w1_1_start75,52053,GreedyCycle2Regret_w1_1
30708,4,TSPB,100,200,21231,GreedyCycle2Regret_w1_1_start76,51939,GreedyCycle2Regret_w1_1
38926,4,TSPB,100,200,17821,GreedyCycle2Regret_w1_1_start77,56747,GreedyCycle2Regret_w1_1
32332,4,TSPB,100,200,19921,GreedyCycle2Regret_w1_1_start78,52253,GreedyCycle2Regret_w1_1
33051,4,TSPB,100,200,20132,GreedyCycle2Regret_w1_1_start79,53183,GreedyCycle2Regret_w1_1
31253,4,TSPB,100,200,20325,GreedyCycle2Regret_w1_1_start80,51578,GreedyCycle2Regret_w1_1
30293,4,TSPB,100,200,21460,GreedyCycle2Regret_w1_1_start81,51753,GreedyCycle2Regret_w1_1
32661,4,TSPB,100,200,19327,GreedyCycle2Regret_w1_1_start82,51988,GreedyCycle2Regret_w1_1
27787,4,TSPB,100,200,20796,GreedyCycle2Regret_w1_1_start83,48583,GreedyCycle2Regret_w1_1
33571,4,TSPB,100,200,18320,GreedyCycle2Regret_w1_1_start84,51891,GreedyCycle2Regret_w1_1
32114,4,TSPB,100,200,18933,GreedyCycle2Regret_w1_1_start85,51047,GreedyCycle2Regret_w1_1
27045,4,TSPB,100,200,21090,GreedyCycle2Regret_w1_1_start86,48135,GreedyCycle2Regret_w1_1
32606,4,TSPB,100,200,19324,GreedyCycle2Regret_w1_1_start87,51930,GreedyCycle2Regret_w1_1
30142,4,TSPB,100,200,21219,GreedyCycle2Regret_w1_1_start88,51361,GreedyCycle2Regret_w1_1
30229,4,TSPB,100,200,21475,GreedyCycle2Regret_w1_1_start89,51704,GreedyCycle2Regret_w1_1
32925,4,TSPB,100,200,19212,GreedyCycle2Regret_w1_1_start90,52137,GreedyCycle2Regret_w1_1
32332,4,TSPB,100,200,20266,GreedyCycle2Regret_w1_1_start91,52598,GreedyCycle2Regret_w1_1
32783,4,TSPB,100,200,19113,GreedyCycle2Regret_w1_1_start92,51896,GreedyCycle2Regret_w1_1
31453,4,TSPB,100,200,21469,GreedyCycle2Regret_w1_1_start93,52922,GreedyCycle2Regret_w1_1
26659,4,TSPB,100,200,21263,GreedyCycle2Regret_w1_1_start94,47922,GreedyCycle2Regret_w1_1
27045,4,TSPB,100,200,21090,GreedyCycle2Regret_w1_1_start95,48135,GreedyCycle2Regret_w1_1
33679,4,TSPB,100,200,19040,GreedyCycle2Regret_w1_1_start96,52719,GreedyCycle2Regret_w1_1
30293,4,TSPB,100,200,21460,GreedyCycle2Regret_w1_1_start97,51753,GreedyCycle2Regret_w1_1
31563,3,TSPB,100,200,19765,GreedyCycle2Regret_w1_1_start98,51328,GreedyCycle2Regret_w1_1
27077,4,TSPB,100,200,20918,GreedyCycle2Regret_w1_1_start99,47995,GreedyCycle2Regret_w1_1
33585,5,TSPB,100,200,19141,GreedyCycle2Regret_w1_1_start100,52726,GreedyCycle2Regret_w1_1
27350,4,TSPB,100,200,20699,GreedyCycle2Regret_w1_1_start101,48049,GreedyCycle2Regret_w1_1
33585,4,TSPB,100,200,19069,GreedyCycle2Regret_w1_1_start102,52654,GreedyCycle2Regret_w1_1
30229,4,TSPB,100,200,21475,GreedyCycle2Regret_w1_1_start103,51704,GreedyCycle2Regret_w1_1
28201,4,TSPB,100,200,20990,GreedyCycle2Regret_w1_1_start104,49191,GreedyCycle2Regret_w1_1
32114,4,TSPB,100,200,20058,GreedyCycle2Regret_w1_1_start105,52172,GreedyCycle2Regret_w1_1
26454,4,TSPB,100,200,21600,GreedyCycle2Regret_w1_1_start106,48054,GreedyCycle2Regret_w1_1
32852,4,TSPB,100,200,19304,GreedyCycle2Regret_w1_1_start107,52156,GreedyCycle2Regret_w1_1
32852,4,TSPB,100,200,20660,GreedyCycle2Regret_w1_1_start108,53512,GreedyCycle2Regret_w1_1
33092,4,TSPB,100,200,18657,GreedyCycle2Regret_w1_1_start109,51749,GreedyCycle2Regret_w1_1
31965,4,TSPB,100,200,21005,GreedyCycle2Regret_w1_1_start110,52970,GreedyCycle2Regret_w1_1
28201,4,TSPB,100,200,21005,GreedyCycle2Regret_w1_1_start111,49206,GreedyCycle2Regret_w1_1
34916,4,TSPB,100,200,19040,GreedyCycle2Regret_w1_1_start112,53956,GreedyCycle2Regret_w1_1
27642,4,TSPB,100,200,20657,GreedyCycle2Regret_w1_1_start113,48299,GreedyCycle2Regret_w1_1
26943,5,TSPB,100,200,21255,GreedyCycle2Regret_w1_1_start114,48198,GreedyCycle2Regret_w1_1
34321,4,TSPB,100,200,18892,GreedyCycle2Regret_w1_1_start115,53213,GreedyCycle2Regret_w1_1
32759,3,TSPB,100,200,20446,GreedyCycle2Regret_w1_1_start116,53205,GreedyCycle2Regret_w1_1
31253,4,TSPB,100,200,20428,GreedyCycle2Regret_w1_1_start117,51681,GreedyCycle2Regret_w1_1
33171,4,TSPB,100,200,20044,GreedyCycle2Regret_w1_1_start118,53215,GreedyCycle2Regret_w1_1
33142,4,TSPB,100,200,18193,GreedyCycle2Regret_w1_1_start119,51335,GreedyCycle2Regret_w1_1
32380,4,TSPB,100,200,19665,GreedyCycle2Regret_w1_1_start120,52045,GreedyCycle2Regret_w1_1
34916,4,TSPB,100,200,19133,GreedyCycle2Regret_w1_1_start121,54049,GreedyCycle2Regret_w1_1
33001,4,TSPB,100,200,19481,GreedyCycle2Regret_w1_1_start122,52482,GreedyCycle2Regret_w1_1
33181,4,TSPB,100,200,19973,GreedyCycle2Regret_w1_1_start123,53154,GreedyCycle2Regret_w1_1
26454,4,TSPB,100,200,21475,GreedyCycle2Regret_w1_1_start124,47929,GreedyCycle2Regret_w1_1
33532,4,TSPB,100,200,19193,GreedyCycle2Regret_w1_1_start125,52725,GreedyCycle2Regret_w1_1
28888,4,TSPB,100,200,20314,GreedyCycle2Regret_w1_1_start126,49202,GreedyCycle2Regret_w1_1
30229,4,TSPB,100,200,21475,GreedyCycle2Regret_w1_1_start127,51704,GreedyCycle2Regret_w1_1
30090,4,TSPB,100,200,21147,GreedyCycle2Regret_w1_1_start128,51237,GreedyCycle2Regret_w1_1
29601,4,TSPB,100,200,21168,GreedyCycle2Regret_w1_1_start129,50769,GreedyCycle2Regret_w1_1
27077,3,TSPB,100,200,20918,GreedyCycle2Regret_w1_1_start130,47995,GreedyCycle2Regret_w1_1
32295,4,TSPB,100,200,19591,GreedyCycle2Regret_w1_1_start131,51886,GreedyCycle2Regret_w1_1
28752,4,TSPB,100,200,20332,GreedyCycle2Regret_w1_1_start132,49084,GreedyCycle2Regret_w1_1
33585,4,TSPB,100,200,19298,GreedyCycle2Regret_w1_1_start133,52883,GreedyCycle2Regret_w1_1
33151,4,TSPB,100,200,18275,GreedyCycle2Regret_w1_1_start134,51426,GreedyCycle2Regret_w1_1
33585,4,TSPB,100,200,19069,GreedyCycle2Regret_w1_1_start135,52654,GreedyCycle2Regret_w1_1
31253,4,TSPB,100,200,20325,GreedyCycle2Regret_w1_1_start136,51578,GreedyCycle2Regret_w1_1
30154,4,TSPB,100,200,21239,GreedyCycle2Regret_w1_1_start137,51393,GreedyCycle2Regret_w1_1
33092,4,TSPB,100,200,18657,GreedyCycle2Regret_w1_1_start138,51749,GreedyCycle2Regret_w1_1
33457,4,TSPB,100,200,18396,GreedyCycle2Regret_w1_1_start139,51853,GreedyCycle2Regret_w1_1
27077,4,TSPB,100,200,20918,GreedyCycle2Regret_w1_1_start140,47995,GreedyCycle2Regret_w1_1
30293,4,TSPB,100,200,21460,GreedyCycle2Regret_w1_1_start141,51753,GreedyCycle2Regret_w1_1
32332,4,TSPB,100,200,19921,GreedyCycle2Regret_w1_1_start142,52253,GreedyCycle2Regret_w1_1
32877,4,TSPB,100,200,19758,GreedyCycle2Regret_w1_1_start143,52635,GreedyCycle2Regret_w1_1
28181,4,TSPB,100,200,21240,GreedyCycle2Regret_w1_1_start144,49421,GreedyCycle2Regret_w1_1
32511,4,TSPB,100,200,17572,GreedyCycle2Regret_w1_1_start145,50083,GreedyCycle2Regret_w1_1
30293,4,TSPB,100,200,21460,GreedyCycle2Regret_w1_1_start146,51753,GreedyCycle2Regret_w1_1
31194,4,TSPB,100,200,19884,GreedyCycle2Regret_w1_1_start147,51078,GreedyCycle2Regret_w1_1
26401,4,TSPB,100,200,21246,GreedyCycle2Regret_w1_1_start148,47647,GreedyCycle2Regret_w1_1
26659,4,TSPB,100,200,20891,GreedyCycle2Regret_w1_1_start149,47550,GreedyCycle2Regret_w1_1
33311,4,TSPB,100,200,18663,GreedyCycle2Regret_w1_1_start150,51974,GreedyCycle2Regret_w1_1
33509,4,TSPB,100,200,18514,GreedyCycle2Regret_w1_1_start151,52023,GreedyCycle2Regret_w1_1
27077,4,TSPB,100,200,20918,GreedyCycle2Regret_w1_1_start152,47995,GreedyCycle2Regret_w1_1
29640,4,TSPB,100,200,21461,GreedyCycle2Regret_w1_1_start153,51101,GreedyCycle2Regret_w1_1
27226,4,TSPB,100,200,21083,GreedyCycle2Regret_w1_1_start154,48309,GreedyCycle2Regret_w1_1
33092,4,TSPB,100,200,19055,GreedyCycle2Regret_w1_1_start155,52147,GreedyCycle2Regret_w1_1
33509,4,TSPB,100,200,18514,GreedyCycle2Regret_w1_1_start156,52023,GreedyCycle2Regret_w1_1
28713,4,TSPB,100,200,21355,GreedyCycle2Regret_w1_1_start157,50068,GreedyCycle2Regret_w1_1
29804,4,TSPB,100,200,20485,GreedyCycle2Regret_w1_1_start158,50289,GreedyCycle2Regret_w1_1
33033,4,TSPB,100,200,17976,GreedyCycle2Regret_w1_1_start159,51009,GreedyCycle2Regret_w1_1
32964,4,TSPB,100,200,18828,GreedyCycle2Regret_w1_1_start160,51792,GreedyCycle2Regret_w1_1
32511,4,TSPB,100,200,17572,GreedyCycle2Regret_w1_1_start161,50083,GreedyCycle2Regret_w1_1
31253,4,TSPB,100,200,20325,GreedyCycle2Regret_w1_1_start162,51578,GreedyCycle2Regret_w1_1
30229,4,TSPB,100,200,21482,GreedyCycle2Regret_w1_1_start163,51711,GreedyCycle2Regret_w1_1
31253,4,TSPB,100,200,20490,GreedyCycle2Regret_w1_1_start164,51743,GreedyCycle2Regret_w1_1
30229,4,TSPB,100,200,21621,GreedyCycle2Regret_w1_1_start165,51850,GreedyCycle2Regret_w1_1
27642,4,TSPB,100,200,20657,GreedyCycle2Regret_w1_1_start166,48299,GreedyCycle2Regret_w1_1
33491,4,TSPB,100,200,18469,GreedyCycle2Regret_w1_1_start167,51960,GreedyCycle2Regret_w1_1
30054,4,TSPB,100,200,20854,GreedyCycle2Regret_w1_1_start168,50908,GreedyCycle2Regret_w1_1
28752,4,TSPB,100,200,20332,GreedyCycle2Regret_w1_1_start169,49084,GreedyCycle2Regret_w1_1
27077,4,TSPB,100,200,20918,GreedyCycle2Regret_w1_1_start170,47995,GreedyCycle2Regret_w1_1
33220,4,TSPB,100,200,19999,GreedyCycle2Regret_w1_1_start171,53219,GreedyCycle2Regret_w1_1
27045,4,TSPB,100,200,21070,GreedyCycle2Regret_w1_1_start172,48115,GreedyCycle2Regret_w1_1
31605,4,TSPB,100,200,20320,GreedyCycle2Regret_w1_1_start173,51925,GreedyCycle2Regret_w1_1
27886,4,TSPB,100,200,21310,GreedyCycle2Regret_w1_1_start174,49196,GreedyCycle2Regret_w1_1
32332,5,TSPB,100,200,19921,GreedyCycle2Regret_w1_1_start175,52253,GreedyCycle2Regret_w1_1
29601,4,TSPB,100,200,21168,GreedyCycle2Regret_w1_1_start176,50769,GreedyCycle2Regret_w1_1
32332,4,TSPB,100,200,19921,GreedyCycle2Regret_w1_1_start177,52253,GreedyCycle2Regret_w1_1
34321,4,TSPB,100,200,18892,GreedyCycle2Regret_w1_1_start178,53213,GreedyCycle2Regret_w1_1
27642,4,TSPB,100,200,20657,GreedyCycle2Regret_w1_1_start179,48299,GreedyCycle2Regret_w1_1
27893,4,TSPB,100,200,20496,GreedyCycle2Regret_w1_1_start180,48389,GreedyCycle2Regret_w1_1
27302,4,TSPB,100,200,20595,GreedyCycle2Regret_w1_1_start181,47897,GreedyCycle2Regret_w1_1
33092,4,TSPB,100,200,18657,GreedyCycle2Regret_w1_1_start182,51749,GreedyCycle2Regret_w1_1
27077,4,TSPB,100,200,20918,GreedyCycle2Regret_w1_1_start183,47995,GreedyCycle2Regret_w1_1
26429,4,TSPB,100,200,21932,GreedyCycle2Regret_w1_1_start184,48361,GreedyCycle2Regret_w1_1
27045,4,TSPB,100,200,21090,GreedyCycle2Regret_w1_1_start185,48135,GreedyCycle2Regret_w1_1
30293,4,TSPB,100,200,21460,GreedyCycle2Regret_w1_1_start186,51753,GreedyCycle2Regret_w1_1
30293,4,TSPB,100,200,21460,GreedyCycle2Regret_w1_1_start187,51753,GreedyCycle2Regret_w1_1
28752,4,TSPB,100,200,20332,GreedyCycle2Regret_w1_1_start188,49084,GreedyCycle2Regret_w1_1
33499,4,TSPB,100,200,18317,GreedyCycle2Regret_w1_1_start189,51816,GreedyCycle2Regret_w1_1
31253,4,TSPB,100,200,20325,GreedyCycle2Regret_w1_1_start190,51578,GreedyCycle2Regret_w1_1
31563,3,TSPB,100,200,19765,GreedyCycle2Regret_w1_1_start191,51328,GreedyCycle2Regret_w1_1
33299,4,TSPB,100,200,18659,GreedyCycle2Regret_w1_1_start192,51958,GreedyCycle2Regret_w1_1
31253,4,TSPB,100,200,20490,GreedyCycle2Regret_w1_1_start193,51743,GreedyCycle2Regret_w1_1
27642,4,TSPB,100,200,20657,GreedyCycle2Regret_w1_1_start194,48299,GreedyCycle2Regret_w1_1
28752,4,TSPB,100,200,20332,GreedyCycle2Regret_w1_1_start195,49084,GreedyCycle2Regret_w1_1
33139,4,TSPB,100,200,20355,GreedyCycle2Regret_w1_1_start196,53494,GreedyCycle2Regret_w1_1
34283,4,TSPB,100,200,18404,GreedyCycle2Regret_w1_1_start197,52687,GreedyCycle2Regret_w1_1
31253,4,TSPB,100,200,20431,GreedyCycle2Regret_w1_1_start198,51684,GreedyCycle2Regret_w1_1
25992,4,TSPB,100,200,21152,GreedyCycle2Regret_w1_1_start199,47144,GreedyCycle2Regret_w1_1
26765,3,TSPB,100,200,19452,NearestNeighborAny2Regret_w1_1_start0,46217,NearestNeighborAny2Regret_w1_1
24752,3,TSPB,100,200,20139,NearestNeighborAny2Regret_w1_1_start1,44891,NearestNeighborAny2Regret_w1_1
27420,2,TSPB,100,200,19125,NearestNeighborAny2Regret_w1_1_start2,46545,NearestNeighborAny2Regret_w1_1
28148,3,TSPB,100,200,20730,NearestNeighborAny2Regret_w1_1_start3,48878,NearestNeighborAny2Regret_w1_1
26863,3,TSPB,100,200,22026,NearestNeighborAny2Regret_w1_1_start4,48889,NearestNeighborAny2Regret_w1_1
27545,2,TSPB,100,200,20608,NearestNeighborAny2Regret_w1_1_start5,48153,NearestNeighborAny2Regret_w1_1
25205,3,TSPB,100,200,20957,NearestNeighborAny2Regret_w1_1_start6,46162,NearestNeighborAny2Regret_w1_1
31463,3,TSPB,100,200,18855,NearestNeighborAny2Regret_w1_1_start7,50318,NearestNeighborAny2Regret_w1_1
26765,3,TSPB,100,200,19452,NearestNeighborAny2Regret_w1_1_start8,46217,NearestNeighborAny2Regret_w1_1
26354,2,TSPB,100,200,20258,NearestNeighborAny2Regret_w1_1_start9,46612,NearestNeighborAny2Regret_w1_1
24745,3,TSPB,100,200,22351,NearestNeighborAny2Regret_w1_1_start10,47096,NearestNeighborAny2Regret_w1_1
30766,3,TSPB,100,200,19832,NearestNeighborAny2Regret_w1_1_start11,50598,NearestNeighborAny2Regret_w1_1
27049,3,TSPB,100,200,19490,NearestNeighborAny2Regret_w1_1_start12,46539,NearestNeighborAny2Regret_w1_1
28393,2,TSPB,100,200,20423,NearestNeighborAny2Regret_w1_1_start13,48816,NearestNeighborAny2Regret_w1_1
28214,3,TSPB,100,200,20134,NearestNeighborAny2Regret_w1_1_start14,48348,NearestNeighborAny2Regret_w1_1
28148,3,TSPB,100,200,20730,NearestNeighborAny2Regret_w1_1_start15,48878,NearestNeighborAny2Regret_w1_1
24752,3,TSPB,100,200,20139,NearestNeighborAny2Regret_w1_1_start16,44891,NearestNeighborAny2Regret_w1_1
25853,2,TSPB,100,200,19869,NearestNeighborAny2Regret_w1_1_start17,45722,NearestNeighborAny2Regret_w1_1
26863,3,TSPB,100,200,22026,NearestNeighborAny2Regret_w1_1_start18,48889,NearestNeighborAny2Regret_w1_1
25525,3,TSPB,100,200,19918,NearestNeighborAny2Regret_w1_1_start19,45443,NearestNeighborAny2Regret_w1_1
28558,2,TSPB,100,200,19783,NearestNeighborAny2Regret_w1_1_start20,48341,NearestNeighborAny2Regret_w1_1
26823,3,TSPB,100,200,20423,NearestNeighborAny2Regret_w1_1_start21,47246,NearestNeighborAny2Regret_w1_1
28558,2,TSPB,100,200,19783,NearestNeighborAny2Regret_w1_1_start22,48341,NearestNeighborAny2Regret_w1_1
27153,3,TSPB,100,200,21978,NearestNeighborAny2Regret_w1_1_start23,49131,NearestNeighborAny2Regret_w1_1
25063,3,TSPB,100,200,20290,NearestNeighborAny2Regret_w1_1_start24,45353,NearestNeighborAny2Regret_w1_1
28558,3,TSPB,100,200,19783,NearestNeighborAny2Regret_w1_1_start25,48341,NearestNeighborAny2Regret_w1_1
25014,2,TSPB,100,200,20124,NearestNeighborAny2Regret_w1_1_start26,45138,NearestNeighborAny2Regret_w1_1
25205,3,TSPB,100,200,20957,NearestNeighborAny2Regret_w1_1_start27,46162,NearestNeighborAny2Regret_w1_1
26863,3,TSPB,100,200,22026,NearestNeighborAny2Regret_w1_1_start28,48889,NearestNeighborAny2Regret_w1_1
26765,3,TSPB,100,200,19452,NearestNeighborAny2Regret_w1_1_start29,46217,NearestNeighborAny2Regret_w1_1
25073,2,TSPB,100,200,20341,NearestNeighborAny2Regret_w1_1_start30,45414,NearestNeighborAny2Regret_w1_1
26166,3,TSPB,100,200,20593,NearestNeighborAny2Regret_w1_1_start31,46759,NearestNeighborAny2Regret_w1_1
28582,3,TSPB,100,200,19639,NearestNeighborAny2Regret_w1_1_start32,48221,NearestNeighborAny2Regret_w1_1
26765,2,TSPB,100,200,19452,NearestNeighborAny2Regret_w1_1_start33,46217,NearestNeighborAny2Regret_w1_1
26385,3,TSPB,100,200,20336,NearestNeighborAny2Regret_w1_1_start34,46721,NearestNeighborAny2Regret_w1_1
26765,3,TSPB,100,200,19452,NearestNeighborAny2Regret_w1_1_start35,46217,NearestNeighborAny2Regret_w1_1
28558,2,TSPB,100,200,19783,NearestNeighborAny2Regret_w1_1_start36,48341,NearestNeighborAny2Regret_w1_1
25042,3,TSPB,100,200,24082,NearestNeighborAny2Regret_w1_1_start37,49124,NearestNeighborAny2Regret_w1_1
25307,3,TSPB,100,200,20932,NearestNeighborAny2Regret_w1_1_start38,46239,NearestNeighborAny2Regret_w1_1
30952,2,TSPB,100,200,20186,NearestNeighborAny2Regret_w1_1_start39,51138,NearestNeighborAny2Regret_w1_1
28558,3,TSPB,100,200,19783,NearestNeighborAny2Regret_w1_1_start40,48341,NearestNeighborAny2Regret_w1_1
28115,3,TSPB,100,200,20155,NearestNeighborAny2Regret_w1_1_start41,48270,NearestNeighborAny2Regret_w1_1
24825,3,TSPB,100,200,20392,NearestNeighborAny2Regret_w1_1_start42,45217,NearestNeighborAny2Regret_w1_1
28148,2,TSPB,100,200,20730,NearestNeighborAny2Regret_w1_1_start43,48878,NearestNeighborAny2Regret_w1_1
28244,3,TSPB,100,200,20722,NearestNeighborAny2Regret_w1_1_start44,48966,NearestNeighborAny2Regret_w1_1
27545,3,TSPB,100,200,20608,NearestNeighborAny2Regret_w1_1_start45,48153,NearestNeighborAny2Regret_w1_1
27284,2,TSPB,100,200,19525,NearestNeighborAny2Regret_w1_1_start46,46809,NearestNeighborAny2Regret_w1_1
28558,3,TSPB,100,200,19783,NearestNeighborAny2Regret_w1_1_start47,48341,NearestNeighborAny2Regret_w1_1
31457,3,TSPB,100,200,23790,NearestNeighborAny2Regret_w1_1_start48,55247,NearestNeighborAny2Regret_w1_1
27076,2,TSPB,100,200,19255,NearestNeighborAny2Regret_w1_1_start49,46331,NearestNeighborAny2Regret_w1_1
28208,2,TSPB,100,200,20114,NearestNeighborAny2Regret_w1_1_start50,48322,NearestNeighborAny2Regret_w1_1
26166,3,TSPB,100,200,20593,NearestNeighborAny2Regret_w1_1_start51,46759,NearestNeighborAny2Regret_w1_1
29153,3,TSPB,100,200,19811,NearestNeighborAny2Regret_w1_1_start52,48964,NearestNeighborAny2Regret_w1_1
26663,2,TSPB,100,200,19962,NearestNeighborAny2Regret_w1_1_start53,46625,NearestNeighborAny2Regret_w1_1
26166,3,TSPB,100,200,20593,NearestNeighborAny2Regret_w1_1_start54,46759,NearestNeighborAny2Regret_w1_1
26863,3,TSPB,100,200,22026,NearestNeighborAny2Regret_w1_1_start55,48889,NearestNeighborAny2Regret_w1_1
27972,3,TSPB,100,200,20296,NearestNeighborAny2Regret_w1_1_start56,48268,NearestNeighborAny2Regret_w1_1
28558,2,TSPB,100,200,19783,NearestNeighborAny2Regret_w1_1_start57,48341,NearestNeighborAny2Regret_w1_1
28366,3,TSPB,100,200,21049,NearestNeighborAny2Regret_w1_1_start58,49415,NearestNeighborAny2Regret_w1_1
26863,3,TSPB,100,200,22026,NearestNeighborAny2Regret_w1_1_start59,48889,NearestNeighborAny2Regret_w1_1
26863,3,TSPB,100,200,22026,NearestNeighborAny2Regret_w1_1_start60,48889,NearestNeighborAny2Regret_w1_1
28558,3,TSPB,100,200,19783,NearestNeighborAny2Regret_w1_1_start61,48341,NearestNeighborAny2Regret_w1_1
26863,3,TSPB,100,200,22026,NearestNeighborAny2Regret_w1_1_start62,48889,NearestNeighborAny2Regret_w1_1
28517,2,TSPB,100,200,19675,NearestNeighborAny2Regret_w1_1_start63,48192,NearestNeighborAny2Regret_w1_1
26657,3,TSPB,100,200,19703,NearestNeighborAny2Regret_w1_1_start64,46360,NearestNeighborAny2Regret_w1_1
28643,3,TSPB,100,200,20420,NearestNeighborAny2Regret_w1_1_start65,49063,NearestNeighborAny2Regret_w1_1
28558,3,TSPB,100,200,19783,NearestNeighborAny2Regret_w1_1_start66,48341,NearestNeighborAny2Regret_w1_1
25226,3,TSPB,100,200,21000,NearestNeighborAny2Regret_w1_1_start67,46226,NearestNeighborAny2Regret_w1_1
32854,3,TSPB,100,200,18686,NearestNeighborAny2Regret_w1_1_start68,51540,NearestNeighborAny2Regret_w1_1
26258,3,TSPB,100,200,20294,NearestNeighborAny2Regret_w1_1_start69,46552,NearestNeighborAny2Regret_w1_1
28148,2,TSPB,100,200,20730,NearestNeighborAny2Regret_w1_1_start70,48878,NearestNeighborAny2Regret_w1_1
28337,3,TSPB,100,200,19132,NearestNeighborAny2Regret_w1_1_start71,47469,NearestNeighborAny2Regret_w1_1
25737,2,TSPB,100,200,19942,NearestNeighborAny2Regret_w1_1_start72,45679,NearestNeighborAny2Regret_w1_1
25416,3,TSPB,100,200,20477,NearestNeighborAny2Regret_w1_1_start73,45893,NearestNeighborAny2Regret_w1_1
26013,3,TSPB,100,200,22572,NearestNeighborAny2Regret_w1_1_start74,48585,NearestNeighborAny2Regret_w1_1
25344,3,TSPB,100,200,20902,NearestNeighborAny2Regret_w1_1_start75,46246,NearestNeighborAny2Regret_w1_1
32598,2,TSPB,100,200,21331,NearestNeighborAny2Regret_w1_1_start76,53929,NearestNeighborAny2Regret_w1_1
24752,3,TSPB,100,200,20139,NearestNeighborAny2Regret_w1_1_start77,44891,NearestNeighborAny2Regret_w1_1
27545,3,TSPB,100,200,20608,NearestNeighborAny2Regret_w1_1_start78,48153,NearestNeighborAny2Regret_w1_1
28638,3,TSPB,100,200,19764,NearestNeighborAny2Regret_w1_1_start79,48402,NearestNeighborAny2Regret_w1_1
26166,2,TSPB,100,200,20593,NearestNeighborAny2Regret_w1_1_start80,46759,NearestNeighborAny2Regret_w1_1
26863,3,TSPB,100,200,22026,NearestNeighborAny2Regret_w1_1_start81,48889,NearestNeighborAny2Regret_w1_1
27048,2,TSPB,100,200,20935,NearestNeighborAny2Regret_w1_1_start82,47983,NearestNeighborAny2Regret_w1_1
27099,3,TSPB,100,200,22022,NearestNeighborAny2Regret_w1_1_start83,49121,NearestNeighborAny2Regret_w1_1
26604,3,TSPB,100,200,19488,NearestNeighborAny2Regret_w1_1_start84,46092,NearestNeighborAny2Regret_w1_1
26671,2,TSPB,100,200,19456,NearestNeighborAny2Regret_w1_1_start85,46127,NearestNeighborAny2Regret_w1_1
28558,3,TSPB,100,200,19783,NearestNeighborAny2Regret_w1_1_start86,48341,NearestNeighborAny2Regret_w1_1
26960,3,TSPB,100,200,20397,NearestNeighborAny2Regret_w1_1_start87,47357,NearestNeighborAny2Regret_w1_1
28694,2,TSPB,100,200,19801,NearestNeighborAny2Regret_w1_1_start88,48495,NearestNeighborAny2Regret_w1_1
28558,3,TSPB,100,200,19783,NearestNeighborAny2Regret_w1_1_start89,48341,NearestNeighborAny2Regret_w1_1
25525,3,TSPB,100,200,19918,NearestNeighborAny2Regret_w1_1_start90,45443,NearestNeighborAny2Regret_w1_1
28558,2,TSPB,100,200,19783,NearestNeighborAny2Regret_w1_1_start91,48341,NearestNeighborAny2Regret_w1_1
28679,3,TSPB,100,200,19790,NearestNeighborAny2Regret_w1_1_start92,48469,NearestNeighborAny2Regret_w1_1
31617,3,TSPB,100,200,20927,NearestNeighborAny2Regret_w1_1_start93,52544,NearestNeighborAny2Regret_w1_1
28558,2,TSPB,100,200,19783,NearestNeighborAny2Regret_w1_1_start94,48341,NearestNeighborAny2Regret_w1_1
28970,3,TSPB,100,200,22934,NearestNeighborAny2Regret_w1_1_start95,51904,NearestNeighborAny2Regret_w1_1
28611,3,TSPB,100,200,19646,NearestNeighborAny2Regret_w1_1_start96,48257,NearestNeighborAny2Regret_w1_1
24935,2,TSPB,100,200,20223,NearestNeighborAny2Regret_w1_1_start97,45158,NearestNeighborAny2Regret_w1_1
26326,3,TSPB,100,200,19490,NearestNeighborAny2Regret_w1_1_start98,45816,NearestNeighborAny2Regret_w1_1
28558,3,TSPB,100,200,19783,NearestNeighborAny2Regret_w1_1_start99,48341,NearestNeighborAny2Regret_w1_1
28558,3,TSPB,100,200,19783,NearestNeighborAny2Regret_w1_1_start100,48341,NearestNeighborAny2Regret_w1_1
27264,2,TSPB,100,200,21938,NearestNeighborAny2Regret_w1_1_start101,49202,NearestNeighborAny2Regret_w1_1
28517,3,TSPB,100,200,19675,NearestNeighborAny2Regret_w1_1_start102,48192,NearestNeighborAny2Regret_w1_1
24752,3,TSPB,100,200,20139,NearestNeighborAny2Regret_w1_1_start103,44891,NearestNeighborAny2Regret_w1_1
26765,2,TSPB,100,200,19452,NearestNeighborAny2Regret_w1_1_start104,46217,NearestNeighborAny2Regret_w1_1
27605,3,TSPB,100,200,18553,NearestNeighborAny2Regret_w1_1_start105,46158,NearestNeighborAny2Regret_w1_1
26863,3,TSPB,100,200,22026,NearestNeighborAny2Regret_w1_1_start106,48889,NearestNeighborAny2Regret_w1_1
28558,3,TSPB,100,200,19783,NearestNeighborAny2Regret_w1_1_start107,48341,NearestNeighborAny2Regret_w1_1
27371,3,TSPB,100,200,20779,NearestNeighborAny2Regret_w1_1_start108,48150,NearestNeighborAny2Regret_w1_1
26765,2,TSPB,100,200,19452,NearestNeighborAny2Regret_w1_1_start109,46217,NearestNeighborAny2Regret_w1_1
27161,3,TSPB,100,200,19293,NearestNeighborAny2Regret_w1_1_start110,46454,NearestNeighborAny2Regret_w1_1
31294,3,TSPB,100,200,18776,NearestNeighborAny2Regret_w1_1_start111,50070,NearestNeighborAny2Regret_w1_1
24778,2,TSPB,100,200,20381,NearestNeighborAny2Regret_w1_1_start112,45159,NearestNeighborAny2Regret_w1_1
28558,3,TSPB,100,200,19783,NearestNeighborAny2Regret_w1_1_start113,48341,NearestNeighborAny2Regret_w1_1
26363,3,TSPB,100,200,19425,NearestNeighborAny2Regret_w1_1_start114,45788,NearestNeighborAny2Regret_w1_1
25836,3,TSPB,100,200,19912,NearestNeighborAny2Regret_w1_1_start115,45748,NearestNeighborAny2Regret_w1_1
25550,2,TSPB,100,200,19759,NearestNeighborAny2Regret_w1_1_start116,45309,NearestNeighborAny2Regret_w1_1
26166,3,TSPB,100,200,20593,NearestNeighborAny2Regret_w1_1_start117,46759,NearestNeighborAny2Regret_w1_1
25801,3,TSPB,100,200,19944,NearestNeighborAny2Regret_w1_1_start118,45745,NearestNeighborAny2Regret_w1_1
26746,3,TSPB,100,200,21595,NearestNeighborAny2Regret_w1_1_start119,48341,NearestNeighborAny2Regret_w1_1
25129,2,TSPB,100,200,21000,NearestNeighborAny2Regret_w1_1_start120,46129,NearestNeighborAny2Regret_w1_1
25525,3,TSPB,100,200,19918,NearestNeighborAny2Regret_w1_1_start121,45443,NearestNeighborAny2Regret_w1_1
28517,3,TSPB,100,200,19675,NearestNeighborAny2Regret_w1_1_start122,48192,NearestNeighborAny2Regret_w1_1
28768,2,TSPB,100,200,19776,NearestNeighborAny2Regret_w1_1_start123,48544,NearestNeighborAny2Regret_w1_1
26863,5,TSPB,100,200,22026,NearestNeighborAny2Regret_w1_1_start124,48889,NearestNeighborAny2Regret_w1_1
28517,3,TSPB,100,200,19675,NearestNeighborAny2Regret_w1_1_start125,48192,NearestNeighborAny2Regret_w1_1
28467,3,TSPB,100,200,20300,NearestNeighborAny2Regret_w1_1_start126,48767,NearestNeighborAny2Regret_w1_1
28558,2,TSPB,100,200,19783,NearestNeighborAny2Regret_w1_1_start127,48341,NearestNeighborAny2Regret_w1_1
26433,3,TSPB,100,200,20446,NearestNeighborAny2Regret_w1_1_start128,46879,NearestNeighborAny2Regret_w1_1
25424,3,TSPB,100,200,20022,NearestNeighborAny2Regret_w1_1_start129,45446,NearestNeighborAny2Regret_w1_1
26954,2,TSPB,100,200,21880,NearestNeighborAny2Regret_w1_1_start130,48834,NearestNeighborAny2Regret_w1_1
28558,3,TSPB,100,200,19783,NearestNeighborAny2Regret_w1_1_start131,48341,NearestNeighborAny2Regret_w1_1
28393,3,TSPB,100,200,20423,NearestNeighborAny2Regret_w1_1_start132,48816,NearestNeighborAny2Regret_w1_1
28001,2,TSPB,100,200,20784,NearestNeighborAny2Regret_w1_1_start133,48785,NearestNeighborAny2Regret_w1_1
27041,3,TSPB,100,200,19245,NearestNeighborAny2Regret_w1_1_start134,46286,NearestNeighborAny2Regret_w1_1
28517,3,TSPB,100,200,19675,NearestNeighborAny2Regret_w1_1_start135,48192,NearestNeighborAny2Regret_w1_1
26493,2,TSPB,100,200,20426,NearestNeighborAny2Regret_w1_1_start136,46919,NearestNeighborAny2Regret_w1_1
31267,3,TSPB,100,200,23776,NearestNeighborAny2Regret_w1_1_start137,55043,NearestNeighborAny2Regret_w1_1
30753,3,TSPB,100,200,20184,NearestNeighborAny2Regret_w1_1_start138,50937,NearestNeighborAny2Regret_w1_1
30026,3,TSPB,100,200,19545,NearestNeighborAny2Regret_w1_1_start139,49571,NearestNeighborAny2Regret_w1_1
26863,2,TSPB,100,200,22026,NearestNeighborAny2Regret_w1_1_start140,48889,NearestNeighborAny2Regret_w1_1
24752,3,TSPB,100,200,20139,NearestNeighborAny2Regret_w1_1_start141,44891,NearestNeighborAny2Regret_w1_1
27545,3,TSPB,100,200,20608,NearestNeighborAny2Regret_w1_1_start142,48153,NearestNeighborAny2Regret_w1_1
28926,2,TSPB,100,200,19329,NearestNeighborAny2Regret_w1_1_start143,48255,NearestNeighborAny2Regret_w1_1
26981,3,TSPB,100,200,19314,NearestNeighborAny2Regret_w1_1_start144,46295,NearestNeighborAny2Regret_w1_1
28148,3,TSPB,100,200,20730,NearestNeighborAny2Regret_w1_1_start145,48878,NearestNeighborAny2Regret_w1_1
27159,2,TSPB,100,200,20429,NearestNeighborAny2Regret_w1_1_start146,47588,NearestNeighborAny2Regret_w1_1
26166,3,TSPB,100,200,20593,NearestNeighborAny2Regret_w1_1_start147,46759,NearestNeighborAny2Regret_w1_1
28558,2,TSPB,100,200,19783,NearestNeighborAny2Regret_w1_1_start148,48341,NearestNeighborAny2Regret_w1_1
26863,3,TSPB,100,200,22026,NearestNeighborAny2Regret_w1_1_start149,48889,NearestNeighborAny2Regret_w1_1
27033,3,TSPB,100,200,20191,NearestNeighborAny2Regret_w1_1_start150,47224,NearestNeighborAny2Regret_w1_1
25525,3,TSPB,100,200,19877,NearestNeighborAny2Regret_w1_1_start151,45402,NearestNeighborAny2Regret_w1_1
27041,2,TSPB,100,200,19245,NearestNeighborAny2Regret_w1_1_start152,46286,NearestNeighborAny2Regret_w1_1
24752,3,TSPB,100,200,20139,NearestNeighborAny2Regret_w1_1_start153,44891,NearestNeighborAny2Regret_w1_1
26892,3,TSPB,100,200,20197,NearestNeighborAny2Regret_w1_1_start154,47089,NearestNeighborAny2Regret_w1_1
26166,2,TSPB,100,200,20593,NearestNeighborAny2Regret_w1_1_start155,46759,NearestNeighborAny2Regret_w1_1
24827,3,TSPB,100,200,20393,NearestNeighborAny2Regret_w1_1_start156,45220,NearestNeighborAny2Regret_w1_1
27146,3,TSPB,100,200,19583,NearestNeighborAny2Regret_w1_1_start157,46729,NearestNeighborAny2Regret_w1_1
28558,2,TSPB,100,200,19783,NearestNeighborAny2Regret_w1_1_start158,48341,NearestNeighborAny2Regret_w1_1
27960,3,TSPB,100,200,20523,NearestNeighborAny2Regret_w1_1_start159,48483,NearestNeighborAny2Regret_w1_1
30753,3,TSPB,100,200,20184,NearestNeighborAny2Regret_w1_1_start160,50937,NearestNeighborAny2Regret_w1_1
26793,2,TSPB,100,200,19261,NearestNeighborAny2Regret_w1_1_start161,46054,NearestNeighborAny2Regret_w1_1
27545,3,TSPB,100,200,20608,NearestNeighborAny2Regret_w1_1_start162,48153,NearestNeighborAny2Regret_w1_1
24752,3,TSPB,100,200,20139,NearestNeighborAny2Regret_w1_1_start163,44891,NearestNeighborAny2Regret_w1_1
26386,3,TSPB,100,200,20430,NearestNeighborAny2Regret_w1_1_start164,46816,NearestNeighborAny2Regret_w1_1
24840,2,TSPB,100,200,20202,NearestNeighborAny2Regret_w1_1_start165,45042,NearestNeighborAny2Regret_w1_1
28558,3,TSPB,100,200,19783,NearestNeighborAny2Regret_w1_1_start166,48341,NearestNeighborAny2Regret_w1_1
27672,3,TSPB,100,200,19714,NearestNeighborAny2Regret_w1_1_start167,47386,NearestNeighborAny2Regret_w1_1
28393,2,TSPB,100,200,20423,NearestNeighborAny2Regret_w1_1_start168,48816,NearestNeighborAny2Regret_w1_1
28393,3,TSPB,100,200,20423,NearestNeighborAny2Regret_w1_1_start169,48816,NearestNeighborAny2Regret_w1_1
26685,3,TSPB,100,200,20142,NearestNeighborAny2Regret_w1_1_start170,46827,NearestNeighborAny2Regret_w1_1
28295,2,TSPB,100,200,20182,NearestNeighborAny2Regret_w1_1_start171,48477,NearestNeighborAny2Regret_w1_1
24752,3,TSPB,100,200,20139,NearestNeighborAny2Regret_w1_1_start172,44891,NearestNeighborAny2Regret_w1_1
25038,3,TSPB,100,200,20397,NearestNeighborAny2Regret_w1_1_start173,45435,NearestNeighborAny2Regret_w1_1
27124,2,TSPB,100,200,22017,NearestNeighborAny2Regret_w1_1_start174,49141,NearestNeighborAny2Regret_w1_1
27545,3,TSPB,100,200,20608,NearestNeighborAny2Regret_w1_1_start175,48153,NearestNeighborAny2Regret_w1_1
28558,3,TSPB,100,200,19783,NearestNeighborAny2Regret_w1_1_start176,48341,NearestNeighborAny2Regret_w1_1
27545,3,TSPB,100,200,20608,NearestNeighborAny2Regret_w1_1_start177,48153,NearestNeighborAny2Regret_w1_1
25750,2,TSPB,100,200,19812,NearestNeighborAny2Regret_w1_1_start178,45562,NearestNeighborAny2Regret_w1_1
24752,3,TSPB,100,200,20139,NearestNeighborAny2Regret_w1_1_start179,44891,NearestNeighborAny2Regret_w1_1
28489,3,TSPB,100,200,19770,NearestNeighborAny2Regret_w1_1_start180,48259,NearestNeighborAny2Regret_w1_1
29323,2,TSPB,100,200,19834,NearestNeighborAny2Regret_w1_1_start181,49157,NearestNeighborAny2Regret_w1_1
30766,3,TSPB,100,200,19832,NearestNeighborAny2Regret_w1_1_start182,50598,NearestNeighborAny2Regret_w1_1
26863,3,TSPB,100,200,22026,NearestNeighborAny2Regret_w1_1_start183,48889,NearestNeighborAny2Regret_w1_1
25992,2,TSPB,100,200,20528,NearestNeighborAny2Regret_w1_1_start184,46520,NearestNeighborAny2Regret_w1_1
28558,3,TSPB,100,200,19783,NearestNeighborAny2Regret_w1_1_start185,48341,NearestNeighborAny2Regret_w1_1
25488,3,TSPB,100,200,19775,NearestNeighborAny2Regret_w1_1_start186,45263,NearestNeighborAny2Regret_w1_1
26659,2,TSPB,100,200,20504,NearestNeighborAny2Regret_w1_1_start187,47163,NearestNeighborAny2Regret_w1_1
28393,3,TSPB,100,200,20423,NearestNeighborAny2Regret_w1_1_start188,48816,NearestNeighborAny2Regret_w1_1
26967,3,TSPB,100,200,21036,NearestNeighborAny2Regret_w1_1_start189,48003,NearestNeighborAny2Regret_w1_1
26166,2,TSPB,100,200,20593,NearestNeighborAny2Regret_w1_1_start190,46759,NearestNeighborAny2Regret_w1_1
28337,3,TSPB,100,200,19132,NearestNeighborAny2Regret_w1_1_start191,47469,NearestNeighborAny2Regret_w1_1
27021,2,TSPB,100,200,20176,NearestNeighborAny2Regret_w1_1_start192,47197,NearestNeighborAny2Regret_w1_1
25416,3,TSPB,100,200,20477,NearestNeighborAny2Regret_w1_1_start193,45893,NearestNeighborAny2Regret_w1_1
28558,3,TSPB,100,200,19783,NearestNeighborAny2Regret_w1_1_start194,48341,NearestNeighborAny2Regret_w1_1
28393,2,TSPB,100,200,20423,NearestNeighborAny2Regret_w1_1_start195,48816,NearestNeighborAny2Regret_w1_1
27103,3,TSPB,100,200,20630,NearestNeighborAny2Regret_w1_1_start196,47733,NearestNeighborAny2Regret_w1_1
25170,3,TSPB,100,200,20128,NearestNeighborAny2Regret_w1_1_start197,45298,NearestNeighborAny2Regret_w1_1
25416,2,TSPB,100,200,20532,NearestNeighborAny2Regret_w1_1_start198,45948,NearestNeighborAny2Regret_w1_1
26994,3,TSPB,100,200,22019,NearestNeighborAny2Regret_w1_1_start199,49013,NearestNeighborAny2Regret_w1_1
48356,5,TSPB,100,200,22231,GreedyCycle2Regret_w0_1_start0,70587,GreedyCycle2Regret_w0_1
49090,4,TSPB,100,200,21509,GreedyCycle2Regret_w0_1_start1,70599,GreedyCycle2Regret_w0_1
49090,4,TSPB,100,200,21509,GreedyCycle2Regret_w0_1_start2,70599,GreedyCycle2Regret_w0_1
49549,4,TSPB,100,200,21455,GreedyCycle2Regret_w0_1_start3,71004,GreedyCycle2Regret_w0_1
48304,4,TSPB,100,200,20284,GreedyCycle2Regret_w0_1_start4,68588,GreedyCycle2Regret_w0_1
50153,4,TSPB,100,200,21158,GreedyCycle2Regret_w0_1_start5,71311,GreedyCycle2Regret_w0_1
46801,4,TSPB,100,200,20760,GreedyCycle2Regret_w0_1_start6,67561,GreedyCycle2Regret_w0_1
48969,4,TSPB,100,200,20668,GreedyCycle2Regret_w0_1_start7,69637,GreedyCycle2Regret_w0_1
49368,5,TSPB,100,200,20073,GreedyCycle2Regret_w0_1_start8,69441,GreedyCycle2Regret_w0_1
48945,4,TSPB,100,200,22854,GreedyCycle2Regret_w0_1_start9,71799,GreedyCycle2Regret_w0_1
49654,4,TSPB,100,200,21709,GreedyCycle2Regret_w0_1_start10,71363,GreedyCycle2Regret_w0_1
48621,4,TSPB,100,200,23271,GreedyCycle2Regret_w0_1_start11,71892,GreedyCycle2Regret_w0_1
47417,4,TSPB,100,200,21475,GreedyCycle2Regret_w0_1_start12,68892,GreedyCycle2Regret_w0_1
47980,4,TSPB,100,200,21362,GreedyCycle2Regret_w0_1_start13,69342,GreedyCycle2Regret_w0_1
48663,4,TSPB,100,200,19656,GreedyCycle2Regret_w0_1_start14,68319,GreedyCycle2Regret_w0_1
49046,4,TSPB,100,200,20903,GreedyCycle2Regret_w0_1_start15,69949,GreedyCycle2Regret_w0_1
49931,4,TSPB,100,200,21927,GreedyCycle2Regret_w0_1_start16,71858,GreedyCycle2Regret_w0_1
50115,4,TSPB,100,200,22296,GreedyCycle2Regret_w0_1_start17,72411,GreedyCycle2Regret_w0_1
50414,5,TSPB,100,200,24275,GreedyCycle2Regret_w0_1_start18,74689,GreedyCycle2Regret_w0_1
48348,4,TSPB,100,200,20496,GreedyCycle2Regret_w0_1_start19,68844,GreedyCycle2Regret_w0_1
48011,4,TSPB,100,200,21550,GreedyCycle2Regret_w0_1_start20,69561,GreedyCycle2Regret_w0_1
51147,4,TSPB,100,200,21385,GreedyCycle2Regret_w0_1_start21,72532,GreedyCycle2Regret_w0_1
47601,4,TSPB,100,200,21265,GreedyCycle2Regret_w0_1_start22,68866,GreedyCycle2Regret_w0_1
49076,4,TSPB,100,200,21935,GreedyCycle2Regret_w0_1_start23,71011,GreedyCycle2Regret_w0_1
51945,4,TSPB,100,200,21930,GreedyCycle2Regret_w0_1_start24,73875,GreedyCycle2Regret_w0_1
50318,4,TSPB,100,200,21543,GreedyCycle2Regret_w0_1_start25,71861,GreedyCycle2Regret_w0_1
48101,4,TSPB,100,200,19132,GreedyCycle2Regret_w0_1_start26,67233,GreedyCycle2Regret_w0_1
48845,4,TSPB,100,200,22620,GreedyCycle2Regret_w0_1_start27,71465,GreedyCycle2Regret_w0_1
47869,4,TSPB,100,200,21504,GreedyCycle2Regret_w0_1_start28,69373,GreedyCycle2Regret_w0_1
47813,3,TSPB,100,200,22953,GreedyCycle2Regret_w0_1_start29,70766,GreedyCycle2Regret_w0_1
52059,5,TSPB,100,200,22448,GreedyCycle2Regret_w0_1_start30,74507,GreedyCycle2Regret_w0_1
50144,4,TSPB,100,200,21084,GreedyCycle2Regret_w0_1_start31,71228,GreedyCycle2Regret_w0_1
50172,4,TSPB,100,200,22359,GreedyCycle2Regret_w0_1_start32,72531,GreedyCycle2Regret_w0_1
46977,4,TSPB,100,200,21124,GreedyCycle2Regret_w0_1_start33,68101,GreedyCycle2Regret_w0_1
48676,4,TSPB,100,200,21158,GreedyCycle2Regret_w0_1_start34,69834,GreedyCycle2Regret_w0_1
45175,4,TSPB,100,200,21165,GreedyCycle2Regret_w0_1_start35,66340,GreedyCycle2Regret_w0_1
49173,4,TSPB,100,200,20944,GreedyCycle2Regret_w0_1_start36,70117,GreedyCycle2Regret_w0_1
49343,4,TSPB,100,200,20897,GreedyCycle2Regret_w0_1_start37,70240,GreedyCycle2Regret_w0_1
50309,4,TSPB,100,200,22173,GreedyCycle2Regret_w0_1_start38,72482,GreedyCycle2Regret_w0_1
47892,4,TSPB,100,200,22801,GreedyCycle2Regret_w0_1_start39,70693,GreedyCycle2Regret_w0_1
49457,5,TSPB,100,200,22221,GreedyCycle2Regret_w0_1_start40,71678,GreedyCycle2Regret_w0_1
48303,5,TSPB,100,200,20001,GreedyCycle2Regret_w0_1_start41,68304,GreedyCycle2Regret_w0_1
48286,5,TSPB,100,200,22226,GreedyCycle2Regret_w0_1_start42,70512,GreedyCycle2Regret_w0_1
48788,3,TSPB,100,200,22084,GreedyCycle2Regret_w0_1_start43,70872,GreedyCycle2Regret_w0_1
51808,5,TSPB,100,200,22191,GreedyCycle2Regret_w0_1_start44,73999,GreedyCycle2Regret_w0_1
52490,4,TSPB,100,200,21102,GreedyCycle2Regret_w0_1_start45,73592,GreedyCycle2Regret_w0_1
49594,4,TSPB,100,200,21382,GreedyCycle2Regret_w0_1_start46,70976,GreedyCycle2Regret_w0_1
51321,4,TSPB,100,200,21631,GreedyCycle2Regret_w0_1_start47,72952,GreedyCycle2Regret_w0_1
47947,4,TSPB,100,200,18608,GreedyCycle2Regret_w0_1_start48,66555,GreedyCycle2Regret_w0_1
49268,4,TSPB,100,200,23198,GreedyCycle2Regret_w0_1_start49,72466,GreedyCycle2Regret_w0_1
49513,4,TSPB,100,200,19901,GreedyCycle2Regret_w0_1_start50,69414,GreedyCycle2Regret_w0_1
50979,4,TSPB,100,200,20568,GreedyCycle2Regret_w0_1_start51,71547,GreedyCycle2Regret_w0_1
50857,5,TSPB,100,200,19746,GreedyCycle2Regret_w0_1_start52,70603,GreedyCycle2Regret_w0_1
50452,4,TSPB,100,200,20315,GreedyCycle2Regret_w0_1_start53,70767,GreedyCycle2Regret_w0_1
50649,4,TSPB,100,200,21892,GreedyCycle2Regret_w0_1_start54,72541,GreedyCycle2Regret_w0_1
48736,4,TSPB,100,200,22036,GreedyCycle2Regret_w0_1_start55,70772,GreedyCycle2Regret_w0_1
49261,4,TSPB,100,200,20445,GreedyCycle2Regret_w0_1_start56,69706,GreedyCycle2Regret_w0_1
48955,4,TSPB,100,200,18830,GreedyCycle2Regret_w0_1_start57,67785,GreedyCycle2Regret_w0_1
49464,4,TSPB,100,200,20278,GreedyCycle2Regret_w0_1_start58,69742,GreedyCycle2Regret_w0_1
47279,4,TSPB,100,200,21528,GreedyCycle2Regret_w0_1_start59,68807,GreedyCycle2Regret_w0_1
48911,4,TSPB,100,200,21872,GreedyCycle2Regret_w0_1_start60,70783,GreedyCycle2Regret_w0_1
47002,4,TSPB,100,200,20546,GreedyCycle2Regret_w0_1_start61,67548,GreedyCycle2Regret_w0_1
50160,4,TSPB,100,200,21197,GreedyCycle2Regret_w0_1_start62,71357,GreedyCycle2Regret_w0_1
49535,4,TSPB,100,200,21763,GreedyCycle2Regret_w0_1_start63,71298,GreedyCycle2Regret_w0_1
49273,4,TSPB,100,200,19952,GreedyCycle2Regret_w0_1_start64,69225,GreedyCycle2Regret_w0_1
50374,4,TSPB,100,200,20081,GreedyCycle2Regret_w0_1_start65,70455,GreedyCycle2Regret_w0_1
53063,4,TSPB,100,200,21950,GreedyCycle2Regret_w0_1_start66,75013,GreedyCycle2Regret_w0_1
50741,5,TSPB,100,200,21051,GreedyCycle2Regret_w0_1_start67,71792,GreedyCycle2Regret_w0_1
50768,5,TSPB,100,200,20364,GreedyCycle2Regret_w0_1_start68,71132,GreedyCycle2Regret_w0_1
48475,4,TSPB,100,200,21519,GreedyCycle2Regret_w0_1_start69,69994,GreedyCycle2Regret_w0_1
48858,4,TSPB,100,200,20623,GreedyCycle2Regret_w0_1_start70,69481,GreedyCycle2Regret_w0_1
50573,4,TSPB,100,200,21383,GreedyCycle2Regret_w0_1_start71,71956,GreedyCycle2Regret_w0_1
50114,4,TSPB,100,200,22408,GreedyCycle2Regret_w0_1_start72,72522,GreedyCycle2Regret_w0_1
50222,4,TSPB,100,200,21561,GreedyCycle2Regret_w0_1_start73,71783,GreedyCycle2Regret_w0_1
47862,4,TSPB,100,200,21747,GreedyCycle2Regret_w0_1_start74,69609,GreedyCycle2Regret_w0_1
48775,4,TSPB,100,200,19188,GreedyCycle2Regret_w0_1_start75,67963,GreedyCycle2Regret_w0_1
49114,4,TSPB,100,200,19064,GreedyCycle2Regret_w0_1_start76,68178,GreedyCycle2Regret_w0_1
50099,4,TSPB,100,200,19977,GreedyCycle2Regret_w0_1_start77,70076,GreedyCycle2Regret_w0_1
50506,4,TSPB,100,200,21679,GreedyCycle2Regret_w0_1_start78,72185,GreedyCycle2Regret_w0_1
47473,4,TSPB,100,200,20540,GreedyCycle2Regret_w0_1_start79,68013,GreedyCycle2Regret_w0_1
49421,4,TSPB,100,200,22133,GreedyCycle2Regret_w0_1_start80,71554,GreedyCycle2Regret_w0_1
48814,4,TSPB,100,200,19777,GreedyCycle2Regret_w0_1_start81,68591,GreedyCycle2Regret_w0_1
49402,4,TSPB,100,200,20250,GreedyCycle2Regret_w0_1_start82,69652,GreedyCycle2Regret_w0_1
50744,3,TSPB,100,200,24733,GreedyCycle2Regret_w0_1_start83,75477,GreedyCycle2Regret_w0_1
49913,4,TSPB,100,200,21133,GreedyCycle2Regret_w0_1_start84,71046,GreedyCycle2Regret_w0_1
48516,4,TSPB,100,200,20835,GreedyCycle2Regret_w0_1_start85,69351,GreedyCycle2Regret_w0_1
47889,4,TSPB,100,200,20794,GreedyCycle2Regret_w0_1_start86,68683,GreedyCycle2Regret_w0_1
46585,4,TSPB,100,200,20106,GreedyCycle2Regret_w0_1_start87,66691,GreedyCycle2Regret_w0_1
45977,4,TSPB,100,200,19066,GreedyCycle2Regret_w0_1_start88,65043,GreedyCycle2Regret_w0_1
47388,4,TSPB,100,200,19125,GreedyCycle2Regret_w0_1_start89,66513,GreedyCycle2Regret_w0_1
49581,4,TSPB,100,200,21392,GreedyCycle2Regret_w0_1_start90,70973,GreedyCycle2Regret_w0_1
49315,4,TSPB,100,200,21168,GreedyCycle2Regret_w0_1_start91,70483,GreedyCycle2Regret_w0_1
50070,4,TSPB,100,200,21960,GreedyCycle2Regret_w0_1_start92,72030,GreedyCycle2Regret_w0_1
49021,4,TSPB,100,200,18862,GreedyCycle2Regret_w0_1_start93,67883,GreedyCycle2Regret_w0_1
51416,4,TSPB,100,200,22236,GreedyCycle2Regret_w0_1_start94,73652,GreedyCycle2Regret_w0_1
48511,4,TSPB,100,200,20739,GreedyCycle2Regret_w0_1_start95,69250,GreedyCycle2Regret_w0_1
50683,4,TSPB,100,200,22655,GreedyCycle2Regret_w0_1_start96,73338,GreedyCycle2Regret_w0_1
50622,4,TSPB,100,200,20138,GreedyCycle2Regret_w0_1_start97,70760,GreedyCycle2Regret_w0_1
49409,4,TSPB,100,200,21459,GreedyCycle2Regret_w0_1_start98,70868,GreedyCycle2Regret_w0_1
52863,4,TSPB,100,200,20212,GreedyCycle2Regret_w0_1_start99,73075,GreedyCycle2Regret_w0_1
49906,4,TSPB,100,200,22148,GreedyCycle2Regret_w0_1_start100,72054,GreedyCycle2Regret_w0_1
47704,5,TSPB,100,200,21513,GreedyCycle2Regret_w0_1_start101,69217,GreedyCycle2Regret_w0_1
50934,4,TSPB,100,200,22506,GreedyCycle2Regret_w0_1_start102,73440,GreedyCycle2Regret_w0_1
49005,4,TSPB,100,200,19306,GreedyCycle2Regret_w0_1_start103,68311,GreedyCycle2Regret_w0_1
47792,4,TSPB,100,200,19666,GreedyCycle2Regret_w0_1_start104,67458,GreedyCycle2Regret_w0_1
50435,5,TSPB,100,200,21998,GreedyCycle2Regret_w0_1_start105,72433,GreedyCycle2Regret_w0_1
48037,4,TSPB,100,200,20134,GreedyCycle2Regret_w0_1_start106,68171,GreedyCycle2Regret_w0_1
49740,4,TSPB,100,200,22657,GreedyCycle2Regret_w0_1_start107,72397,GreedyCycle2Regret_w0_1
48645,4,TSPB,100,200,22320,GreedyCycle2Regret_w0_1_start108,70965,GreedyCycle2Regret_w0_1
47793,4,TSPB,100,200,22351,GreedyCycle2Regret_w0_1_start109,70144,GreedyCycle2Regret_w0_1
49470,4,TSPB,100,200,20410,GreedyCycle2Regret_w0_1_start110,69880,GreedyCycle2Regret_w0_1
50635,4,TSPB,100,200,19967,GreedyCycle2Regret_w0_1_start111,70602,GreedyCycle2Regret_w0_1
46846,4,TSPB,100,200,20767,GreedyCycle2Regret_w0_1_start112,67613,GreedyCycle2Regret_w0_1
46276,4,TSPB,100,200,19246,GreedyCycle2Regret_w0_1_start113,65522,GreedyCycle2Regret_w0_1
49079,4,TSPB,100,200,18874,GreedyCycle2Regret_w0_1_start114,67953,GreedyCycle2Regret_w0_1
49732,4,TSPB,100,200,21632,GreedyCycle2Regret_w0_1_start115,71364,GreedyCycle2Regret_w0_1
50691,4,TSPB,100,200,21852,GreedyCycle2Regret_w0_1_start116,72543,GreedyCycle2Regret_w0_1
51112,4,TSPB,100,200,22457,GreedyCycle2Regret_w0_1_start117,73569,GreedyCycle2Regret_w0_1
47872,4,TSPB,100,200,20486,GreedyCycle2Regret_w0_1_start118,68358,GreedyCycle2Regret_w0_1
48006,4,TSPB,100,200,19319,GreedyCycle2Regret_w0_1_start119,67325,GreedyCycle2Regret_w0_1
50947,4,TSPB,100,200,21666,GreedyCycle2Regret_w0_1_start120,72613,GreedyCycle2Regret_w0_1
50613,4,TSPB,100,200,23068,GreedyCycle2Regret_w0_1_start121,73681,GreedyCycle2Regret_w0_1
50527,4,TSPB,100,200,21428,GreedyCycle2Regret_w0_1_start122,71955,GreedyCycle2Regret_w0_1
50644,4,TSPB,100,200,20638,GreedyCycle2Regret_w0_1_start123,71282,GreedyCycle2Regret_w0_1
50125,5,TSPB,100,200,20489,GreedyCycle2Regret_w0_1_start124,70614,GreedyCycle2Regret_w0_1
48052,5,TSPB,100,200,21824,GreedyCycle2Regret_w0_1_start125,69876,GreedyCycle2Regret_w0_1
49676,4,TSPB,100,200,20954,GreedyCycle2Regret_w0_1_start126,70630,GreedyCycle2Regret_w0_1
47924,4,TSPB,100,200,19111,GreedyCycle2Regret_w0_1_start127,67035,GreedyCycle2Regret_w0_1
49490,5,TSPB,100,200,20372,GreedyCycle2Regret_w0_1_start128,69862,GreedyCycle2Regret_w0_1
48144,3,TSPB,100,200,19112,GreedyCycle2Regret_w0_1_start129,67256,GreedyCycle2Regret_w0_1
51679,4,TSPB,100,200,22963,GreedyCycle2Regret_w0_1_start130,74642,GreedyCycle2Regret_w0_1
48740,5,TSPB,100,200,21703,GreedyCycle2Regret_w0_1_start131,70443,GreedyCycle2Regret_w0_1
49438,4,TSPB,100,200,21949,GreedyCycle2Regret_w0_1_start132,71387,GreedyCycle2Regret_w0_1
52130,4,TSPB,100,200,22289,GreedyCycle2Regret_w0_1_start133,74419,GreedyCycle2Regret_w0_1
49319,3,TSPB,100,200,20702,GreedyCycle2Regret_w0_1_start134,70021,GreedyCycle2Regret_w0_1
49467,4,TSPB,100,200,22372,GreedyCycle2Regret_w0_1_start135,71839,GreedyCycle2Regret_w0_1
49214,4,TSPB,100,200,21959,GreedyCycle2Regret_w0_1_start136,71173,GreedyCycle2Regret_w0_1
48435,4,TSPB,100,200,19357,GreedyCycle2Regret_w0_1_start137,67792,GreedyCycle2Regret_w0_1
48916,5,TSPB,100,200,22807,GreedyCycle2Regret_w0_1_start138,71723,GreedyCycle2Regret_w0_1
49937,4,TSPB,100,200,21887,GreedyCycle2Regret_w0_1_start139,71824,GreedyCycle2Regret_w0_1
47323,4,TSPB,100,200,21029,GreedyCycle2Regret_w0_1_start140,68352,GreedyCycle2Regret_w0_1
49907,4,TSPB,100,200,20285,GreedyCycle2Regret_w0_1_start141,70192,GreedyCycle2Regret_w0_1
52355,4,TSPB,100,200,21084,GreedyCycle2Regret_w0_1_start142,73439,GreedyCycle2Regret_w0_1
48956,4,TSPB,100,200,20081,GreedyCycle2Regret_w0_1_start143,69037,GreedyCycle2Regret_w0_1
48733,4,TSPB,100,200,20529,GreedyCycle2Regret_w0_1_start144,69262,GreedyCycle2Regret_w0_1
46907,3,TSPB,100,200,21154,GreedyCycle2Regret_w0_1_start145,68061,GreedyCycle2Regret_w0_1
47467,4,TSPB,100,200,19605,GreedyCycle2Regret_w0_1_start146,67072,GreedyCycle2Regret_w0_1
48612,5,TSPB,100,200,21733,GreedyCycle2Regret_w0_1_start147,70345,GreedyCycle2Regret_w0_1
49380,4,TSPB,100,200,23006,GreedyCycle2Regret_w0_1_start148,72386,GreedyCycle2Regret_w0_1
47783,4,TSPB,100,200,20466,GreedyCycle2Regret_w0_1_start149,68249,GreedyCycle2Regret_w0_1
49551,4,TSPB,100,200,21059,GreedyCycle2Regret_w0_1_start150,70610,GreedyCycle2Regret_w0_1
50779,5,TSPB,100,200,21676,GreedyCycle2Regret_w0_1_start151,72455,GreedyCycle2Regret_w0_1
48108,4,TSPB,100,200,21223,GreedyCycle2Regret_w0_1_start152,69331,GreedyCycle2Regret_w0_1
47773,4,TSPB,100,200,19807,GreedyCycle2Regret_w0_1_start153,67580,GreedyCycle2Regret_w0_1
53800,4,TSPB,100,200,22525,GreedyCycle2Regret_w0_1_start154,76325,GreedyCycle2Regret_w0_1
48717,4,TSPB,100,200,20588,GreedyCycle2Regret_w0_1_start155,69305,GreedyCycle2Regret_w0_1
49280,4,TSPB,100,200,21688,GreedyCycle2Regret_w0_1_start156,70968,GreedyCycle2Regret_w0_1
48342,4,TSPB,100,200,20942,GreedyCycle2Regret_w0_1_start157,69284,GreedyCycle2Regret_w0_1
50107,4,TSPB,100,200,22222,GreedyCycle2Regret_w0_1_start158,72329,GreedyCycle2Regret_w0_1
46037,4,TSPB,100,200,20688,GreedyCycle2Regret_w0_1_start159,66725,GreedyCycle2Regret_w0_1
47560,4,TSPB,100,200,20755,GreedyCycle2Regret_w0_1_start160,68315,GreedyCycle2Regret_w0_1
50111,4,TSPB,100,200,21578,GreedyCycle2Regret_w0_1_start161,71689,GreedyCycle2Regret_w0_1
49258,5,TSPB,100,200,21344,GreedyCycle2Regret_w0_1_start162,70602,GreedyCycle2Regret_w0_1
46803,4,TSPB,100,200,18961,GreedyCycle2Regret_w0_1_start163,65764,GreedyCycle2Regret_w0_1
52237,4,TSPB,100,200,21105,GreedyCycle2Regret_w0_1_start164,73342,GreedyCycle2Regret_w0_1
48280,4,TSPB,100,200,19395,GreedyCycle2Regret_w0_1_start165,67675,GreedyCycle2Regret_w0_1
47451,4,TSPB,100,200,19481,GreedyCycle2Regret_w0_1_start166,66932,GreedyCycle2Regret_w0_1
46911,3,TSPB,100,200,20527,GreedyCycle2Regret_w0_1_start167,67438,GreedyCycle2Regret_w0_1
46762,5,TSPB,100,200,20031,GreedyCycle2Regret_w0_1_start168,66793,GreedyCycle2Regret_w0_1
47797,4,TSPB,100,200,20614,GreedyCycle2Regret_w0_1_start169,68411,GreedyCycle2Regret_w0_1
48892,4,TSPB,100,200,21405,GreedyCycle2Regret_w0_1_start170,70297,GreedyCycle2Regret_w0_1
50315,4,TSPB,100,200,20311,GreedyCycle2Regret_w0_1_start171,70626,GreedyCycle2Regret_w0_1
50740,4,TSPB,100,200,19865,GreedyCycle2Regret_w0_1_start172,70605,GreedyCycle2Regret_w0_1
49766,4,TSPB,100,200,22043,GreedyCycle2Regret_w0_1_start173,71809,GreedyCycle2Regret_w0_1
47987,4,TSPB,100,200,21522,GreedyCycle2Regret_w0_1_start174,69509,GreedyCycle2Regret_w0_1
50185,4,TSPB,100,200,21881,GreedyCycle2Regret_w0_1_start175,72066,GreedyCycle2Regret_w0_1
46927,4,TSPB,100,200,19056,GreedyCycle2Regret_w0_1_start176,65983,GreedyCycle2Regret_w0_1
47696,4,TSPB,100,200,20885,GreedyCycle2Regret_w0_1_start177,68581,GreedyCycle2Regret_w0_1
47496,5,TSPB,100,200,21540,GreedyCycle2Regret_w0_1_start178,69036,GreedyCycle2Regret_w0_1
48858,4,TSPB,100,200,19294,GreedyCycle2Regret_w0_1_start179,68152,GreedyCycle2Regret_w0_1
47254,4,TSPB,100,200,19160,GreedyCycle2Regret_w0_1_start180,66414,GreedyCycle2Regret_w0_1
54432,4,TSPB,100,200,19253,GreedyCycle2Regret_w0_1_start181,73685,GreedyCycle2Regret_w0_1
49390,4,TSPB,100,200,23213,GreedyCycle2Regret_w0_1_start182,72603,GreedyCycle2Regret_w0_1
47488,4,TSPB,100,200,21039,GreedyCycle2Regret_w0_1_start183,68527,GreedyCycle2Regret_w0_1
47920,5,TSPB,100,200,21250,GreedyCycle2Regret_w0_1_start184,69170,GreedyCycle2Regret_w0_1
49002,4,TSPB,100,200,21159,GreedyCycle2Regret_w0_1_start185,70161,GreedyCycle2Regret_w0_1
46819,4,TSPB,100,200,19769,GreedyCycle2Regret_w0_1_start186,66588,GreedyCycle2Regret_w0_1
48145,4,TSPB,100,200,19820,GreedyCycle2Regret_w0_1_start187,67965,GreedyCycle2Regret_w0_1
49664,4,TSPB,100,200,20032,GreedyCycle2Regret_w0_1_start188,69696,GreedyCycle2Regret_w0_1
48848,4,TSPB,100,200,20707,GreedyCycle2Regret_w0_1_start189,69555,GreedyCycle2Regret_w0_1
47573,4,TSPB,100,200,21961,GreedyCycle2Regret_w0_1_start190,69534,GreedyCycle2Regret_w0_1
50547,4,TSPB,100,200,21708,GreedyCycle2Regret_w0_1_start191,72255,GreedyCycle2Regret_w0_1
48259,4,TSPB,100,200,20822,GreedyCycle2Regret_w0_1_start192,69081,GreedyCycle2Regret_w0_1
49737,4,TSPB,100,200,21080,GreedyCycle2Regret_w0_1_start193,70817,GreedyCycle2Regret_w0_1
47330,4,TSPB,100,200,19225,GreedyCycle2Regret_w0_1_start194,66555,GreedyCycle2Regret_w0_1
48843,4,TSPB,100,200,20869,GreedyCycle2Regret_w0_1_start195,69712,GreedyCycle2Regret_w0_1
48807,4,TSPB,100,200,22364,GreedyCycle2Regret_w0_1_start196,71171,GreedyCycle2Regret_w0_1
50307,4,TSPB,100,200,22145,GreedyCycle2Regret_w0_1_start197,72452,GreedyCycle2Regret_w0_1
51485,4,TSPB,100,200,22152,GreedyCycle2Regret_w0_1_start198,73637,GreedyCycle2Regret_w0_1
47631,3,TSPB,100,200,21235,GreedyCycle2Regret_w0_1_start199,68866,GreedyCycle2Regret_w0_1
51867,3,TSPB,100,200,24151,NearestNeighborAny2Regret_w0_1_start0,76018,NearestNeighborAny2Regret_w0_1
51867,2,TSPB,100,200,24151,NearestNeighborAny2Regret_w0_1_start1,76018,NearestNeighborAny2Regret_w0_1
50020,3,TSPB,100,200,21373,NearestNeighborAny2Regret_w0_1_start2,71393,NearestNeighborAny2Regret_w0_1
49627,3,TSPB,100,200,23392,NearestNeighborAny2Regret_w0_1_start3,73019,NearestNeighborAny2Regret_w0_1
50313,3,TSPB,100,200,23900,NearestNeighborAny2Regret_w0_1_start4,74213,NearestNeighborAny2Regret_w0_1
48185,2,TSPB,100,200,24842,NearestNeighborAny2Regret_w0_1_start5,73027,NearestNeighborAny2Regret_w0_1
50409,3,TSPB,100,200,24097,NearestNeighborAny2Regret_w0_1_start6,74506,NearestNeighborAny2Regret_w0_1
47590,3,TSPB,100,200,23336,NearestNeighborAny2Regret_w0_1_start7,70926,NearestNeighborAny2Regret_w0_1
52103,3,TSPB,100,200,25114,NearestNeighborAny2Regret_w0_1_start8,77217,NearestNeighborAny2Regret_w0_1
50363,3,TSPB,100,200,23587,NearestNeighborAny2Regret_w0_1_start9,73950,NearestNeighborAny2Regret_w0_1
50636,3,TSPB,100,200,22719,NearestNeighborAny2Regret_w0_1_start10,73355,NearestNeighborAny2Regret_w0_1
48141,2,TSPB,100,200,25354,NearestNeighborAny2Regret_w0_1_start11,73495,NearestNeighborAny2Regret_w0_1
52568,3,TSPB,100,200,23813,NearestNeighborAny2Regret_w0_1_start12,76381,NearestNeighborAny2Regret_w0_1
50870,3,TSPB,100,200,23281,NearestNeighborAny2Regret_w0_1_start13,74151,NearestNeighborAny2Regret_w0_1
53132,2,TSPB,100,200,22945,NearestNeighborAny2Regret_w0_1_start14,76077,NearestNeighborAny2Regret_w0_1
50924,3,TSPB,100,200,23688,NearestNeighborAny2Regret_w0_1_start15,74612,NearestNeighborAny2Regret_w0_1
51994,3,TSPB,100,200,24143,NearestNeighborAny2Regret_w0_1_start16,76137,NearestNeighborAny2Regret_w0_1
51720,3,TSPB,100,200,22489,NearestNeighborAny2Regret_w0_1_start17,74209,NearestNeighborAny2Regret_w0_1
48502,2,TSPB,100,200,23074,NearestNeighborAny2Regret_w0_1_start18,71576,NearestNeighborAny2Regret_w0_1
52301,3,TSPB,100,200,23442,NearestNeighborAny2Regret_w0_1_start19,75743,NearestNeighborAny2Regret_w0_1
50315,3,TSPB,100,200,23464,NearestNeighborAny2Regret_w0_1_start20,73779,NearestNeighborAny2Regret_w0_1
50947,2,TSPB,100,200,25501,NearestNeighborAny2Regret_w0_1_start21,76448,NearestNeighborAny2Regret_w0_1
48744,3,TSPB,100,200,23790,NearestNeighborAny2Regret_w0_1_start22,72534,NearestNeighborAny2Regret_w0_1
52833,3,TSPB,100,200,23847,NearestNeighborAny2Regret_w0_1_start23,76680,NearestNeighborAny2Regret_w0_1
52694,3,TSPB,100,200,23124,NearestNeighborAny2Regret_w0_1_start24,75818,NearestNeighborAny2Regret_w0_1
54469,3,TSPB,100,200,24561,NearestNeighborAny2Regret_w0_1_start25,79030,NearestNeighborAny2Regret_w0_1
50144,3,TSPB,100,200,25279,NearestNeighborAny2Regret_w0_1_start26,75423,NearestNeighborAny2Regret_w0_1
53287,2,TSPB,100,200,24143,NearestNeighborAny2Regret_w0_1_start27,77430,NearestNeighborAny2Regret_w0_1
47279,3,TSPB,100,200,23158,NearestNeighborAny2Regret_w0_1_start28,70437,NearestNeighborAny2Regret_w0_1
48604,3,TSPB,100,200,24030,NearestNeighborAny2Regret_w0_1_start29,72634,NearestNeighborAny2Regret_w0_1
52943,2,TSPB,100,200,23185,NearestNeighborAny2Regret_w0_1_start30,76128,NearestNeighborAny2Regret_w0_1
52325,3,TSPB,100,200,22303,NearestNeighborAny2Regret_w0_1_start31,74628,NearestNeighborAny2Regret_w0_1
51768,3,TSPB,100,200,22217,NearestNeighborAny2Regret_w0_1_start32,73985,NearestNeighborAny2Regret_w0_1
45668,2,TSPB,100,200,24265,NearestNeighborAny2Regret_w0_1_start33,69933,NearestNeighborAny2Regret_w0_1
50315,3,TSPB,100,200,23464,NearestNeighborAny2Regret_w0_1_start34,73779,NearestNeighborAny2Regret_w0_1
49657,2,TSPB,100,200,23779,NearestNeighborAny2Regret_w0_1_start35,73436,NearestNeighborAny2Regret_w0_1
46726,3,TSPB,100,200,24635,NearestNeighborAny2Regret_w0_1_start36,71361,NearestNeighborAny2Regret_w0_1
50066,3,TSPB,100,200,24156,NearestNeighborAny2Regret_w0_1_start37,74222,NearestNeighborAny2Regret_w0_1
50456,2,TSPB,100,200,21510,NearestNeighborAny2Regret_w0_1_start38,71966,NearestNeighborAny2Regret_w0_1
51044,3,TSPB,100,200,23594,NearestNeighborAny2Regret_w0_1_start39,74638,NearestNeighborAny2Regret_w0_1
49825,3,TSPB,100,200,21323,NearestNeighborAny2Regret_w0_1_start40,71148,NearestNeighborAny2Regret_w0_1
49383,2,TSPB,100,200,23416,NearestNeighborAny2Regret_w0_1_start41,72799,NearestNeighborAny2Regret_w0_1
52640,3,TSPB,100,200,23663,NearestNeighborAny2Regret_w0_1_start42,76303,NearestNeighborAny2Regret_w0_1
53269,2,TSPB,100,200,23427,NearestNeighborAny2Regret_w0_1_start43,76696,NearestNeighborAny2Regret_w0_1
53001,3,TSPB,100,200,22144,NearestNeighborAny2Regret_w0_1_start44,75145,NearestNeighborAny2Regret_w0_1
49987,3,TSPB,100,200,24770,NearestNeighborAny2Regret_w0_1_start45,74757,NearestNeighborAny2Regret_w0_1
53375,3,TSPB,100,200,22704,NearestNeighborAny2Regret_w0_1_start46,76079,NearestNeighborAny2Regret_w0_1
53125,2,TSPB,100,200,24207,NearestNeighborAny2Regret_w0_1_start47,77332,NearestNeighborAny2Regret_w0_1
50107,3,TSPB,100,200,23577,NearestNeighborAny2Regret_w0_1_start48,73684,NearestNeighborAny2Regret_w0_1
50889,3,TSPB,100,200,24218,NearestNeighborAny2Regret_w0_1_start49,75107,NearestNeighborAny2Regret_w0_1
49656,3,TSPB,100,200,24830,NearestNeighborAny2Regret_w0_1_start50,74486,NearestNeighborAny2Regret_w0_1
48454,3,TSPB,100,200,24269,NearestNeighborAny2Regret_w0_1_start51,72723,NearestNeighborAny2Regret_w0_1
51106,3,TSPB,100,200,24556,NearestNeighborAny2Regret_w0_1_start52,75662,NearestNeighborAny2Regret_w0_1
52560,3,TSPB,100,200,24086,NearestNeighborAny2Regret_w0_1_start53,76646,NearestNeighborAny2Regret_w0_1
51227,2,TSPB,100,200,23029,NearestNeighborAny2Regret_w0_1_start54,74256,NearestNeighborAny2Regret_w0_1
50192,3,TSPB,100,200,26606,NearestNeighborAny2Regret_w0_1_start55,76798,NearestNeighborAny2Regret_w0_1
48936,3,TSPB,100,200,24254,NearestNeighborAny2Regret_w0_1_start56,73190,NearestNeighborAny2Regret_w0_1
50135,3,TSPB,100,200,22436,NearestNeighborAny2Regret_w0_1_start57,72571,NearestNeighborAny2Regret_w0_1
52389,3,TSPB,100,200,24807,NearestNeighborAny2Regret_w0_1_start58,77196,NearestNeighborAny2Regret_w0_1
50889,2,TSPB,100,200,22939,NearestNeighborAny2Regret_w0_1_start59,73828,NearestNeighborAny2Regret_w0_1
56132,3,TSPB,100,200,24081,NearestNeighborAny2Regret_w0_1_start60,80213,NearestNeighborAny2Regret_w0_1
46613,3,TSPB,100,200,24542,NearestNeighborAny2Regret_w0_1_start61,71155,NearestNeighborAny2Regret_w0_1
50221,3,TSPB,100,200,24501,NearestNeighborAny2Regret_w0_1_start62,74722,NearestNeighborAny2Regret_w0_1
50744,3,TSPB,100,200,21585,NearestNeighborAny2Regret_w0_1_start63,72329,NearestNeighborAny2Regret_w0_1
52437,2,TSPB,100,200,23938,NearestNeighborAny2Regret_w0_1_start64,76375,NearestNeighborAny2Regret_w0_1
51007,3,TSPB,100,200,24034,NearestNeighborAny2Regret_w0_1_start65,75041,NearestNeighborAny2Regret_w0_1
52474,3,TSPB,100,200,23975,NearestNeighborAny2Regret_w0_1_start66,76449,NearestNeighborAny2Regret_w0_1
51765,2,TSPB,100,200,23737,NearestNeighborAny2Regret_w0_1_start67,75502,NearestNeighborAny2Regret_w0_1
49636,3,TSPB,100,200,23538,NearestNeighborAny2Regret_w0_1_start68,73174,NearestNeighborAny2Regret_w0_1
49179,3,TSPB,100,200,23849,NearestNeighborAny2Regret_w0_1_start69,73028,NearestNeighborAny2Regret_w0_1
52894,3,TSPB,100,200,23190,NearestNeighborAny2Regret_w0_1_start70,76084,NearestNeighborAny2Regret_w0_1
50622,3,TSPB,100,200,22429,NearestNeighborAny2Regret_w0_1_start71,73051,NearestNeighborAny2Regret_w0_1
51322,3,TSPB,100,200,22309,NearestNeighborAny2Regret_w0_1_start72,73631,NearestNeighborAny2Regret_w0_1
51294,2,TSPB,100,200,21189,NearestNeighborAny2Regret_w0_1_start73,72483,NearestNeighborAny2Regret_w0_1
50215,3,TSPB,100,200,22245,NearestNeighborAny2Regret_w0_1_start74,72460,NearestNeighborAny2Regret_w0_1
52986,3,TSPB,100,200,24639,NearestNeighborAny2Regret_w0_1_start75,77625,NearestNeighborAny2Regret_w0_1
50493,2,TSPB,100,200,23546,NearestNeighborAny2Regret_w0_1_start76,74039,NearestNeighborAny2Regret_w0_1
48438,3,TSPB,100,200,24459,NearestNeighborAny2Regret_w0_1_start77,72897,NearestNeighborAny2Regret_w0_1
47828,6,TSPB,100,200,24262,NearestNeighborAny2Regret_w0_1_start78,72090,NearestNeighborAny2Regret_w0_1
47356,3,TSPB,100,200,24460,NearestNeighborAny2Regret_w0_1_start79,71816,NearestNeighborAny2Regret_w0_1
51342,2,TSPB,100,200,23173,NearestNeighborAny2Regret_w0_1_start80,74515,NearestNeighborAny2Regret_w0_1
49678,3,TSPB,100,200,24859,NearestNeighborAny2Regret_w0_1_start81,74537,NearestNeighborAny2Regret_w0_1
49219,3,TSPB,100,200,24372,NearestNeighborAny2Regret_w0_1_start82,73591,NearestNeighborAny2Regret_w0_1
51155,3,TSPB,100,200,23773,NearestNeighborAny2Regret_w0_1_start83,74928,NearestNeighborAny2Regret_w0_1
51816,2,TSPB,100,200,24683,NearestNeighborAny2Regret_w0_1_start84,76499,NearestNeighborAny2Regret_w0_1
50029,3,TSPB,100,200,21472,NearestNeighborAny2Regret_w0_1_start85,71501,NearestNeighborAny2Regret_w0_1
53612,3,TSPB,100,200,23864,NearestNeighborAny2Regret_w0_1_start86,77476,NearestNeighborAny2Regret_w0_1
51987,3,TSPB,100,200,22451,NearestNeighborAny2Regret_w0_1_start87,74438,NearestNeighborAny2Regret_w0_1
53954,3,TSPB,100,200,24047,NearestNeighborAny2Regret_w0_1_start88,78001,NearestNeighborAny2Regret_w0_1
49311,2,TSPB,100,200,24861,NearestNeighborAny2Regret_w0_1_start89,74172,NearestNeighborAny2Regret_w0_1
50035,3,TSPB,100,200,23614,NearestNeighborAny2Regret_w0_1_start90,73649,NearestNeighborAny2Regret_w0_1
50009,3,TSPB,100,200,23165,NearestNeighborAny2Regret_w0_1_start91,73174,NearestNeighborAny2Regret_w0_1
52331,3,TSPB,100,200,21323,NearestNeighborAny2Regret_w0_1_start92,73654,NearestNeighborAny2Regret_w0_1
51720,3,TSPB,100,200,22489,NearestNeighborAny2Regret_w0_1_start93,74209,NearestNeighborAny2Regret_w0_1
53566,3,TSPB,100,200,23768,NearestNeighborAny2Regret_w0_1_start94,77334,NearestNeighborAny2Regret_w0_1
48077,2,TSPB,100,200,22975,NearestNeighborAny2Regret_w0_1_start95,71052,NearestNeighborAny2Regret_w0_1
52836,3,TSPB,100,200,23244,NearestNeighborAny2Regret_w0_1_start96,76080,NearestNeighborAny2Regret_w0_1
49804,3,TSPB,100,200,24530,NearestNeighborAny2Regret_w0_1_start97,74334,NearestNeighborAny2Regret_w0_1
51211,2,TSPB,100,200,25136,NearestNeighborAny2Regret_w0_1_start98,76347,NearestNeighborAny2Regret_w0_1
50804,3,TSPB,100,200,25028,NearestNeighborAny2Regret_w0_1_start99,75832,NearestNeighborAny2Regret_w0_1
50290,3,TSPB,100,200,21190,NearestNeighborAny2Regret_w0_1_start100,71480,NearestNeighborAny2Regret_w0_1
47956,3,TSPB,100,200,23162,NearestNeighborAny2Regret_w0_1_start101,71118,NearestNeighborAny2Regret_w0_1
49727,3,TSPB,100,200,22999,NearestNeighborAny2Regret_w0_1_start102,72726,NearestNeighborAny2Regret_w0_1
49453,3,TSPB,100,200,24994,NearestNeighborAny2Regret_w0_1_start103,74447,NearestNeighborAny2Regret_w0_1
48753,2,TSPB,100,200,24823,NearestNeighborAny2Regret_w0_1_start104,73576,NearestNeighborAny2Regret_w0_1
53685,3,TSPB,100,200,22387,NearestNeighborAny2Regret_w0_1_start105,76072,NearestNeighborAny2Regret_w0_1
51720,3,TSPB,100,200,22489,NearestNeighborAny2Regret_w0_1_start106,74209,NearestNeighborAny2Regret_w0_1
50464,2,TSPB,100,200,21520,NearestNeighborAny2Regret_w0_1_start107,71984,NearestNeighborAny2Regret_w0_1
51717,3,TSPB,100,200,23617,NearestNeighborAny2Regret_w0_1_start108,75334,NearestNeighborAny2Regret_w0_1
50710,3,TSPB,100,200,23890,NearestNeighborAny2Regret_w0_1_start109,74600,NearestNeighborAny2Regret_w0_1
50504,2,TSPB,100,200,22700,NearestNeighborAny2Regret_w0_1_start110,73204,NearestNeighborAny2Regret_w0_1
48776,3,TSPB,100,200,23023,NearestNeighborAny2Regret_w0_1_start111,71799,NearestNeighborAny2Regret_w0_1
51319,3,TSPB,100,200,23265,NearestNeighborAny2Regret_w0_1_start112,74584,NearestNeighborAny2Regret_w0_1
49406,3,TSPB,100,200,24611,NearestNeighborAny2Regret_w0_1_start113,74017,NearestNeighborAny2Regret_w0_1
51525,3,TSPB,100,200,24218,NearestNeighborAny2Regret_w0_1_start114,75743,NearestNeighborAny2Regret_w0_1
48352,2,TSPB,100,200,22738,NearestNeighborAny2Regret_w0_1_start115,71090,NearestNeighborAny2Regret_w0_1
50351,3,TSPB,100,200,23844,NearestNeighborAny2Regret_w0_1_start116,74195,NearestNeighborAny2Regret_w0_1
48097,3,TSPB,100,200,23388,NearestNeighborAny2Regret_w0_1_start117,71485,NearestNeighborAny2Regret_w0_1
51649,3,TSPB,100,200,25631,NearestNeighborAny2Regret_w0_1_start118,77280,NearestNeighborAny2Regret_w0_1
50637,2,TSPB,100,200,22255,NearestNeighborAny2Regret_w0_1_start119,72892,NearestNeighborAny2Regret_w0_1
51668,3,TSPB,100,200,23712,NearestNeighborAny2Regret_w0_1_start120,75380,NearestNeighborAny2Regret_w0_1
52744,3,TSPB,100,200,24194,NearestNeighborAny2Regret_w0_1_start121,76938,NearestNeighborAny2Regret_w0_1
52145,2,TSPB,100,200,22985,NearestNeighborAny2Regret_w0_1_start122,75130,NearestNeighborAny2Regret_w0_1
49069,3,TSPB,100,200,24760,NearestNeighborAny2Regret_w0_1_start123,73829,NearestNeighborAny2Regret_w0_1
49039,3,TSPB,100,200,24662,NearestNeighborAny2Regret_w0_1_start124,73701,NearestNeighborAny2Regret_w0_1
52267,3,TSPB,100,200,24934,NearestNeighborAny2Regret_w0_1_start125,77201,NearestNeighborAny2Regret_w0_1
50616,2,TSPB,100,200,25456,NearestNeighborAny2Regret_w0_1_start126,76072,NearestNeighborAny2Regret_w0_1
51586,3,TSPB,100,200,25364,NearestNeighborAny2Regret_w0_1_start127,76950,NearestNeighborAny2Regret_w0_1
52356,3,TSPB,100,200,23387,NearestNeighborAny2Regret_w0_1_start128,75743,NearestNeighborAny2Regret_w0_1
50793,3,TSPB,100,200,23118,NearestNeighborAny2Regret_w0_1_start129,73911,NearestNeighborAny2Regret_w0_1
50673,2,TSPB,100,200,23329,NearestNeighborAny2Regret_w0_1_start130,74002,NearestNeighborAny2Regret_w0_1
51206,3,TSPB,100,200,22430,NearestNeighborAny2Regret_w0_1_start131,73636,NearestNeighborAny2Regret_w0_1
53457,3,TSPB,100,200,23860,NearestNeighborAny2Regret_w0_1_start132,77317,NearestNeighborAny2Regret_w0_1
50594,2,TSPB,100,200,23068,NearestNeighborAny2Regret_w0_1_start133,73662,NearestNeighborAny2Regret_w0_1
51296,3,TSPB,100,200,23803,NearestNeighborAny2Regret_w0_1_start134,75099,NearestNeighborAny2Regret_w0_1
50103,3,TSPB,100,200,22236,NearestNeighborAny2Regret_w0_1_start135,72339,NearestNeighborAny2Regret_w0_1
50789,2,TSPB,100,200,22561,NearestNeighborAny2Regret_w0_1_start136,73350,NearestNeighborAny2Regret_w0_1
50028,3,TSPB,100,200,23773,NearestNeighborAny2Regret_w0_1_start137,73801,NearestNeighborAny2Regret_w0_1
51279,3,TSPB,100,200,21819,NearestNeighborAny2Regret_w0_1_start138,73098,NearestNeighborAny2Regret_w0_1
49937,2,TSPB,100,200,22446,NearestNeighborAny2Regret_w0_1_start139,72383,NearestNeighborAny2Regret_w0_1
50684,3,TSPB,100,200,23235,NearestNeighborAny2Regret_w0_1_start140,73919,NearestNeighborAny2Regret_w0_1
50049,3,TSPB,100,200,24265,NearestNeighborAny2Regret_w0_1_start141,74314,NearestNeighborAny2Regret_w0_1
49406,2,TSPB,100,200,24495,NearestNeighborAny2Regret_w0_1_start142,73901,NearestNeighborAny2Regret_w0_1
50517,3,TSPB,100,200,24519,NearestNeighborAny2Regret_w0_1_start143,75036,NearestNeighborAny2Regret_w0_1
50943,3,TSPB,100,200,23941,NearestNeighborAny2Regret_w0_1_start144,74884,NearestNeighborAny2Regret_w0_1
49740,3,TSPB,100,200,24950,NearestNeighborAny2Regret_w0_1_start145,74690,NearestNeighborAny2Regret_w0_1
52602,2,TSPB,100,200,24495,NearestNeighborAny2Regret_w0_1_start146,77097,NearestNeighborAny2Regret_w0_1
52899,3,TSPB,100,200,25152,NearestNeighborAny2Regret_w0_1_start147,78051,NearestNeighborAny2Regret_w0_1
50965,3,TSPB,100,200,23097,NearestNeighborAny2Regret_w0_1_start148,74062,NearestNeighborAny2Regret_w0_1
50073,3,TSPB,100,200,23711,NearestNeighborAny2Regret_w0_1_start149,73784,NearestNeighborAny2Regret_w0_1
52757,2,TSPB,100,200,24013,NearestNeighborAny2Regret_w0_1_start150,76770,NearestNeighborAny2Regret_w0_1
49518,3,TSPB,100,200,24753,NearestNeighborAny2Regret_w0_1_start151,74271,NearestNeighborAny2Regret_w0_1
47047,3,TSPB,100,200,23134,NearestNeighborAny2Regret_w0_1_start152,70181,NearestNeighborAny2Regret_w0_1
51513,3,TSPB,100,200,25654,NearestNeighborAny2Regret_w0_1_start153,77167,NearestNeighborAny2Regret_w0_1
51594,2,TSPB,100,200,24155,NearestNeighborAny2Regret_w0_1_start154,75749,NearestNeighborAny2Regret_w0_1
54488,3,TSPB,100,200,25790,NearestNeighborAny2Regret_w0_1_start155,80278,NearestNeighborAny2Regret_w0_1
52299,3,TSPB,100,200,23247,NearestNeighborAny2Regret_w0_1_start156,75546,NearestNeighborAny2Regret_w0_1
50458,3,TSPB,100,200,23322,NearestNeighborAny2Regret_w0_1_start157,73780,NearestNeighborAny2Regret_w0_1
51876,2,TSPB,100,200,22848,NearestNeighborAny2Regret_w0_1_start158,74724,NearestNeighborAny2Regret_w0_1
50493,3,TSPB,100,200,23546,NearestNeighborAny2Regret_w0_1_start159,74039,NearestNeighborAny2Regret_w0_1
48905,3,TSPB,100,200,23411,NearestNeighborAny2Regret_w0_1_start160,72316,NearestNeighborAny2Regret_w0_1
53399,2,TSPB,100,200,22987,NearestNeighborAny2Regret_w0_1_start161,76386,NearestNeighborAny2Regret_w0_1
52051,3,TSPB,100,200,23864,NearestNeighborAny2Regret_w0_1_start162,75915,NearestNeighborAny2Regret_w0_1
49342,3,TSPB,100,200,24947,NearestNeighborAny2Regret_w0_1_start163,74289,NearestNeighborAny2Regret_w0_1
51655,3,TSPB,100,200,21596,NearestNeighborAny2Regret_w0_1_start164,73251,NearestNeighborAny2Regret_w0_1
50930,2,TSPB,100,200,22854,NearestNeighborAny2Regret_w0_1_start165,73784,NearestNeighborAny2Regret_w0_1
49059,3,TSPB,100,200,22402,NearestNeighborAny2Regret_w0_1_start166,71461,NearestNeighborAny2Regret_w0_1
52126,3,TSPB,100,200,23425,NearestNeighborAny2Regret_w0_1_start167,75551,NearestNeighborAny2Regret_w0_1
49017,3,TSPB,100,200,22681,NearestNeighborAny2Regret_w0_1_start168,71698,NearestNeighborAny2Regret_w0_1
51034,2,TSPB,100,200,24847,NearestNeighborAny2Regret_w0_1_start169,75881,NearestNeighborAny2Regret_w0_1
50150,3,TSPB,100,200,23362,NearestNeighborAny2Regret_w0_1_start170,73512,NearestNeighborAny2Regret_w0_1
47134,3,TSPB,100,200,24323,NearestNeighborAny2Regret_w0_1_start171,71457,NearestNeighborAny2Regret_w0_1
50655,2,TSPB,100,200,25019,NearestNeighborAny2Regret_w0_1_start172,75674,NearestNeighborAny2Regret_w0_1
51180,3,TSPB,100,200,23686,NearestNeighborAny2Regret_w0_1_start173,74866,NearestNeighborAny2Regret_w0_1
49806,3,TSPB,100,200,23487,NearestNeighborAny2Regret_w0_1_start174,73293,NearestNeighborAny2Regret_w0_1
49013,3,TSPB,100,200,24485,NearestNeighborAny2Regret_w0_1_start175,73498,NearestNeighborAny2Regret_w0_1
52543,2,TSPB,100,200,24383,NearestNeighborAny2Regret_w0_1_start176,76926,NearestNeighborAny2Regret_w0_1
48737,3,TSPB,100,200,24697,NearestNeighborAny2Regret_w0_1_start177,73434,NearestNeighborAny2Regret_w0_1
48335,3,TSPB,100,200,22298,NearestNeighborAny2Regret_w0_1_start178,70633,NearestNeighborAny2Regret_w0_1
48699,3,TSPB,100,200,24859,NearestNeighborAny2Regret_w0_1_start179,73558,NearestNeighborAny2Regret_w0_1
53172,2,TSPB,100,200,24385,NearestNeighborAny2Regret_w0_1_start180,77557,NearestNeighborAny2Regret_w0_1
48138,3,TSPB,100,200,22361,NearestNeighborAny2Regret_w0_1_start181,70499,NearestNeighborAny2Regret_w0_1
50221,3,TSPB,100,200,24501,NearestNeighborAny2Regret_w0_1_start182,74722,NearestNeighborAny2Regret_w0_1
49483,3,TSPB,100,200,22956,NearestNeighborAny2Regret_w0_1_start183,72439,NearestNeighborAny2Regret_w0_1
50227,3,TSPB,100,200,24679,NearestNeighborAny2Regret_w0_1_start184,74906,NearestNeighborAny2Regret_w0_1
49017,2,TSPB,100,200,24278,NearestNeighborAny2Regret_w0_1_start185,73295,NearestNeighborAny2Regret_w0_1
52102,3,TSPB,100,200,24122,NearestNeighborAny2Regret_w0_1_start186,76224,NearestNeighborAny2Regret_w0_1
52195,3,TSPB,100,200,25328,NearestNeighborAny2Regret_w0_1_start187,77523,NearestNeighborAny2Regret_w0_1
51890,2,TSPB,100,200,23195,NearestNeighborAny2Regret_w0_1_start188,75085,NearestNeighborAny2Regret_w0_1
50163,3,TSPB,100,200,23314,NearestNeighborAny2Regret_w0_1_start189,73477,NearestNeighborAny2Regret_w0_1
52540,3,TSPB,100,200,22525,NearestNeighborAny2Regret_w0_1_start190,75065,NearestNeighborAny2Regret_w0_1
51168,2,TSPB,100,200,23905,NearestNeighborAny2Regret_w0_1_start191,75073,NearestNeighborAny2Regret_w0_1
53005,3,TSPB,100,200,23170,NearestNeighborAny2Regret_w0_1_start192,76175,NearestNeighborAny2Regret_w0_1
49840,3,TSPB,100,200,23151,NearestNeighborAny2Regret_w0_1_start193,72991,NearestNeighborAny2Regret_w0_1
50517,2,TSPB,100,200,24519,NearestNeighborAny2Regret_w0_1_start194,75036,NearestNeighborAny2Regret_w0_1
52775,3,TSPB,100,200,23606,NearestNeighborAny2Regret_w0_1_start195,76381,NearestNeighborAny2Regret_w0_1
52833,3,TSPB,100,200,23847,NearestNeighborAny2Regret_w0_1_start196,76680,NearestNeighborAny2Regret_w0_1
52982,2,TSPB,100,200,23985,NearestNeighborAny2Regret_w0_1_start197,76967,NearestNeighborAny2Regret_w0_1
52075,3,TSPB,100,200,22406,NearestNeighborAny2Regret_w0_1_start198,74481,NearestNeighborAny2Regret_w0_1
49569,3,TSPB,100,200,23539,NearestNeighborAny2Regret_w0_1_start199,73108,NearestNeighborAny2Regret_w0_1
