algorithm,instance,objective_value,path_length,node_costs,computation_time_ms,selected_nodes,total_nodes
RandomSolution_start0,TSPA,266609,169300,97309,1,100,200
RandomSolution_start1,TSPA,264193,175494,88699,0,100,200
RandomSolution_start2,TSPA,256902,158926,97976,1,100,200
RandomSolution_start3,TSPA,268483,166696,101787,0,100,200
RandomSolution_start4,TSPA,279555,175829,103726,0,100,200
RandomSolution_start5,TSPA,260811,162460,98351,0,100,200
RandomSolution_start6,TSPA,268559,163428,105131,0,100,200
RandomSolution_start7,TSPA,260575,166361,94214,0,100,200
RandomSolution_start8,TSPA,275548,176768,98780,1,100,200
RandomSolution_start9,TSPA,280733,185959,94774,0,100,200
RandomSolution_start10,TSPA,257325,162192,95133,0,100,200
RandomSolution_start11,TSPA,255392,150215,105177,0,100,200
RandomSolution_start12,TSPA,271095,176795,94300,0,100,200
RandomSolution_start13,TSPA,250298,162380,87918,0,100,200
RandomSolution_start14,TSPA,257500,167149,90351,1,100,200
RandomSolution_start15,TSPA,257656,158256,99400,0,100,200
RandomSolution_start16,TSPA,279606,181305,98301,0,100,200
RandomSolution_start17,TSPA,270477,163581,106896,0,100,200
RandomSolution_start18,TSPA,267155,171554,95601,0,100,200
RandomSolution_start19,TSPA,260470,152881,107589,0,100,200
RandomSolution_start20,TSPA,262630,161948,100682,1,100,200
RandomSolution_start21,TSPA,282895,178535,104360,0,100,200
RandomSolution_start22,TSPA,263755,160271,103484,0,100,200
RandomSolution_start23,TSPA,265070,168894,96176,0,100,200
RandomSolution_start24,TSPA,279939,182535,97404,0,100,200
RandomSolution_start25,TSPA,268039,167594,100445,0,100,200
RandomSolution_start26,TSPA,282466,178934,103532,0,100,200
RandomSolution_start27,TSPA,275695,177528,98167,0,100,200
RandomSolution_start28,TSPA,250948,152620,98328,1,100,200
RandomSolution_start29,TSPA,250655,155464,95191,0,100,200
RandomSolution_start30,TSPA,272254,175877,96377,0,100,200
RandomSolution_start31,TSPA,276591,177662,98929,1,100,200
RandomSolution_start32,TSPA,263880,167127,96753,0,100,200
RandomSolution_start33,TSPA,266107,167571,98536,0,100,200
RandomSolution_start34,TSPA,261609,164060,97549,0,100,200
RandomSolution_start35,TSPA,273872,179083,94789,0,100,200
RandomSolution_start36,TSPA,273471,173332,100139,1,100,200
RandomSolution_start37,TSPA,272255,176676,95579,0,100,200
RandomSolution_start38,TSPA,255124,159870,95254,0,100,200
RandomSolution_start39,TSPA,260503,163797,96706,0,100,200
RandomSolution_start40,TSPA,263086,161993,101093,0,100,200
RandomSolution_start41,TSPA,265929,162657,103272,0,100,200
RandomSolution_start42,TSPA,267233,165048,102185,1,100,200
RandomSolution_start43,TSPA,271889,175634,96255,0,100,200
RandomSolution_start44,TSPA,279166,188238,90928,0,100,200
RandomSolution_start45,TSPA,259374,160173,99201,0,100,200
RandomSolution_start46,TSPA,261908,168080,93828,0,100,200
RandomSolution_start47,TSPA,267904,168844,99060,0,100,200
RandomSolution_start48,TSPA,256348,157605,98743,1,100,200
RandomSolution_start49,TSPA,277301,175564,101737,0,100,200
RandomSolution_start50,TSPA,265623,167079,98544,1,100,200
RandomSolution_start51,TSPA,259484,156787,102697,0,100,200
RandomSolution_start52,TSPA,268246,170945,97301,0,100,200
RandomSolution_start53,TSPA,257134,156104,101030,0,100,200
RandomSolution_start54,TSPA,270033,173554,96479,0,100,200
RandomSolution_start55,TSPA,273851,170030,103821,0,100,200
RandomSolution_start56,TSPA,241001,141718,99283,1,100,200
RandomSolution_start57,TSPA,283227,183047,100180,0,100,200
RandomSolution_start58,TSPA,263779,164290,99489,0,100,200
RandomSolution_start59,TSPA,270985,177631,93354,0,100,200
RandomSolution_start60,TSPA,259366,165096,94270,1,100,200
RandomSolution_start61,TSPA,265599,168592,97007,0,100,200
RandomSolution_start62,TSPA,269046,170704,98342,0,100,200
RandomSolution_start63,TSPA,252881,158843,94038,0,100,200
RandomSolution_start64,TSPA,266624,165991,100633,0,100,200
RandomSolution_start65,TSPA,254572,157788,96784,0,100,200
RandomSolution_start66,TSPA,261646,164967,96679,0,100,200
RandomSolution_start67,TSPA,268403,171792,96611,0,100,200
RandomSolution_start68,TSPA,271954,178333,93621,0,100,200
RandomSolution_start69,TSPA,262185,160897,101288,0,100,200
RandomSolution_start70,TSPA,259514,156845,102669,0,100,200
RandomSolution_start71,TSPA,262121,163600,98521,1,100,200
RandomSolution_start72,TSPA,267534,165385,102149,0,100,200
RandomSolution_start73,TSPA,247692,153421,94271,0,100,200
RandomSolution_start74,TSPA,250463,153251,97212,0,100,200
RandomSolution_start75,TSPA,267405,166471,100934,0,100,200
RandomSolution_start76,TSPA,267950,168661,99289,0,100,200
RandomSolution_start77,TSPA,264128,164618,99510,1,100,200
RandomSolution_start78,TSPA,262365,170026,92339,0,100,200
RandomSolution_start79,TSPA,263547,172194,91353,0,100,200
RandomSolution_start80,TSPA,270867,165316,105551,0,100,200
RandomSolution_start81,TSPA,257771,166575,91196,1,100,200
RandomSolution_start82,TSPA,250618,149707,100911,0,100,200
RandomSolution_start83,TSPA,271107,178658,92449,0,100,200
RandomSolution_start84,TSPA,274819,174473,100346,0,100,200
RandomSolution_start85,TSPA,273020,173570,99450,0,100,200
RandomSolution_start86,TSPA,248994,147326,101668,0,100,200
RandomSolution_start87,TSPA,269461,173425,96036,1,100,200
RandomSolution_start88,TSPA,261204,168050,93154,0,100,200
RandomSolution_start89,TSPA,282803,181157,101646,0,100,200
RandomSolution_start90,TSPA,263549,163564,99985,3,100,200
RandomSolution_start91,TSPA,256518,164496,92022,0,100,200
RandomSolution_start92,TSPA,256757,157102,99655,1,100,200
RandomSolution_start93,TSPA,262796,161993,100803,0,100,200
RandomSolution_start94,TSPA,262784,166903,95881,0,100,200
RandomSolution_start95,TSPA,255474,161546,93928,0,100,200
RandomSolution_start96,TSPA,264345,169380,94965,1,100,200
RandomSolution_start97,TSPA,267168,163892,103276,0,100,200
RandomSolution_start98,TSPA,268074,168000,100074,0,100,200
RandomSolution_start99,TSPA,271224,168013,103211,1,100,200
RandomSolution_start100,TSPA,266372,164891,101481,0,100,200
RandomSolution_start101,TSPA,277211,177805,99406,0,100,200
RandomSolution_start102,TSPA,272221,168047,104174,0,100,200
RandomSolution_start103,TSPA,261952,163417,98535,0,100,200
RandomSolution_start104,TSPA,265689,165303,100386,0,100,200
RandomSolution_start105,TSPA,264951,165766,99185,0,100,200
RandomSolution_start106,TSPA,265630,169845,95785,0,100,200
RandomSolution_start107,TSPA,259842,163372,96470,0,100,200
RandomSolution_start108,TSPA,259114,159362,99752,0,100,200
RandomSolution_start109,TSPA,251775,160898,90877,0,100,200
RandomSolution_start110,TSPA,267023,174314,92709,0,100,200
RandomSolution_start111,TSPA,262123,160530,101593,0,100,200
RandomSolution_start112,TSPA,256447,157251,99196,0,100,200
RandomSolution_start113,TSPA,267674,166276,101398,0,100,200
RandomSolution_start114,TSPA,286921,181472,105449,1,100,200
RandomSolution_start115,TSPA,257285,159076,98209,0,100,200
RandomSolution_start116,TSPA,264090,171459,92631,0,100,200
RandomSolution_start117,TSPA,279982,179696,100286,0,100,200
RandomSolution_start118,TSPA,264003,168356,95647,0,100,200
RandomSolution_start119,TSPA,283572,179999,103573,0,100,200
RandomSolution_start120,TSPA,242960,152347,90613,0,100,200
RandomSolution_start121,TSPA,243274,152379,90895,0,100,200
RandomSolution_start122,TSPA,267576,163473,104103,0,100,200
RandomSolution_start123,TSPA,258344,159868,98476,1,100,200
RandomSolution_start124,TSPA,275849,181391,94458,0,100,200
RandomSolution_start125,TSPA,276147,172597,103550,0,100,200
RandomSolution_start126,TSPA,279607,174193,105414,0,100,200
RandomSolution_start127,TSPA,271415,170492,100923,0,100,200
RandomSolution_start128,TSPA,281004,181775,99229,0,100,200
RandomSolution_start129,TSPA,269872,169932,99940,0,100,200
RandomSolution_start130,TSPA,268492,167978,100514,0,100,200
RandomSolution_start131,TSPA,258146,163868,94278,0,100,200
RandomSolution_start132,TSPA,283485,184482,99003,1,100,200
RandomSolution_start133,TSPA,257150,161723,95427,0,100,200
RandomSolution_start134,TSPA,256107,161386,94721,0,100,200
RandomSolution_start135,TSPA,242867,150356,92511,0,100,200
RandomSolution_start136,TSPA,272491,172971,99520,0,100,200
RandomSolution_start137,TSPA,264694,166081,98613,0,100,200
RandomSolution_start138,TSPA,253580,155345,98235,0,100,200
RandomSolution_start139,TSPA,288140,178021,110119,0,100,200
RandomSolution_start140,TSPA,285369,183335,102034,1,100,200
RandomSolution_start141,TSPA,272647,170910,101737,0,100,200
RandomSolution_start142,TSPA,249261,158895,90366,0,100,200
RandomSolution_start143,TSPA,264206,167417,96789,0,100,200
RandomSolution_start144,TSPA,262129,163522,98607,0,100,200
RandomSolution_start145,TSPA,262889,164091,98798,0,100,200
RandomSolution_start146,TSPA,245842,156819,89023,0,100,200
RandomSolution_start147,TSPA,257337,153564,103773,0,100,200
RandomSolution_start148,TSPA,275678,176970,98708,0,100,200
RandomSolution_start149,TSPA,241183,148138,93045,1,100,200
RandomSolution_start150,TSPA,267952,172661,95291,0,100,200
RandomSolution_start151,TSPA,276530,176194,100336,0,100,200
RandomSolution_start152,TSPA,258729,166305,92424,0,100,200
RandomSolution_start153,TSPA,256739,160792,95947,0,100,200
RandomSolution_start154,TSPA,264652,172721,91931,0,100,200
RandomSolution_start155,TSPA,283725,178888,104837,0,100,200
RandomSolution_start156,TSPA,269089,171084,98005,0,100,200
RandomSolution_start157,TSPA,238849,148965,89884,0,100,200
RandomSolution_start158,TSPA,246542,151589,94953,0,100,200
RandomSolution_start159,TSPA,276042,176640,99402,0,100,200
RandomSolution_start160,TSPA,248619,147060,101559,0,100,200
RandomSolution_start161,TSPA,271786,169104,102682,1,100,200
RandomSolution_start162,TSPA,257976,155983,101993,0,100,200
RandomSolution_start163,TSPA,262753,165437,97316,0,100,200
RandomSolution_start164,TSPA,269256,170659,98597,0,100,200
RandomSolution_start165,TSPA,258140,165876,92264,0,100,200
RandomSolution_start166,TSPA,270140,164444,105696,0,100,200
RandomSolution_start167,TSPA,279118,182871,96247,0,100,200
RandomSolution_start168,TSPA,258884,160003,98881,0,100,200
RandomSolution_start169,TSPA,253391,153025,100366,0,100,200
RandomSolution_start170,TSPA,262191,160695,101496,1,100,200
RandomSolution_start171,TSPA,266515,164605,101910,0,100,200
RandomSolution_start172,TSPA,281212,177940,103272,0,100,200
RandomSolution_start173,TSPA,277936,181097,96839,0,100,200
RandomSolution_start174,TSPA,257843,162465,95378,0,100,200
RandomSolution_start175,TSPA,276592,174194,102398,0,100,200
RandomSolution_start176,TSPA,263450,166488,96962,6,100,200
RandomSolution_start177,TSPA,275599,179238,96361,0,100,200
RandomSolution_start178,TSPA,269490,173033,96457,0,100,200
RandomSolution_start179,TSPA,261727,169511,92216,0,100,200
RandomSolution_start180,TSPA,281734,178823,102911,0,100,200
RandomSolution_start181,TSPA,270545,170842,99703,0,100,200
RandomSolution_start182,TSPA,270092,169339,100753,0,100,200
RandomSolution_start183,TSPA,275646,177567,98079,0,100,200
RandomSolution_start184,TSPA,271228,170869,100359,0,100,200
RandomSolution_start185,TSPA,253079,155270,97809,0,100,200
RandomSolution_start186,TSPA,242825,150291,92534,0,100,200
RandomSolution_start187,TSPA,274572,179161,95411,0,100,200
RandomSolution_start188,TSPA,263091,160809,102282,0,100,200
RandomSolution_start189,TSPA,266684,168709,97975,0,100,200
RandomSolution_start190,TSPA,262072,160543,101529,0,100,200
RandomSolution_start191,TSPA,257015,158830,98185,0,100,200
RandomSolution_start192,TSPA,268043,174612,93431,1,100,200
RandomSolution_start193,TSPA,261327,160580,100747,0,100,200
RandomSolution_start194,TSPA,276239,173658,102581,0,100,200
RandomSolution_start195,TSPA,251603,150485,101118,0,100,200
RandomSolution_start196,TSPA,248461,160744,87717,0,100,200
RandomSolution_start197,TSPA,268305,167046,101259,0,100,200
RandomSolution_start198,TSPA,265653,167318,98335,0,100,200
RandomSolution_start199,TSPA,257261,161015,96246,0,100,200
GreedyCycle_start0,TSPA,71488,23578,47910,16,100,200
GreedyCycle_start1,TSPA,72752,23585,49167,6,100,200
GreedyCycle_start2,TSPA,72639,24161,48478,17,100,200
GreedyCycle_start3,TSPA,72238,23760,48478,10,100,200
GreedyCycle_start4,TSPA,71761,23851,47910,6,100,200
GreedyCycle_start5,TSPA,71891,24115,47776,6,100,200
GreedyCycle_start6,TSPA,73061,24329,48732,8,100,200
GreedyCycle_start7,TSPA,73373,22852,50521,6,100,200
GreedyCycle_start8,TSPA,72839,23546,49293,7,100,200
GreedyCycle_start9,TSPA,71948,23548,48400,7,100,200
GreedyCycle_start10,TSPA,72475,24804,47671,12,100,200
GreedyCycle_start11,TSPA,73415,25081,48334,6,100,200
GreedyCycle_start12,TSPA,73023,23462,49561,7,100,200
GreedyCycle_start13,TSPA,74119,24298,49821,5,100,200
GreedyCycle_start14,TSPA,71948,23548,48400,3,100,200
GreedyCycle_start15,TSPA,72594,23799,48795,3,100,200
GreedyCycle_start16,TSPA,72815,24337,48478,3,100,200
GreedyCycle_start17,TSPA,73649,23166,50483,4,100,200
GreedyCycle_start18,TSPA,71926,24150,47776,4,100,200
GreedyCycle_start19,TSPA,73194,23503,49691,4,100,200
GreedyCycle_start20,TSPA,72584,24340,48244,3,100,200
GreedyCycle_start21,TSPA,72980,24302,48678,3,100,200
GreedyCycle_start22,TSPA,71926,24150,47776,3,100,200
GreedyCycle_start23,TSPA,72462,24250,48212,3,100,200
GreedyCycle_start24,TSPA,72702,24348,48354,3,100,200
GreedyCycle_start25,TSPA,72639,24161,48478,3,100,200
GreedyCycle_start26,TSPA,72752,23585,49167,3,100,200
GreedyCycle_start27,TSPA,72747,23227,49520,3,100,200
GreedyCycle_start28,TSPA,72920,24748,48172,3,100,200
GreedyCycle_start29,TSPA,72143,23759,48384,3,100,200
GreedyCycle_start30,TSPA,72749,25039,47710,4,100,200
GreedyCycle_start31,TSPA,72815,24337,48478,4,100,200
GreedyCycle_start32,TSPA,73131,23642,49489,3,100,200
GreedyCycle_start33,TSPA,73257,23498,49759,3,100,200
GreedyCycle_start34,TSPA,71773,24102,47671,2,100,200
GreedyCycle_start35,TSPA,71761,23851,47910,2,100,200
GreedyCycle_start36,TSPA,72530,23893,48637,2,100,200
GreedyCycle_start37,TSPA,72671,23498,49173,2,100,200
GreedyCycle_start38,TSPA,73894,24313,49581,2,100,200
GreedyCycle_start39,TSPA,72747,23227,49520,2,100,200
GreedyCycle_start40,TSPA,71948,23548,48400,2,100,200
GreedyCycle_start41,TSPA,72081,24305,47776,2,100,200
GreedyCycle_start42,TSPA,72129,24353,47776,2,100,200
GreedyCycle_start43,TSPA,72535,24864,47671,2,100,200
GreedyCycle_start44,TSPA,72639,24161,48478,2,100,200
GreedyCycle_start45,TSPA,73176,24436,48740,2,100,200
GreedyCycle_start46,TSPA,72081,24305,47776,2,100,200
GreedyCycle_start47,TSPA,72432,24371,48061,2,100,200
GreedyCycle_start48,TSPA,72712,25041,47671,2,100,200
GreedyCycle_start49,TSPA,71948,23548,48400,1,100,200
GreedyCycle_start50,TSPA,74350,24421,49929,1,100,200
GreedyCycle_start51,TSPA,72022,24246,47776,2,100,200
GreedyCycle_start52,TSPA,72326,23848,48478,2,100,200
GreedyCycle_start53,TSPA,72087,24311,47776,2,100,200
GreedyCycle_start54,TSPA,72712,25041,47671,2,100,200
GreedyCycle_start55,TSPA,72326,23848,48478,2,100,200
GreedyCycle_start56,TSPA,72815,24337,48478,2,100,200
GreedyCycle_start57,TSPA,71987,23509,48478,3,100,200
GreedyCycle_start58,TSPA,73532,22752,50780,1,100,200
GreedyCycle_start59,TSPA,72081,24305,47776,2,100,200
GreedyCycle_start60,TSPA,72818,24007,48811,2,100,200
GreedyCycle_start61,TSPA,73475,23576,49899,2,100,200
GreedyCycle_start62,TSPA,71948,23548,48400,3,100,200
GreedyCycle_start63,TSPA,72087,24311,47776,3,100,200
GreedyCycle_start64,TSPA,73320,23384,49936,2,100,200
GreedyCycle_start65,TSPA,72081,24305,47776,2,100,200
GreedyCycle_start66,TSPA,73043,24566,48477,4,100,200
GreedyCycle_start67,TSPA,72713,23885,48828,2,100,200
GreedyCycle_start68,TSPA,72129,24353,47776,2,100,200
GreedyCycle_start69,TSPA,71926,24150,47776,2,100,200
GreedyCycle_start70,TSPA,72087,24311,47776,2,100,200
GreedyCycle_start71,TSPA,73539,22759,50780,2,100,200
GreedyCycle_start72,TSPA,72561,24404,48157,2,100,200
GreedyCycle_start73,TSPA,73327,24033,49294,2,100,200
GreedyCycle_start74,TSPA,73362,23502,49860,2,100,200
GreedyCycle_start75,TSPA,72894,24416,48478,4,100,200
GreedyCycle_start76,TSPA,73540,24371,49169,7,100,200
GreedyCycle_start77,TSPA,72845,24799,48046,3,100,200
GreedyCycle_start78,TSPA,72639,24161,48478,1,100,200
GreedyCycle_start79,TSPA,72087,24311,47776,2,100,200
GreedyCycle_start80,TSPA,71951,24175,47776,2,100,200
GreedyCycle_start81,TSPA,71948,23548,48400,2,100,200
GreedyCycle_start82,TSPA,73386,24271,49115,2,100,200
GreedyCycle_start83,TSPA,73406,24226,49180,2,100,200
GreedyCycle_start84,TSPA,71761,23851,47910,2,100,200
GreedyCycle_start85,TSPA,73918,24318,49600,3,100,200
GreedyCycle_start86,TSPA,72602,23435,49167,2,100,200
GreedyCycle_start87,TSPA,73477,23444,50033,3,100,200
GreedyCycle_start88,TSPA,74252,24404,49848,2,100,200
GreedyCycle_start89,TSPA,72462,24250,48212,2,100,200
GreedyCycle_start90,TSPA,71948,23548,48400,1,100,200
GreedyCycle_start91,TSPA,73152,23660,49492,1,100,200
GreedyCycle_start92,TSPA,72639,24161,48478,2,100,200
GreedyCycle_start93,TSPA,71719,24005,47714,2,100,200
GreedyCycle_start94,TSPA,72602,23435,49167,2,100,200
GreedyCycle_start95,TSPA,73373,22852,50521,2,100,200
GreedyCycle_start96,TSPA,72426,24275,48151,2,100,200
GreedyCycle_start97,TSPA,72752,23585,49167,2,100,200
GreedyCycle_start98,TSPA,73238,23922,49316,2,100,200
GreedyCycle_start99,TSPA,73866,23589,50277,1,100,200
GreedyCycle_start100,TSPA,72602,23435,49167,3,100,200
GreedyCycle_start101,TSPA,72752,23585,49167,2,100,200
GreedyCycle_start102,TSPA,71948,23548,48400,1,100,200
GreedyCycle_start103,TSPA,71958,24060,47898,1,100,200
GreedyCycle_start104,TSPA,73307,24957,48350,2,100,200
GreedyCycle_start105,TSPA,72637,24381,48256,2,100,200
GreedyCycle_start106,TSPA,71948,23548,48400,2,100,200
GreedyCycle_start107,TSPA,73850,23191,50659,2,100,200
GreedyCycle_start108,TSPA,71926,24150,47776,2,100,200
GreedyCycle_start109,TSPA,72484,24033,48451,3,100,200
GreedyCycle_start110,TSPA,72801,24420,48381,2,100,200
GreedyCycle_start111,TSPA,73064,23239,49825,2,100,200
GreedyCycle_start112,TSPA,71761,23851,47910,1,100,200
GreedyCycle_start113,TSPA,72815,24337,48478,2,100,200
GreedyCycle_start114,TSPA,72640,23427,49213,2,100,200
GreedyCycle_start115,TSPA,72081,24305,47776,2,100,200
GreedyCycle_start116,TSPA,72081,24305,47776,2,100,200
GreedyCycle_start117,TSPA,71488,23578,47910,3,100,200
GreedyCycle_start118,TSPA,72081,24305,47776,2,100,200
GreedyCycle_start119,TSPA,71955,23555,48400,1,100,200
GreedyCycle_start120,TSPA,72639,24161,48478,3,100,200
GreedyCycle_start121,TSPA,72674,23389,49285,2,100,200
GreedyCycle_start122,TSPA,74197,24494,49703,2,100,200
GreedyCycle_start123,TSPA,73679,24065,49614,1,100,200
GreedyCycle_start124,TSPA,72713,23546,49167,2,100,200
GreedyCycle_start125,TSPA,73674,23543,50131,2,100,200
GreedyCycle_start126,TSPA,72265,23749,48516,2,100,200
GreedyCycle_start127,TSPA,73679,24065,49614,2,100,200
GreedyCycle_start128,TSPA,73436,24039,49397,2,100,200
GreedyCycle_start129,TSPA,72639,24161,48478,3,100,200
GreedyCycle_start130,TSPA,73353,23475,49878,2,100,200
GreedyCycle_start131,TSPA,72022,24246,47776,1,100,200
GreedyCycle_start132,TSPA,73613,23917,49696,2,100,200
GreedyCycle_start133,TSPA,71951,24175,47776,2,100,200
GreedyCycle_start134,TSPA,73387,24673,48714,2,100,200
GreedyCycle_start135,TSPA,72087,24311,47776,2,100,200
GreedyCycle_start136,TSPA,72812,24150,48662,2,100,200
GreedyCycle_start137,TSPA,72602,23435,49167,2,100,200
GreedyCycle_start138,TSPA,71948,23548,48400,2,100,200
GreedyCycle_start139,TSPA,72081,24305,47776,1,100,200
GreedyCycle_start140,TSPA,71719,24005,47714,1,100,200
GreedyCycle_start141,TSPA,72982,24264,48718,2,100,200
GreedyCycle_start142,TSPA,73152,24408,48744,2,100,200
GreedyCycle_start143,TSPA,71488,23578,47910,2,100,200
GreedyCycle_start144,TSPA,71948,23548,48400,2,100,200
GreedyCycle_start145,TSPA,72639,24161,48478,2,100,200
GreedyCycle_start146,TSPA,71773,24102,47671,2,100,200
GreedyCycle_start147,TSPA,73351,24725,48626,2,100,200
GreedyCycle_start148,TSPA,71948,23548,48400,2,100,200
GreedyCycle_start149,TSPA,72022,24246,47776,1,100,200
GreedyCycle_start150,TSPA,73729,23603,50126,1,100,200
GreedyCycle_start151,TSPA,71951,24175,47776,2,100,200
GreedyCycle_start152,TSPA,72752,23585,49167,2,100,200
GreedyCycle_start153,TSPA,72432,24193,48239,2,100,200
GreedyCycle_start154,TSPA,72087,24311,47776,2,100,200
GreedyCycle_start155,TSPA,73031,23503,49528,2,100,200
GreedyCycle_start156,TSPA,72276,23766,48510,2,100,200
GreedyCycle_start157,TSPA,72858,23770,49088,2,100,200
GreedyCycle_start158,TSPA,72360,24332,48028,2,100,200
GreedyCycle_start159,TSPA,71926,24150,47776,2,100,200
GreedyCycle_start160,TSPA,71773,24102,47671,2,100,200
GreedyCycle_start161,TSPA,73408,24816,48592,2,100,200
GreedyCycle_start162,TSPA,72211,24435,47776,2,100,200
GreedyCycle_start163,TSPA,72458,24162,48296,2,100,200
GreedyCycle_start164,TSPA,73373,22852,50521,2,100,200
GreedyCycle_start165,TSPA,71948,23548,48400,2,100,200
GreedyCycle_start166,TSPA,73408,25234,48174,2,100,200
GreedyCycle_start167,TSPA,72283,23978,48305,2,100,200
GreedyCycle_start168,TSPA,74073,24235,49838,2,100,200
GreedyCycle_start169,TSPA,73273,23841,49432,2,100,200
GreedyCycle_start170,TSPA,71732,23497,48235,2,100,200
GreedyCycle_start171,TSPA,72815,24337,48478,3,100,200
GreedyCycle_start172,TSPA,73768,23977,49791,2,100,200
GreedyCycle_start173,TSPA,73029,24354,48675,2,100,200
GreedyCycle_start174,TSPA,73249,23629,49620,2,100,200
GreedyCycle_start175,TSPA,72815,24337,48478,2,100,200
GreedyCycle_start176,TSPA,71951,24175,47776,2,100,200
GreedyCycle_start177,TSPA,72712,25041,47671,2,100,200
GreedyCycle_start178,TSPA,71948,23548,48400,2,100,200
GreedyCycle_start179,TSPA,72179,23701,48478,2,100,200
GreedyCycle_start180,TSPA,72087,24311,47776,2,100,200
GreedyCycle_start181,TSPA,71773,24102,47671,2,100,200
GreedyCycle_start182,TSPA,72835,24148,48687,2,100,200
GreedyCycle_start183,TSPA,72462,24250,48212,1,100,200
GreedyCycle_start184,TSPA,72535,24864,47671,1,100,200
GreedyCycle_start185,TSPA,71948,23548,48400,2,100,200
GreedyCycle_start186,TSPA,72530,24318,48212,1,100,200
GreedyCycle_start187,TSPA,73129,23590,49539,2,100,200
GreedyCycle_start188,TSPA,74410,24435,49975,2,100,200
GreedyCycle_start189,TSPA,72813,23396,49417,2,100,200
GreedyCycle_start190,TSPA,72475,24804,47671,2,100,200
GreedyCycle_start191,TSPA,72772,24326,48446,2,100,200
GreedyCycle_start192,TSPA,72507,24123,48384,2,100,200
GreedyCycle_start193,TSPA,72081,24305,47776,2,100,200
GreedyCycle_start194,TSPA,72834,24621,48213,1,100,200
GreedyCycle_start195,TSPA,71868,24028,47840,2,100,200
GreedyCycle_start196,TSPA,72163,23685,48478,2,100,200
GreedyCycle_start197,TSPA,72985,24475,48510,2,100,200
GreedyCycle_start198,TSPA,72350,24104,48246,2,100,200
GreedyCycle_start199,TSPA,72629,24449,48180,2,100,200
NearestNeighborEnd_start0,TSPA,84780,35690,49090,2,100,200
NearestNeighborEnd_start1,TSPA,84037,32394,51643,2,100,200
NearestNeighborEnd_start2,TSPA,84180,33242,50938,1,100,200
NearestNeighborEnd_start3,TSPA,84539,32857,51682,2,100,200
NearestNeighborEnd_start4,TSPA,85555,36724,48831,2,100,200
NearestNeighborEnd_start5,TSPA,88080,33563,54517,0,100,200
NearestNeighborEnd_start6,TSPA,87351,34986,52365,1,100,200
NearestNeighborEnd_start7,TSPA,85482,33997,51485,0,100,200
NearestNeighborEnd_start8,TSPA,84941,33003,51938,1,100,200
NearestNeighborEnd_start9,TSPA,84010,32087,51923,0,100,200
NearestNeighborEnd_start10,TSPA,86282,37316,48966,0,100,200
NearestNeighborEnd_start11,TSPA,86023,36410,49613,1,100,200
NearestNeighborEnd_start12,TSPA,84545,32754,51791,0,100,200
NearestNeighborEnd_start13,TSPA,85444,33484,51960,0,100,200
NearestNeighborEnd_start14,TSPA,84986,33182,51804,0,100,200
NearestNeighborEnd_start15,TSPA,84228,32190,52038,1,100,200
NearestNeighborEnd_start16,TSPA,84581,33305,51276,0,100,200
NearestNeighborEnd_start17,TSPA,85350,33410,51940,0,100,200
NearestNeighborEnd_start18,TSPA,86267,33067,53200,1,100,200
NearestNeighborEnd_start19,TSPA,84505,32456,52049,0,100,200
NearestNeighborEnd_start20,TSPA,86083,33009,53074,0,100,200
NearestNeighborEnd_start21,TSPA,85549,33628,51921,0,100,200
NearestNeighborEnd_start22,TSPA,86716,33886,52830,1,100,200
NearestNeighborEnd_start23,TSPA,85127,34541,50586,0,100,200
NearestNeighborEnd_start24,TSPA,84185,34184,50001,1,100,200
NearestNeighborEnd_start25,TSPA,84245,32940,51305,0,100,200
NearestNeighborEnd_start26,TSPA,83952,32309,51643,0,100,200
NearestNeighborEnd_start27,TSPA,85362,33351,52011,1,100,200
NearestNeighborEnd_start28,TSPA,85739,36376,49363,0,100,200
NearestNeighborEnd_start29,TSPA,84242,34223,50019,0,100,200
NearestNeighborEnd_start30,TSPA,89433,34916,54517,1,100,200
NearestNeighborEnd_start31,TSPA,84488,33212,51276,0,100,200
NearestNeighborEnd_start32,TSPA,85604,32872,52732,0,100,200
NearestNeighborEnd_start33,TSPA,85149,32147,53002,0,100,200
NearestNeighborEnd_start34,TSPA,88973,34456,54517,1,100,200
NearestNeighborEnd_start35,TSPA,85276,36445,48831,0,100,200
NearestNeighborEnd_start36,TSPA,85790,35125,50665,0,100,200
NearestNeighborEnd_start37,TSPA,84561,32145,52416,1,100,200
NearestNeighborEnd_start38,TSPA,84844,33124,51720,0,100,200
NearestNeighborEnd_start39,TSPA,85064,32757,52307,0,100,200
NearestNeighborEnd_start40,TSPA,84596,32953,51643,1,100,200
NearestNeighborEnd_start41,TSPA,85677,32477,53200,0,100,200
NearestNeighborEnd_start42,TSPA,87938,33869,54069,0,100,200
NearestNeighborEnd_start43,TSPA,86228,33340,52888,0,100,200
NearestNeighborEnd_start44,TSPA,84160,32517,51643,1,100,200
NearestNeighborEnd_start45,TSPA,84507,31815,52692,0,100,200
NearestNeighborEnd_start46,TSPA,85207,35314,49893,0,100,200
NearestNeighborEnd_start47,TSPA,86014,33036,52978,1,100,200
NearestNeighborEnd_start48,TSPA,87100,34270,52830,0,100,200
NearestNeighborEnd_start49,TSPA,85158,32660,52498,0,100,200
NearestNeighborEnd_start50,TSPA,85627,33559,52068,0,100,200
NearestNeighborEnd_start51,TSPA,83597,31793,51804,1,100,200
NearestNeighborEnd_start52,TSPA,84420,32777,51643,0,100,200
NearestNeighborEnd_start53,TSPA,83717,32074,51643,0,100,200
NearestNeighborEnd_start54,TSPA,88641,34352,54289,1,100,200
NearestNeighborEnd_start55,TSPA,84425,32782,51643,0,100,200
NearestNeighborEnd_start56,TSPA,84663,33496,51167,0,100,200
NearestNeighborEnd_start57,TSPA,83969,32693,51276,1,100,200
NearestNeighborEnd_start58,TSPA,85813,33989,51824,0,100,200
NearestNeighborEnd_start59,TSPA,84078,33583,50495,0,100,200
NearestNeighborEnd_start60,TSPA,84810,33956,50854,0,100,200
NearestNeighborEnd_start61,TSPA,85335,32193,53142,1,100,200
NearestNeighborEnd_start62,TSPA,84730,32232,52498,0,100,200
NearestNeighborEnd_start63,TSPA,84226,33575,50651,0,100,200
NearestNeighborEnd_start64,TSPA,85751,35952,49799,1,100,200
NearestNeighborEnd_start65,TSPA,86184,32984,53200,0,100,200
NearestNeighborEnd_start66,TSPA,83996,31971,52025,0,100,200
NearestNeighborEnd_start67,TSPA,86147,32756,53391,0,100,200
NearestNeighborEnd_start68,TSPA,85659,33861,51798,1,100,200
NearestNeighborEnd_start69,TSPA,86265,33065,53200,0,100,200
NearestNeighborEnd_start70,TSPA,86219,35091,51128,0,100,200
NearestNeighborEnd_start71,TSPA,86003,33682,52321,1,100,200
NearestNeighborEnd_start72,TSPA,83993,33541,50452,0,100,200
NearestNeighborEnd_start73,TSPA,85441,32904,52537,1,100,200
NearestNeighborEnd_start74,TSPA,84067,31910,52157,0,100,200
NearestNeighborEnd_start75,TSPA,84115,32472,51643,0,100,200
NearestNeighborEnd_start76,TSPA,85159,35157,50002,1,100,200
NearestNeighborEnd_start77,TSPA,86158,33180,52978,0,100,200
NearestNeighborEnd_start78,TSPA,83904,32628,51276,0,100,200
NearestNeighborEnd_start79,TSPA,83941,32298,51643,0,100,200
NearestNeighborEnd_start80,TSPA,83681,31877,51804,1,100,200
NearestNeighborEnd_start81,TSPA,85182,33539,51643,0,100,200
NearestNeighborEnd_start82,TSPA,84463,32781,51682,0,100,200
NearestNeighborEnd_start83,TSPA,85525,35512,50013,1,100,200
NearestNeighborEnd_start84,TSPA,85430,36599,48831,0,100,200
NearestNeighborEnd_start85,TSPA,85088,33349,51739,0,100,200
NearestNeighborEnd_start86,TSPA,84084,32441,51643,1,100,200
NearestNeighborEnd_start87,TSPA,85093,32702,52391,0,100,200
NearestNeighborEnd_start88,TSPA,85343,33356,51987,0,100,200
NearestNeighborEnd_start89,TSPA,84755,36160,48595,0,100,200
NearestNeighborEnd_start90,TSPA,84962,33475,51487,1,100,200
NearestNeighborEnd_start91,TSPA,84709,33078,51631,0,100,200
NearestNeighborEnd_start92,TSPA,83743,32467,51276,0,100,200
NearestNeighborEnd_start93,TSPA,85668,35173,50495,1,100,200
NearestNeighborEnd_start94,TSPA,83436,32498,50938,0,100,200
NearestNeighborEnd_start95,TSPA,85426,33110,52316,0,100,200
NearestNeighborEnd_start96,TSPA,85900,32825,53075,0,100,200
NearestNeighborEnd_start97,TSPA,84029,32386,51643,1,100,200
NearestNeighborEnd_start98,TSPA,85677,33829,51848,0,100,200
NearestNeighborEnd_start99,TSPA,84644,32200,52444,0,100,200
NearestNeighborEnd_start100,TSPA,83923,32280,51643,1,100,200
NearestNeighborEnd_start101,TSPA,84078,32435,51643,0,100,200
NearestNeighborEnd_start102,TSPA,84653,32567,52086,0,100,200
NearestNeighborEnd_start103,TSPA,86810,33980,52830,1,100,200
NearestNeighborEnd_start104,TSPA,86444,36903,49541,0,100,200
NearestNeighborEnd_start105,TSPA,86054,33044,53010,0,100,200
NearestNeighborEnd_start106,TSPA,84435,32792,51643,0,100,200
NearestNeighborEnd_start107,TSPA,86307,33312,52995,1,100,200
NearestNeighborEnd_start108,TSPA,86212,33012,53200,0,100,200
NearestNeighborEnd_start109,TSPA,84177,33683,50494,0,100,200
NearestNeighborEnd_start110,TSPA,85207,34531,50676,1,100,200
NearestNeighborEnd_start111,TSPA,85226,32601,52625,0,100,200
NearestNeighborEnd_start112,TSPA,83890,34634,49256,0,100,200
NearestNeighborEnd_start113,TSPA,84784,33508,51276,1,100,200
NearestNeighborEnd_start114,TSPA,85426,36336,49090,0,100,200
NearestNeighborEnd_start115,TSPA,85004,33206,51798,0,100,200
NearestNeighborEnd_start116,TSPA,86107,32907,53200,0,100,200
NearestNeighborEnd_start117,TSPA,84234,33737,50497,1,100,200
NearestNeighborEnd_start118,TSPA,85472,33429,52043,0,100,200
NearestNeighborEnd_start119,TSPA,84630,33017,51613,0,100,200
NearestNeighborEnd_start120,TSPA,84300,32657,51643,1,100,200
NearestNeighborEnd_start121,TSPA,83717,32074,51643,0,100,200
NearestNeighborEnd_start122,TSPA,84273,33330,50943,0,100,200
NearestNeighborEnd_start123,TSPA,83692,34436,49256,0,100,200
NearestNeighborEnd_start124,TSPA,83182,31732,51450,1,100,200
NearestNeighborEnd_start125,TSPA,84402,31974,52428,0,100,200
NearestNeighborEnd_start126,TSPA,84313,34162,50151,0,100,200
NearestNeighborEnd_start127,TSPA,83692,34436,49256,1,100,200
NearestNeighborEnd_start128,TSPA,85347,32612,52735,0,100,200
NearestNeighborEnd_start129,TSPA,84528,33590,50938,0,100,200
NearestNeighborEnd_start130,TSPA,83961,31786,52175,0,100,200
NearestNeighborEnd_start131,TSPA,86532,33332,53200,1,100,200
NearestNeighborEnd_start132,TSPA,85897,32958,52939,0,100,200
NearestNeighborEnd_start133,TSPA,83590,31786,51804,0,100,200
NearestNeighborEnd_start134,TSPA,86516,32972,53544,1,100,200
NearestNeighborEnd_start135,TSPA,86531,34837,51694,0,100,200
NearestNeighborEnd_start136,TSPA,83810,31959,51851,0,100,200
NearestNeighborEnd_start137,TSPA,84254,32450,51804,0,100,200
NearestNeighborEnd_start138,TSPA,85298,33096,52202,1,100,200
NearestNeighborEnd_start139,TSPA,84844,34349,50495,0,100,200
NearestNeighborEnd_start140,TSPA,85509,35014,50495,0,100,200
NearestNeighborEnd_start141,TSPA,84343,32077,52266,0,100,200
NearestNeighborEnd_start142,TSPA,85995,32497,53498,0,100,200
NearestNeighborEnd_start143,TSPA,84382,33885,50497,1,100,200
NearestNeighborEnd_start144,TSPA,85192,32694,52498,0,100,200
NearestNeighborEnd_start145,TSPA,83868,32592,51276,1,100,200
NearestNeighborEnd_start146,TSPA,86713,33883,52830,0,100,200
NearestNeighborEnd_start147,TSPA,87828,34575,53253,1,100,200
NearestNeighborEnd_start148,TSPA,83620,32553,51067,0,100,200
NearestNeighborEnd_start149,TSPA,84775,34524,50251,0,100,200
NearestNeighborEnd_start150,TSPA,84895,32411,52484,1,100,200
NearestNeighborEnd_start151,TSPA,83657,31814,51843,0,100,200
NearestNeighborEnd_start152,TSPA,83923,32985,50938,0,100,200
NearestNeighborEnd_start153,TSPA,84596,35195,49401,1,100,200
NearestNeighborEnd_start154,TSPA,83365,34739,48626,0,100,200
NearestNeighborEnd_start155,TSPA,85398,32627,52771,0,100,200
NearestNeighborEnd_start156,TSPA,84359,34214,50145,1,100,200
NearestNeighborEnd_start157,TSPA,84534,33307,51227,0,100,200
NearestNeighborEnd_start158,TSPA,83972,32083,51889,0,100,200
NearestNeighborEnd_start159,TSPA,84585,34445,50140,1,100,200
NearestNeighborEnd_start160,TSPA,87057,34227,52830,0,100,200
NearestNeighborEnd_start161,TSPA,84873,34634,50239,1,100,200
NearestNeighborEnd_start162,TSPA,84464,34406,50058,0,100,200
NearestNeighborEnd_start163,TSPA,86114,32914,53200,0,100,200
NearestNeighborEnd_start164,TSPA,85585,33951,51634,1,100,200
NearestNeighborEnd_start165,TSPA,84653,32636,52017,0,100,200
NearestNeighborEnd_start166,TSPA,86720,33526,53194,0,100,200
NearestNeighborEnd_start167,TSPA,84744,32637,52107,1,100,200
NearestNeighborEnd_start168,TSPA,84838,32861,51977,0,100,200
NearestNeighborEnd_start169,TSPA,85211,33134,52077,0,100,200
NearestNeighborEnd_start170,TSPA,84638,33694,50944,1,100,200
NearestNeighborEnd_start171,TSPA,84906,33630,51276,0,100,200
NearestNeighborEnd_start172,TSPA,85531,33173,52358,0,100,200
NearestNeighborEnd_start173,TSPA,84592,34844,49748,1,100,200
NearestNeighborEnd_start174,TSPA,85625,33360,52265,0,100,200
NearestNeighborEnd_start175,TSPA,84947,33671,51276,0,100,200
NearestNeighborEnd_start176,TSPA,83790,31986,51804,1,100,200
NearestNeighborEnd_start177,TSPA,85782,36482,49300,0,100,200
NearestNeighborEnd_start178,TSPA,84462,32819,51643,0,100,200
NearestNeighborEnd_start179,TSPA,83965,32955,51010,1,100,200
NearestNeighborEnd_start180,TSPA,83650,34855,48795,0,100,200
NearestNeighborEnd_start181,TSPA,87678,34399,53279,0,100,200
NearestNeighborEnd_start182,TSPA,83881,32005,51876,0,100,200
NearestNeighborEnd_start183,TSPA,84817,35727,49090,1,100,200
NearestNeighborEnd_start184,TSPA,85198,36367,48831,0,100,200
NearestNeighborEnd_start185,TSPA,84424,32781,51643,0,100,200
NearestNeighborEnd_start186,TSPA,85018,35928,49090,1,100,200
NearestNeighborEnd_start187,TSPA,85739,33555,52184,0,100,200
NearestNeighborEnd_start188,TSPA,85786,33672,52114,0,100,200
NearestNeighborEnd_start189,TSPA,84170,32395,51775,1,100,200
NearestNeighborEnd_start190,TSPA,85891,37060,48831,0,100,200
NearestNeighborEnd_start191,TSPA,85192,34451,50741,0,100,200
NearestNeighborEnd_start192,TSPA,87010,33999,53011,1,100,200
NearestNeighborEnd_start193,TSPA,85663,32463,53200,1,100,200
NearestNeighborEnd_start194,TSPA,86673,34827,51846,1,100,200
NearestNeighborEnd_start195,TSPA,86672,33842,52830,1,100,200
NearestNeighborEnd_start196,TSPA,84501,33225,51276,0,100,200
NearestNeighborEnd_start197,TSPA,84750,33945,50805,1,100,200
NearestNeighborEnd_start198,TSPA,84745,34322,50423,0,100,200
NearestNeighborEnd_start199,TSPA,86462,33262,53200,0,100,200
NearestNeighborAny_start0,TSPA,73503,25775,47728,24,100,200
NearestNeighborAny_start1,TSPA,73697,25894,47803,18,100,200
NearestNeighborAny_start2,TSPA,73846,26043,47803,57,100,200
NearestNeighborAny_start3,TSPA,72916,24969,47947,5,100,200
NearestNeighborAny_start4,TSPA,73304,25633,47671,5,100,200
NearestNeighborAny_start5,TSPA,72779,25003,47776,3,100,200
NearestNeighborAny_start6,TSPA,73756,25012,48744,5,100,200
NearestNeighborAny_start7,TSPA,72493,24830,47663,5,100,200
NearestNeighborAny_start8,TSPA,73191,24988,48203,8,100,200
NearestNeighborAny_start9,TSPA,72169,24300,47869,6,100,200
NearestNeighborAny_start10,TSPA,74015,26344,47671,4,100,200
NearestNeighborAny_start11,TSPA,73486,25121,48365,6,100,200
NearestNeighborAny_start12,TSPA,73446,25203,48243,3,100,200
NearestNeighborAny_start13,TSPA,75450,26902,48548,3,100,200
NearestNeighborAny_start14,TSPA,72169,24300,47869,3,100,200
NearestNeighborAny_start15,TSPA,73009,24797,48212,3,100,200
NearestNeighborAny_start16,TSPA,74335,26520,47815,3,100,200
NearestNeighborAny_start17,TSPA,74821,24770,50051,4,100,200
NearestNeighborAny_start18,TSPA,72207,24536,47671,5,100,200
NearestNeighborAny_start19,TSPA,74052,25869,48183,3,100,200
NearestNeighborAny_start20,TSPA,72553,24487,48066,2,100,200
NearestNeighborAny_start21,TSPA,73453,25709,47744,3,100,200
NearestNeighborAny_start22,TSPA,72207,24536,47671,3,100,200
NearestNeighborAny_start23,TSPA,73194,25404,47790,5,100,200
NearestNeighborAny_start24,TSPA,73208,25032,48176,3,100,200
NearestNeighborAny_start25,TSPA,73697,25894,47803,4,100,200
NearestNeighborAny_start26,TSPA,73648,25845,47803,3,100,200
NearestNeighborAny_start27,TSPA,72836,25354,47482,3,100,200
NearestNeighborAny_start28,TSPA,73353,25003,48350,3,100,200
NearestNeighborAny_start29,TSPA,72889,24505,48384,3,100,200
NearestNeighborAny_start30,TSPA,72602,24892,47710,2,100,200
NearestNeighborAny_start31,TSPA,74719,26916,47803,3,100,200
NearestNeighborAny_start32,TSPA,73429,25030,48399,3,100,200
NearestNeighborAny_start33,TSPA,73140,24319,48821,3,100,200
NearestNeighborAny_start34,TSPA,72779,25003,47776,3,100,200
NearestNeighborAny_start35,TSPA,73555,25892,47663,3,100,200
NearestNeighborAny_start36,TSPA,72530,23893,48637,3,100,200
NearestNeighborAny_start37,TSPA,72551,24316,48235,3,100,200
NearestNeighborAny_start38,TSPA,75259,26951,48308,3,100,200
NearestNeighborAny_start39,TSPA,73144,25193,47951,3,100,200
NearestNeighborAny_start40,TSPA,72866,25076,47790,2,100,200
NearestNeighborAny_start41,TSPA,72207,24536,47671,2,100,200
NearestNeighborAny_start42,TSPA,72779,25003,47776,2,100,200
NearestNeighborAny_start43,TSPA,71179,23434,47745,2,100,200
NearestNeighborAny_start44,TSPA,73697,25894,47803,2,100,200
NearestNeighborAny_start45,TSPA,72677,24115,48562,2,100,200
NearestNeighborAny_start46,TSPA,72364,24453,47911,2,100,200
NearestNeighborAny_start47,TSPA,71416,23343,48073,3,100,200
NearestNeighborAny_start48,TSPA,72779,25003,47776,2,100,200
NearestNeighborAny_start49,TSPA,72169,24300,47869,2,100,200
NearestNeighborAny_start50,TSPA,75253,26467,48786,2,100,200
NearestNeighborAny_start51,TSPA,72501,24711,47790,2,100,200
NearestNeighborAny_start52,TSPA,71512,23807,47705,2,100,200
NearestNeighborAny_start53,TSPA,73024,25114,47910,2,100,200
NearestNeighborAny_start54,TSPA,72779,25003,47776,2,100,200
NearestNeighborAny_start55,TSPA,71512,23807,47705,2,100,200
NearestNeighborAny_start56,TSPA,74719,26916,47803,2,100,200
NearestNeighborAny_start57,TSPA,73697,25894,47803,2,100,200
NearestNeighborAny_start58,TSPA,73175,25016,48159,2,100,200
NearestNeighborAny_start59,TSPA,71179,23434,47745,2,100,200
NearestNeighborAny_start60,TSPA,73347,24713,48634,2,100,200
NearestNeighborAny_start61,TSPA,74200,23895,50305,2,100,200
NearestNeighborAny_start62,TSPA,72169,24300,47869,2,100,200
NearestNeighborAny_start63,TSPA,72545,24755,47790,2,100,200
NearestNeighborAny_start64,TSPA,73236,24210,49026,2,100,200
NearestNeighborAny_start65,TSPA,71179,23434,47745,2,100,200
NearestNeighborAny_start66,TSPA,73258,24840,48418,2,100,200
NearestNeighborAny_start67,TSPA,72964,24581,48383,2,100,200
NearestNeighborAny_start68,TSPA,74828,26747,48081,2,100,200
NearestNeighborAny_start69,TSPA,72322,24651,47671,2,100,200
NearestNeighborAny_start70,TSPA,73024,25114,47910,2,100,200
NearestNeighborAny_start71,TSPA,73182,25023,48159,2,100,200
NearestNeighborAny_start72,TSPA,71638,23469,48169,2,100,200
NearestNeighborAny_start73,TSPA,72837,24481,48356,2,100,200
NearestNeighborAny_start74,TSPA,74136,25758,48378,2,100,200
NearestNeighborAny_start75,TSPA,73697,25894,47803,2,100,200
NearestNeighborAny_start76,TSPA,74115,25413,48702,2,100,200
NearestNeighborAny_start77,TSPA,71611,23375,48236,2,100,200
NearestNeighborAny_start78,TSPA,73697,25894,47803,2,100,200
NearestNeighborAny_start79,TSPA,72545,24755,47790,2,100,200
NearestNeighborAny_start80,TSPA,72545,24755,47790,2,100,200
NearestNeighborAny_start81,TSPA,73704,24653,49051,2,100,200
NearestNeighborAny_start82,TSPA,72784,23669,49115,2,100,200
NearestNeighborAny_start83,TSPA,74093,25380,48713,3,100,200
NearestNeighborAny_start84,TSPA,73534,25871,47663,1,100,200
NearestNeighborAny_start85,TSPA,75249,26922,48327,2,100,200
NearestNeighborAny_start86,TSPA,73581,25778,47803,2,100,200
NearestNeighborAny_start87,TSPA,74312,25761,48551,2,100,200
NearestNeighborAny_start88,TSPA,75114,26409,48705,2,100,200
NearestNeighborAny_start89,TSPA,73194,25404,47790,2,100,200
NearestNeighborAny_start90,TSPA,72866,25076,47790,2,100,200
NearestNeighborAny_start91,TSPA,74416,26197,48219,2,100,200
NearestNeighborAny_start92,TSPA,74674,25258,49416,2,100,200
NearestNeighborAny_start93,TSPA,73503,25775,47728,2,100,200
NearestNeighborAny_start94,TSPA,72639,24849,47790,2,100,200
NearestNeighborAny_start95,TSPA,73376,25427,47949,2,100,200
NearestNeighborAny_start96,TSPA,73183,25032,48151,2,100,200
NearestNeighborAny_start97,TSPA,73697,25894,47803,2,100,200
NearestNeighborAny_start98,TSPA,74974,25015,49959,2,100,200
NearestNeighborAny_start99,TSPA,74172,25274,48898,2,100,200
NearestNeighborAny_start100,TSPA,73648,25845,47803,2,100,200
NearestNeighborAny_start101,TSPA,73697,25894,47803,2,100,200
NearestNeighborAny_start102,TSPA,72169,24300,47869,2,100,200
NearestNeighborAny_start103,TSPA,72440,24408,48032,2,100,200
NearestNeighborAny_start104,TSPA,74481,26149,48332,2,100,200
NearestNeighborAny_start105,TSPA,71552,23284,48268,2,100,200
NearestNeighborAny_start106,TSPA,72866,25076,47790,2,100,200
NearestNeighborAny_start107,TSPA,73848,25015,48833,2,100,200
NearestNeighborAny_start108,TSPA,72207,24536,47671,2,100,200
NearestNeighborAny_start109,TSPA,72754,24480,48274,2,100,200
NearestNeighborAny_start110,TSPA,72542,24161,48381,2,100,200
NearestNeighborAny_start111,TSPA,74094,24033,50061,2,100,200
NearestNeighborAny_start112,TSPA,72445,24535,47910,2,100,200
NearestNeighborAny_start113,TSPA,74335,26520,47815,2,100,200
NearestNeighborAny_start114,TSPA,72574,24586,47988,2,100,200
NearestNeighborAny_start115,TSPA,72207,24536,47671,2,100,200
NearestNeighborAny_start116,TSPA,71179,23434,47745,2,100,200
NearestNeighborAny_start117,TSPA,73503,25775,47728,3,100,200
NearestNeighborAny_start118,TSPA,71179,23434,47745,2,100,200
NearestNeighborAny_start119,TSPA,72866,25076,47790,2,100,200
NearestNeighborAny_start120,TSPA,73697,25894,47803,2,100,200
NearestNeighborAny_start121,TSPA,73061,25082,47979,3,100,200
NearestNeighborAny_start122,TSPA,72652,24655,47997,2,100,200
NearestNeighborAny_start123,TSPA,73024,25114,47910,2,100,200
NearestNeighborAny_start124,TSPA,72728,24952,47776,2,100,200
NearestNeighborAny_start125,TSPA,74410,25761,48649,2,100,200
NearestNeighborAny_start126,TSPA,72958,24442,48516,2,100,200
NearestNeighborAny_start127,TSPA,73024,25114,47910,3,100,200
NearestNeighborAny_start128,TSPA,73600,25141,48459,2,100,200
NearestNeighborAny_start129,TSPA,74674,25258,49416,2,100,200
NearestNeighborAny_start130,TSPA,73526,24966,48560,2,100,200
NearestNeighborAny_start131,TSPA,72804,25133,47671,2,100,200
NearestNeighborAny_start132,TSPA,73342,24584,48758,2,100,200
NearestNeighborAny_start133,TSPA,73194,25404,47790,3,100,200
NearestNeighborAny_start134,TSPA,73282,24803,48479,3,100,200
NearestNeighborAny_start135,TSPA,73024,25114,47910,2,100,200
NearestNeighborAny_start136,TSPA,73488,25183,48305,2,100,200
NearestNeighborAny_start137,TSPA,73194,25404,47790,2,100,200
NearestNeighborAny_start138,TSPA,72959,25090,47869,2,100,200
NearestNeighborAny_start139,TSPA,72207,24536,47671,2,100,200
NearestNeighborAny_start140,TSPA,73503,25775,47728,2,100,200
NearestNeighborAny_start141,TSPA,73555,24896,48659,3,100,200
NearestNeighborAny_start142,TSPA,73806,25062,48744,2,100,200
NearestNeighborAny_start143,TSPA,73503,25775,47728,2,100,200
NearestNeighborAny_start144,TSPA,72169,24300,47869,2,100,200
NearestNeighborAny_start145,TSPA,73697,25894,47803,2,100,200
NearestNeighborAny_start146,TSPA,72077,24115,47962,2,100,200
NearestNeighborAny_start147,TSPA,74903,26287,48616,2,100,200
NearestNeighborAny_start148,TSPA,72169,24300,47869,2,100,200
NearestNeighborAny_start149,TSPA,72804,25133,47671,1,100,200
NearestNeighborAny_start150,TSPA,74512,25868,48644,1,100,200
NearestNeighborAny_start151,TSPA,71179,23434,47745,2,100,200
NearestNeighborAny_start152,TSPA,73581,25778,47803,2,100,200
NearestNeighborAny_start153,TSPA,73785,25746,48039,3,100,200
NearestNeighborAny_start154,TSPA,73024,25114,47910,2,100,200
NearestNeighborAny_start155,TSPA,72897,24307,48590,2,100,200
NearestNeighborAny_start156,TSPA,73011,24501,48510,2,100,200
NearestNeighborAny_start157,TSPA,74358,24942,49416,3,100,200
NearestNeighborAny_start158,TSPA,73108,25068,48040,2,100,200
NearestNeighborAny_start159,TSPA,72207,24536,47671,2,100,200
NearestNeighborAny_start160,TSPA,72779,25003,47776,3,100,200
NearestNeighborAny_start161,TSPA,72530,24116,48414,2,100,200
NearestNeighborAny_start162,TSPA,71901,24230,47671,3,100,200
NearestNeighborAny_start163,TSPA,73087,24779,48308,2,100,200
NearestNeighborAny_start164,TSPA,72836,25354,47482,3,100,200
NearestNeighborAny_start165,TSPA,72866,25076,47790,1,100,200
NearestNeighborAny_start166,TSPA,72860,24464,48396,1,100,200
NearestNeighborAny_start167,TSPA,73451,25644,47807,3,100,200
NearestNeighborAny_start168,TSPA,72981,23536,49445,2,100,200
NearestNeighborAny_start169,TSPA,74703,26466,48237,2,100,200
NearestNeighborAny_start170,TSPA,73778,25676,48102,2,100,200
NearestNeighborAny_start171,TSPA,74335,26520,47815,2,100,200
NearestNeighborAny_start172,TSPA,73989,25366,48623,2,100,200
NearestNeighborAny_start173,TSPA,73818,25131,48687,2,100,200
NearestNeighborAny_start174,TSPA,72585,24067,48518,2,100,200
NearestNeighborAny_start175,TSPA,74335,26520,47815,3,100,200
NearestNeighborAny_start176,TSPA,72545,24755,47790,2,100,200
NearestNeighborAny_start177,TSPA,73781,26071,47710,2,100,200
NearestNeighborAny_start178,TSPA,72866,25076,47790,2,100,200
NearestNeighborAny_start179,TSPA,73697,25894,47803,3,100,200
NearestNeighborAny_start180,TSPA,73024,25114,47910,2,100,200
NearestNeighborAny_start181,TSPA,72746,25075,47671,2,100,200
NearestNeighborAny_start182,TSPA,73511,25181,48330,2,100,200
NearestNeighborAny_start183,TSPA,73503,25775,47728,1,100,200
NearestNeighborAny_start184,TSPA,72779,25003,47776,2,100,200
NearestNeighborAny_start185,TSPA,72866,25076,47790,2,100,200
NearestNeighborAny_start186,TSPA,73194,25404,47790,2,100,200
NearestNeighborAny_start187,TSPA,72372,23935,48437,2,100,200
NearestNeighborAny_start188,TSPA,75386,26554,48832,2,100,200
NearestNeighborAny_start189,TSPA,73245,25071,48174,2,100,200
NearestNeighborAny_start190,TSPA,74015,26344,47671,1,100,200
NearestNeighborAny_start191,TSPA,72723,24455,48268,2,100,200
NearestNeighborAny_start192,TSPA,73845,25327,48518,2,100,200
NearestNeighborAny_start193,TSPA,72207,24536,47671,2,100,200
NearestNeighborAny_start194,TSPA,73424,25199,48225,2,100,200
NearestNeighborAny_start195,TSPA,72289,24449,47840,2,100,200
NearestNeighborAny_start196,TSPA,73704,24653,49051,2,100,200
NearestNeighborAny_start197,TSPA,71925,23403,48522,2,100,200
NearestNeighborAny_start198,TSPA,72476,24335,48141,1,100,200
NearestNeighborAny_start199,TSPA,72457,24455,48002,2,100,200
