algorithm,instance,objective_value,path_length,node_costs,computation_time_ms,selected_nodes,total_nodes
RandomSolution_start0,TSPB,220010,166789,53221,0,100,200
RandomSolution_start1,TSPB,203068,157708,45360,0,100,200
RandomSolution_start2,TSPB,227210,175238,51972,0,100,200
RandomSolution_start3,TSPB,202083,151377,50706,0,100,200
RandomSolution_start4,TSPB,217451,166287,51164,0,100,200
RandomSolution_start5,TSPB,188500,144700,43800,0,100,200
RandomSolution_start6,TSPB,212012,165785,46227,0,100,200
RandomSolution_start7,TSPB,219564,174662,44902,0,100,200
RandomSolution_start8,TSPB,224656,169753,54903,0,100,200
RandomSolution_start9,TSPB,214659,167410,47249,0,100,200
RandomSolution_start10,TSPB,209465,161905,47560,0,100,200
RandomSolution_start11,TSPB,211487,163977,47510,0,100,200
RandomSolution_start12,TSPB,226123,179878,46245,0,100,200
RandomSolution_start13,TSPB,214865,165501,49364,0,100,200
RandomSolution_start14,TSPB,216241,169137,47104,0,100,200
RandomSolution_start15,TSPB,217751,168536,49215,0,100,200
RandomSolution_start16,TSPB,206126,160067,46059,0,100,200
RandomSolution_start17,TSPB,217483,169196,48287,0,100,200
RandomSolution_start18,TSPB,194909,149739,45170,0,100,200
RandomSolution_start19,TSPB,219517,166235,53282,0,100,200
RandomSolution_start20,TSPB,205120,157698,47422,0,100,200
RandomSolution_start21,TSPB,206554,157370,49184,0,100,200
RandomSolution_start22,TSPB,202953,159829,43124,1,100,200
RandomSolution_start23,TSPB,210430,163004,47426,0,100,200
RandomSolution_start24,TSPB,215519,162825,52694,0,100,200
RandomSolution_start25,TSPB,217029,167652,49377,0,100,200
RandomSolution_start26,TSPB,222343,172557,49786,0,100,200
RandomSolution_start27,TSPB,227496,177952,49544,0,100,200
RandomSolution_start28,TSPB,220292,171410,48882,0,100,200
RandomSolution_start29,TSPB,212275,164610,47665,0,100,200
RandomSolution_start30,TSPB,201798,153197,48601,0,100,200
RandomSolution_start31,TSPB,198897,150567,48330,0,100,200
RandomSolution_start32,TSPB,213837,164881,48956,0,100,200
RandomSolution_start33,TSPB,215234,167547,47687,0,100,200
RandomSolution_start34,TSPB,207674,158795,48879,0,100,200
RandomSolution_start35,TSPB,209727,159910,49817,0,100,200
RandomSolution_start36,TSPB,207024,162152,44872,0,100,200
RandomSolution_start37,TSPB,211753,159940,51813,0,100,200
RandomSolution_start38,TSPB,217268,166995,50273,0,100,200
RandomSolution_start39,TSPB,225503,173641,51862,0,100,200
RandomSolution_start40,TSPB,218766,170436,48330,0,100,200
RandomSolution_start41,TSPB,232228,179806,52422,0,100,200
RandomSolution_start42,TSPB,218343,170033,48310,0,100,200
RandomSolution_start43,TSPB,207900,159879,48021,0,100,200
RandomSolution_start44,TSPB,222713,173263,49450,0,100,200
RandomSolution_start45,TSPB,221270,171378,49892,0,100,200
RandomSolution_start46,TSPB,197924,149928,47996,0,100,200
RandomSolution_start47,TSPB,206742,156744,49998,0,100,200
RandomSolution_start48,TSPB,219390,170679,48711,0,100,200
RandomSolution_start49,TSPB,221555,170261,51294,0,100,200
RandomSolution_start50,TSPB,211743,158751,52992,0,100,200
RandomSolution_start51,TSPB,191050,145321,45729,0,100,200
RandomSolution_start52,TSPB,204134,153202,50932,0,100,200
RandomSolution_start53,TSPB,199491,148506,50985,0,100,200
RandomSolution_start54,TSPB,203637,154350,49287,0,100,200
RandomSolution_start55,TSPB,224306,175589,48717,1,100,200
RandomSolution_start56,TSPB,225396,178760,46636,0,100,200
RandomSolution_start57,TSPB,231828,179680,52148,0,100,200
RandomSolution_start58,TSPB,217093,166472,50621,0,100,200
RandomSolution_start59,TSPB,222317,171198,51119,0,100,200
RandomSolution_start60,TSPB,218232,169442,48790,0,100,200
RandomSolution_start61,TSPB,218624,168123,50501,0,100,200
RandomSolution_start62,TSPB,223575,176705,46870,0,100,200
RandomSolution_start63,TSPB,223888,172836,51052,0,100,200
RandomSolution_start64,TSPB,217922,167966,49956,0,100,200
RandomSolution_start65,TSPB,212013,162942,49071,0,100,200
RandomSolution_start66,TSPB,225356,177278,48078,0,100,200
RandomSolution_start67,TSPB,207236,156701,50535,0,100,200
RandomSolution_start68,TSPB,197494,148695,48799,0,100,200
RandomSolution_start69,TSPB,225729,174185,51544,0,100,200
RandomSolution_start70,TSPB,210755,158479,52276,0,100,200
RandomSolution_start71,TSPB,225283,172634,52649,0,100,200
RandomSolution_start72,TSPB,212004,164275,47729,0,100,200
RandomSolution_start73,TSPB,222426,172879,49547,0,100,200
RandomSolution_start74,TSPB,218143,168574,49569,0,100,200
RandomSolution_start75,TSPB,223277,174804,48473,0,100,200
RandomSolution_start76,TSPB,216288,167105,49183,0,100,200
RandomSolution_start77,TSPB,212862,162441,50421,0,100,200
RandomSolution_start78,TSPB,212237,162616,49621,0,100,200
RandomSolution_start79,TSPB,218362,166987,51375,0,100,200
RandomSolution_start80,TSPB,221294,170701,50593,0,100,200
RandomSolution_start81,TSPB,204135,155429,48706,0,100,200
RandomSolution_start82,TSPB,231919,179834,52085,0,100,200
RandomSolution_start83,TSPB,208550,163444,45106,0,100,200
RandomSolution_start84,TSPB,214286,163701,50585,0,100,200
RandomSolution_start85,TSPB,227624,177119,50505,0,100,200
RandomSolution_start86,TSPB,214257,161465,52792,0,100,200
RandomSolution_start87,TSPB,209921,160938,48983,0,100,200
RandomSolution_start88,TSPB,210434,164750,45684,0,100,200
RandomSolution_start89,TSPB,202548,155143,47405,1,100,200
RandomSolution_start90,TSPB,232129,180329,51800,0,100,200
RandomSolution_start91,TSPB,223986,174450,49536,0,100,200
RandomSolution_start92,TSPB,213741,166399,47342,0,100,200
RandomSolution_start93,TSPB,218303,170059,48244,0,100,200
RandomSolution_start94,TSPB,236008,186164,49844,0,100,200
RandomSolution_start95,TSPB,213834,165869,47965,0,100,200
RandomSolution_start96,TSPB,208710,158269,50441,0,100,200
RandomSolution_start97,TSPB,206836,158325,48511,0,100,200
RandomSolution_start98,TSPB,205406,158609,46797,0,100,200
RandomSolution_start99,TSPB,218162,165742,52420,0,100,200
RandomSolution_start100,TSPB,192916,143998,48918,0,100,200
RandomSolution_start101,TSPB,218047,169290,48757,0,100,200
RandomSolution_start102,TSPB,208262,161871,46391,0,100,200
RandomSolution_start103,TSPB,220736,170233,50503,0,100,200
RandomSolution_start104,TSPB,221339,173227,48112,0,100,200
RandomSolution_start105,TSPB,226766,178107,48659,0,100,200
RandomSolution_start106,TSPB,214165,166622,47543,0,100,200
RandomSolution_start107,TSPB,207544,159949,47595,0,100,200
RandomSolution_start108,TSPB,228729,180560,48169,0,100,200
RandomSolution_start109,TSPB,207523,153118,54405,0,100,200
RandomSolution_start110,TSPB,202581,151410,51171,0,100,200
RandomSolution_start111,TSPB,193744,148831,44913,0,100,200
RandomSolution_start112,TSPB,207415,158495,48920,0,100,200
RandomSolution_start113,TSPB,218693,168317,50376,0,100,200
RandomSolution_start114,TSPB,202126,153857,48269,0,100,200
RandomSolution_start115,TSPB,217409,168443,48966,0,100,200
RandomSolution_start116,TSPB,190842,144092,46750,0,100,200
RandomSolution_start117,TSPB,199356,148805,50551,0,100,200
RandomSolution_start118,TSPB,221722,172418,49304,0,100,200
RandomSolution_start119,TSPB,198160,150748,47412,0,100,200
RandomSolution_start120,TSPB,219237,169041,50196,0,100,200
RandomSolution_start121,TSPB,216800,167698,49102,0,100,200
RandomSolution_start122,TSPB,217795,164531,53264,1,100,200
RandomSolution_start123,TSPB,208130,159841,48289,0,100,200
RandomSolution_start124,TSPB,211023,162086,48937,0,100,200
RandomSolution_start125,TSPB,224863,171439,53424,0,100,200
RandomSolution_start126,TSPB,215713,167439,48274,0,100,200
RandomSolution_start127,TSPB,223330,171697,51633,0,100,200
RandomSolution_start128,TSPB,232989,182813,50176,0,100,200
RandomSolution_start129,TSPB,204128,154079,50049,0,100,200
RandomSolution_start130,TSPB,203098,154545,48553,0,100,200
RandomSolution_start131,TSPB,207076,157854,49222,0,100,200
RandomSolution_start132,TSPB,222741,177117,45624,0,100,200
RandomSolution_start133,TSPB,216024,169066,46958,0,100,200
RandomSolution_start134,TSPB,215685,168131,47554,0,100,200
RandomSolution_start135,TSPB,201351,150859,50492,0,100,200
RandomSolution_start136,TSPB,200298,153684,46614,0,100,200
RandomSolution_start137,TSPB,195396,146887,48509,0,100,200
RandomSolution_start138,TSPB,197150,146595,50555,0,100,200
RandomSolution_start139,TSPB,213555,167345,46210,0,100,200
RandomSolution_start140,TSPB,211376,158261,53115,0,100,200
RandomSolution_start141,TSPB,209695,163669,46026,0,100,200
RandomSolution_start142,TSPB,215233,162094,53139,0,100,200
RandomSolution_start143,TSPB,207537,156383,51154,0,100,200
RandomSolution_start144,TSPB,222861,175539,47322,0,100,200
RandomSolution_start145,TSPB,227251,178851,48400,0,100,200
RandomSolution_start146,TSPB,211614,159654,51960,0,100,200
RandomSolution_start147,TSPB,205193,157210,47983,0,100,200
RandomSolution_start148,TSPB,208926,157669,51257,0,100,200
RandomSolution_start149,TSPB,214345,166484,47861,0,100,200
RandomSolution_start150,TSPB,218419,171892,46527,0,100,200
RandomSolution_start151,TSPB,208596,161159,47437,0,100,200
RandomSolution_start152,TSPB,214019,164817,49202,1,100,200
RandomSolution_start153,TSPB,203331,154586,48745,0,100,200
RandomSolution_start154,TSPB,227026,179963,47063,0,100,200
RandomSolution_start155,TSPB,217305,165214,52091,0,100,200
RandomSolution_start156,TSPB,211568,162395,49173,0,100,200
RandomSolution_start157,TSPB,195872,146697,49175,0,100,200
RandomSolution_start158,TSPB,209034,162191,46843,0,100,200
RandomSolution_start159,TSPB,200043,150960,49083,0,100,200
RandomSolution_start160,TSPB,204871,157507,47364,0,100,200
RandomSolution_start161,TSPB,210195,156909,53286,0,100,200
RandomSolution_start162,TSPB,206446,160636,45810,0,100,200
RandomSolution_start163,TSPB,211140,161648,49492,0,100,200
RandomSolution_start164,TSPB,209927,159502,50425,0,100,200
RandomSolution_start165,TSPB,213474,163353,50121,0,100,200
RandomSolution_start166,TSPB,202933,152862,50071,0,100,200
RandomSolution_start167,TSPB,212683,161247,51436,0,100,200
RandomSolution_start168,TSPB,213344,162060,51284,0,100,200
RandomSolution_start169,TSPB,208354,158571,49783,0,100,200
RandomSolution_start170,TSPB,197935,146354,51581,0,100,200
RandomSolution_start171,TSPB,203575,153257,50318,0,100,200
RandomSolution_start172,TSPB,214829,164800,50029,0,100,200
RandomSolution_start173,TSPB,205648,158048,47600,0,100,200
RandomSolution_start174,TSPB,211678,163674,48004,0,100,200
RandomSolution_start175,TSPB,194067,147886,46181,0,100,200
RandomSolution_start176,TSPB,208591,159790,48801,0,100,200
RandomSolution_start177,TSPB,217358,164507,52851,0,100,200
RandomSolution_start178,TSPB,208626,160428,48198,0,100,200
RandomSolution_start179,TSPB,220464,170608,49856,0,100,200
RandomSolution_start180,TSPB,210993,158562,52431,0,100,200
RandomSolution_start181,TSPB,224300,169634,54666,0,100,200
RandomSolution_start182,TSPB,220109,169778,50331,0,100,200
RandomSolution_start183,TSPB,221409,173210,48199,0,100,200
RandomSolution_start184,TSPB,209736,161991,47745,0,100,200
RandomSolution_start185,TSPB,217362,168569,48793,0,100,200
RandomSolution_start186,TSPB,196014,147622,48392,0,100,200
RandomSolution_start187,TSPB,218494,168029,50465,0,100,200
RandomSolution_start188,TSPB,208525,160044,48481,0,100,200
RandomSolution_start189,TSPB,216145,164605,51540,0,100,200
RandomSolution_start190,TSPB,211211,162526,48685,0,100,200
RandomSolution_start191,TSPB,214632,168089,46543,0,100,200
RandomSolution_start192,TSPB,210224,161502,48722,0,100,200
RandomSolution_start193,TSPB,202848,149062,53786,0,100,200
RandomSolution_start194,TSPB,197608,149878,47730,0,100,200
RandomSolution_start195,TSPB,210593,162950,47643,0,100,200
RandomSolution_start196,TSPB,202816,151571,51245,0,100,200
RandomSolution_start197,TSPB,207987,158915,49072,0,100,200
RandomSolution_start198,TSPB,207070,156604,50466,0,100,200
RandomSolution_start199,TSPB,211323,158914,52409,0,100,200
GreedyCycle_start0,TSPB,50243,20579,29664,2,100,200
GreedyCycle_start1,TSPB,52933,20350,32583,2,100,200
GreedyCycle_start2,TSPB,49617,20111,29506,1,100,200
GreedyCycle_start3,TSPB,52260,19636,32624,2,100,200
GreedyCycle_start4,TSPB,51849,19333,32516,2,100,200
GreedyCycle_start5,TSPB,49394,21169,28225,2,100,200
GreedyCycle_start6,TSPB,49413,20201,29212,1,100,200
GreedyCycle_start7,TSPB,49836,21178,28658,2,100,200
GreedyCycle_start8,TSPB,50141,20317,29824,2,100,200
GreedyCycle_start9,TSPB,51895,19379,32516,2,100,200
GreedyCycle_start10,TSPB,52665,20954,31711,2,100,200
GreedyCycle_start11,TSPB,50243,20579,29664,2,100,200
GreedyCycle_start12,TSPB,50536,20334,30202,1,100,200
GreedyCycle_start13,TSPB,49413,20201,29212,2,100,200
GreedyCycle_start14,TSPB,50618,20029,30589,2,100,200
GreedyCycle_start15,TSPB,52260,19636,32624,1,100,200
GreedyCycle_start16,TSPB,52985,20415,32570,2,100,200
GreedyCycle_start17,TSPB,57324,19155,38169,2,100,200
GreedyCycle_start18,TSPB,52079,20966,31113,2,100,200
GreedyCycle_start19,TSPB,53026,20443,32583,2,100,200
GreedyCycle_start20,TSPB,52247,19655,32592,1,100,200
GreedyCycle_start21,TSPB,49402,21177,28225,2,100,200
GreedyCycle_start22,TSPB,51149,19545,31604,2,100,200
GreedyCycle_start23,TSPB,52340,19657,32683,1,100,200
GreedyCycle_start24,TSPB,53294,20354,32940,2,100,200
GreedyCycle_start25,TSPB,49678,21453,28225,2,100,200
GreedyCycle_start26,TSPB,50970,19366,31604,2,100,200
GreedyCycle_start27,TSPB,53047,20477,32570,1,100,200
GreedyCycle_start28,TSPB,51849,19333,32516,2,100,200
GreedyCycle_start29,TSPB,50243,20579,29664,2,100,200
GreedyCycle_start30,TSPB,51895,21411,30484,1,100,200
GreedyCycle_start31,TSPB,50608,21253,29355,2,100,200
GreedyCycle_start32,TSPB,52694,20918,31776,2,100,200
GreedyCycle_start33,TSPB,50243,20579,29664,2,100,200
GreedyCycle_start34,TSPB,50997,21068,29929,1,100,200
GreedyCycle_start35,TSPB,50243,20579,29664,2,100,200
GreedyCycle_start36,TSPB,50392,20568,29824,2,100,200
GreedyCycle_start37,TSPB,50760,20139,30621,1,100,200
GreedyCycle_start38,TSPB,52985,20415,32570,2,100,200
GreedyCycle_start39,TSPB,50690,20490,30200,2,100,200
GreedyCycle_start40,TSPB,57140,18971,38169,1,100,200
GreedyCycle_start41,TSPB,50583,20128,30455,3,100,200
GreedyCycle_start42,TSPB,51793,21572,30221,1,100,200
GreedyCycle_start43,TSPB,50042,20218,29824,3,100,200
GreedyCycle_start44,TSPB,52997,20470,32527,2,100,200
GreedyCycle_start45,TSPB,49394,21169,28225,2,100,200
GreedyCycle_start46,TSPB,51188,20942,30246,2,100,200
GreedyCycle_start47,TSPB,52250,19658,32592,3,100,200
GreedyCycle_start48,TSPB,51892,19810,32082,2,100,200
GreedyCycle_start49,TSPB,50057,20233,29824,6,100,200
GreedyCycle_start50,TSPB,50735,20152,30583,2,100,200
GreedyCycle_start51,TSPB,52665,20954,31711,2,100,200
GreedyCycle_start52,TSPB,50970,19366,31604,3,100,200
GreedyCycle_start53,TSPB,51292,18776,32516,1,100,200
GreedyCycle_start54,TSPB,50608,21253,29355,2,100,200
GreedyCycle_start55,TSPB,52079,20966,31113,2,100,200
GreedyCycle_start56,TSPB,49593,21368,28225,2,100,200
GreedyCycle_start57,TSPB,51040,19122,31918,2,100,200
GreedyCycle_start58,TSPB,49459,20677,28782,1,100,200
GreedyCycle_start59,TSPB,51849,19333,32516,3,100,200
GreedyCycle_start60,TSPB,52247,19655,32592,2,100,200
GreedyCycle_start61,TSPB,50392,20568,29824,2,100,200
GreedyCycle_start62,TSPB,52079,20966,31113,1,100,200
GreedyCycle_start63,TSPB,52665,20954,31711,2,100,200
GreedyCycle_start64,TSPB,51588,19371,32217,2,100,200
GreedyCycle_start65,TSPB,52484,19736,32748,1,100,200
GreedyCycle_start66,TSPB,52250,19658,32592,2,100,200
GreedyCycle_start67,TSPB,52887,20941,31946,2,100,200
GreedyCycle_start68,TSPB,50807,20176,30631,2,100,200
GreedyCycle_start69,TSPB,51001,20836,30165,1,100,200
GreedyCycle_start70,TSPB,52260,19636,32624,2,100,200
GreedyCycle_start71,TSPB,52295,21182,31113,2,100,200
GreedyCycle_start72,TSPB,57140,18971,38169,2,100,200
GreedyCycle_start73,TSPB,50608,21253,29355,1,100,200
GreedyCycle_start74,TSPB,53407,20719,32688,2,100,200
GreedyCycle_start75,TSPB,51625,19689,31936,2,100,200
GreedyCycle_start76,TSPB,51591,19535,32056,2,100,200
GreedyCycle_start77,TSPB,50954,19350,31604,2,100,200
GreedyCycle_start78,TSPB,49394,21169,28225,1,100,200
GreedyCycle_start79,TSPB,50674,20221,30453,2,100,200
GreedyCycle_start80,TSPB,50443,21088,29355,2,100,200
GreedyCycle_start81,TSPB,50954,19350,31604,2,100,200
GreedyCycle_start82,TSPB,49402,21177,28225,4,100,200
GreedyCycle_start83,TSPB,51506,19077,32429,2,100,200
GreedyCycle_start84,TSPB,50451,20621,29830,2,100,200
GreedyCycle_start85,TSPB,49001,20856,28145,3,100,200
GreedyCycle_start86,TSPB,50970,19366,31604,2,100,200
GreedyCycle_start87,TSPB,49402,21177,28225,2,100,200
GreedyCycle_start88,TSPB,51490,19360,32130,2,100,200
GreedyCycle_start89,TSPB,50970,19366,31604,2,100,200
GreedyCycle_start90,TSPB,52727,21016,31711,2,100,200
GreedyCycle_start91,TSPB,50392,20568,29824,2,100,200
GreedyCycle_start92,TSPB,53124,20550,32574,2,100,200
GreedyCycle_start93,TSPB,52248,19450,32798,2,100,200
GreedyCycle_start94,TSPB,52250,19658,32592,2,100,200
GreedyCycle_start95,TSPB,50970,19366,31604,1,100,200
GreedyCycle_start96,TSPB,52792,20987,31805,2,100,200
GreedyCycle_start97,TSPB,50954,19350,31604,4,100,200
GreedyCycle_start98,TSPB,53066,20549,32517,3,100,200
GreedyCycle_start99,TSPB,51149,19545,31604,2,100,200
GreedyCycle_start100,TSPB,56757,19324,37433,2,100,200
GreedyCycle_start101,TSPB,52020,19310,32710,1,100,200
GreedyCycle_start102,TSPB,52727,21016,31711,2,100,200
GreedyCycle_start103,TSPB,50970,19366,31604,2,100,200
GreedyCycle_start104,TSPB,50141,20317,29824,3,100,200
GreedyCycle_start105,TSPB,54470,20155,34315,3,100,200
GreedyCycle_start106,TSPB,52079,20966,31113,4,100,200
GreedyCycle_start107,TSPB,57078,18909,38169,2,100,200
GreedyCycle_start108,TSPB,52666,21793,30873,2,100,200
GreedyCycle_start109,TSPB,50243,20579,29664,2,100,200
GreedyCycle_start110,TSPB,51614,18736,32878,1,100,200
GreedyCycle_start111,TSPB,50111,20287,29824,4,100,200
GreedyCycle_start112,TSPB,52964,20381,32583,2,100,200
GreedyCycle_start113,TSPB,50970,19366,31604,2,100,200
GreedyCycle_start114,TSPB,50879,19275,31604,2,100,200
GreedyCycle_start115,TSPB,52614,20817,31797,2,100,200
GreedyCycle_start116,TSPB,52981,20493,32488,2,100,200
GreedyCycle_start117,TSPB,50546,21191,29355,9,100,200
GreedyCycle_start118,TSPB,53066,20549,32517,2,100,200
GreedyCycle_start119,TSPB,51545,20776,30769,2,100,200
GreedyCycle_start120,TSPB,52758,20909,31849,2,100,200
GreedyCycle_start121,TSPB,53026,20443,32583,2,100,200
GreedyCycle_start122,TSPB,52727,21016,31711,2,100,200
GreedyCycle_start123,TSPB,49949,21322,28627,2,100,200
GreedyCycle_start124,TSPB,52079,20966,31113,5,100,200
GreedyCycle_start125,TSPB,52784,21073,31711,2,100,200
GreedyCycle_start126,TSPB,49891,20039,29852,2,100,200
GreedyCycle_start127,TSPB,50970,19366,31604,2,100,200
GreedyCycle_start128,TSPB,51559,18967,32592,2,100,200
GreedyCycle_start129,TSPB,51485,19307,32178,2,100,200
GreedyCycle_start130,TSPB,50970,19366,31604,3,100,200
GreedyCycle_start131,TSPB,52665,20954,31711,3,100,200
GreedyCycle_start132,TSPB,49413,20201,29212,2,100,200
GreedyCycle_start133,TSPB,52727,21016,31711,1,100,200
GreedyCycle_start134,TSPB,49413,20201,29212,2,100,200
GreedyCycle_start135,TSPB,52727,21016,31711,2,100,200
GreedyCycle_start136,TSPB,50443,21088,29355,2,100,200
GreedyCycle_start137,TSPB,50926,19322,31604,1,100,200
GreedyCycle_start138,TSPB,50243,20579,29664,2,100,200
GreedyCycle_start139,TSPB,50243,20579,29664,2,100,200
GreedyCycle_start140,TSPB,51182,18753,32429,2,100,200
GreedyCycle_start141,TSPB,50954,19350,31604,1,100,200
GreedyCycle_start142,TSPB,49394,21169,28225,2,100,200
GreedyCycle_start143,TSPB,50997,21068,29929,2,100,200
GreedyCycle_start144,TSPB,50425,20601,29824,1,100,200
GreedyCycle_start145,TSPB,52260,19636,32624,2,100,200
GreedyCycle_start146,TSPB,50954,19350,31604,2,100,200
GreedyCycle_start147,TSPB,52258,21145,31113,1,100,200
GreedyCycle_start148,TSPB,52250,19658,32592,2,100,200
GreedyCycle_start149,TSPB,51849,19333,32516,2,100,200
GreedyCycle_start150,TSPB,51642,19396,32246,2,100,200
GreedyCycle_start151,TSPB,52933,20350,32583,1,100,200
GreedyCycle_start152,TSPB,51182,18753,32429,1,100,200
GreedyCycle_start153,TSPB,50954,19350,31604,2,100,200
GreedyCycle_start154,TSPB,52250,19658,32592,2,100,200
GreedyCycle_start155,TSPB,50251,20587,29664,2,100,200
GreedyCycle_start156,TSPB,52995,20412,32583,1,100,200
GreedyCycle_start157,TSPB,50611,20086,30525,2,100,200
GreedyCycle_start158,TSPB,49584,22177,27407,2,100,200
GreedyCycle_start159,TSPB,50997,21068,29929,2,100,200
GreedyCycle_start160,TSPB,50243,20579,29664,1,100,200
GreedyCycle_start161,TSPB,52260,19636,32624,2,100,200
GreedyCycle_start162,TSPB,50443,21088,29355,2,100,200
GreedyCycle_start163,TSPB,50970,19366,31604,1,100,200
GreedyCycle_start164,TSPB,50608,21253,29355,2,100,200
GreedyCycle_start165,TSPB,51109,19505,31604,2,100,200
GreedyCycle_start166,TSPB,50970,19366,31604,1,100,200
GreedyCycle_start167,TSPB,50559,20636,29923,2,100,200
GreedyCycle_start168,TSPB,49413,20201,29212,2,100,200
GreedyCycle_start169,TSPB,49413,20201,29212,2,100,200
GreedyCycle_start170,TSPB,51099,21170,29929,1,100,200
GreedyCycle_start171,TSPB,49641,20782,28859,2,100,200
GreedyCycle_start172,TSPB,50970,19366,31604,2,100,200
GreedyCycle_start173,TSPB,50807,20322,30485,1,100,200
GreedyCycle_start174,TSPB,51403,18912,32491,2,100,200
GreedyCycle_start175,TSPB,49394,21169,28225,2,100,200
GreedyCycle_start176,TSPB,50970,19366,31604,2,100,200
GreedyCycle_start177,TSPB,49394,21169,28225,2,100,200
GreedyCycle_start178,TSPB,52727,21016,31711,2,100,200
GreedyCycle_start179,TSPB,50970,19366,31604,1,100,200
GreedyCycle_start180,TSPB,50970,19366,31604,2,100,200
GreedyCycle_start181,TSPB,51728,19068,32660,2,100,200
GreedyCycle_start182,TSPB,50243,20579,29664,2,100,200
GreedyCycle_start183,TSPB,51182,18753,32429,1,100,200
GreedyCycle_start184,TSPB,51221,21406,29815,2,100,200
GreedyCycle_start185,TSPB,50970,19366,31604,2,100,200
GreedyCycle_start186,TSPB,51534,19292,32242,2,100,200
GreedyCycle_start187,TSPB,50954,19350,31604,1,100,200
GreedyCycle_start188,TSPB,49413,20201,29212,2,100,200
GreedyCycle_start189,TSPB,50043,20932,29111,2,100,200
GreedyCycle_start190,TSPB,50443,21088,29355,2,100,200
GreedyCycle_start191,TSPB,52665,20954,31711,2,100,200
GreedyCycle_start192,TSPB,51626,19392,32234,1,100,200
GreedyCycle_start193,TSPB,50608,21253,29355,2,100,200
GreedyCycle_start194,TSPB,50970,19366,31604,2,100,200
GreedyCycle_start195,TSPB,49413,20201,29212,2,100,200
GreedyCycle_start196,TSPB,52611,21451,31160,1,100,200
GreedyCycle_start197,TSPB,53314,20367,32947,2,100,200
GreedyCycle_start198,TSPB,50549,21194,29355,2,100,200
GreedyCycle_start199,TSPB,52247,19655,32592,1,100,200
NearestNeighborEnd_start0,TSPB,55374,28259,27115,0,100,200
NearestNeighborEnd_start1,TSPB,52584,27231,25353,0,100,200
NearestNeighborEnd_start2,TSPB,54369,25952,28417,1,100,200
NearestNeighborEnd_start3,TSPB,53796,25603,28193,0,100,200
NearestNeighborEnd_start4,TSPB,55335,27047,28288,0,100,200
NearestNeighborEnd_start5,TSPB,54997,27145,27852,1,100,200
NearestNeighborEnd_start6,TSPB,55492,28416,27076,0,100,200
NearestNeighborEnd_start7,TSPB,54592,27008,27584,0,100,200
NearestNeighborEnd_start8,TSPB,55937,26791,29146,1,100,200
NearestNeighborEnd_start9,TSPB,54625,26635,27990,0,100,200
NearestNeighborEnd_start10,TSPB,52543,27651,24892,0,100,200
NearestNeighborEnd_start11,TSPB,53417,27062,26355,1,100,200
NearestNeighborEnd_start12,TSPB,55436,27812,27624,0,100,200
NearestNeighborEnd_start13,TSPB,54637,26220,28417,0,100,200
NearestNeighborEnd_start14,TSPB,54085,27589,26496,1,100,200
NearestNeighborEnd_start15,TSPB,54628,26182,28446,0,100,200
NearestNeighborEnd_start16,TSPB,52319,27165,25154,0,100,200
NearestNeighborEnd_start17,TSPB,53001,27509,25492,0,100,200
NearestNeighborEnd_start18,TSPB,55232,27122,28110,1,100,200
NearestNeighborEnd_start19,TSPB,54778,27408,27370,0,100,200
NearestNeighborEnd_start20,TSPB,52915,25884,27031,0,100,200
NearestNeighborEnd_start21,TSPB,56255,27312,28943,1,100,200
NearestNeighborEnd_start22,TSPB,52703,25792,26911,0,100,200
NearestNeighborEnd_start23,TSPB,53255,26126,27129,1,100,200
NearestNeighborEnd_start24,TSPB,53085,27147,25938,0,100,200
NearestNeighborEnd_start25,TSPB,54829,26421,28408,0,100,200
NearestNeighborEnd_start26,TSPB,55766,28862,26904,0,100,200
NearestNeighborEnd_start27,TSPB,53306,27576,25730,1,100,200
NearestNeighborEnd_start28,TSPB,53083,25867,27216,0,100,200
NearestNeighborEnd_start29,TSPB,55210,28095,27115,0,100,200
NearestNeighborEnd_start30,TSPB,52983,27035,25948,1,100,200
NearestNeighborEnd_start31,TSPB,53381,27933,25448,0,100,200
NearestNeighborEnd_start32,TSPB,53008,26910,26098,0,100,200
NearestNeighborEnd_start33,TSPB,53527,27468,26059,1,100,200
NearestNeighborEnd_start34,TSPB,59030,28904,30126,0,100,200
NearestNeighborEnd_start35,TSPB,55417,28302,27115,0,100,200
NearestNeighborEnd_start36,TSPB,52756,27946,24810,1,100,200
NearestNeighborEnd_start37,TSPB,55806,28123,27683,0,100,200
NearestNeighborEnd_start38,TSPB,53038,27353,25685,0,100,200
NearestNeighborEnd_start39,TSPB,55314,27692,27622,1,100,200
NearestNeighborEnd_start40,TSPB,52893,27503,25390,0,100,200
NearestNeighborEnd_start41,TSPB,55825,28308,27517,0,100,200
NearestNeighborEnd_start42,TSPB,53159,27474,25685,1,100,200
NearestNeighborEnd_start43,TSPB,54620,27410,27210,0,100,200
NearestNeighborEnd_start44,TSPB,52993,27725,25268,0,100,200
NearestNeighborEnd_start45,TSPB,55165,27218,27947,0,100,200
NearestNeighborEnd_start46,TSPB,53649,25872,27777,1,100,200
NearestNeighborEnd_start47,TSPB,58125,29029,29096,0,100,200
NearestNeighborEnd_start48,TSPB,56010,28585,27425,0,100,200
NearestNeighborEnd_start49,TSPB,53423,27401,26022,1,100,200
NearestNeighborEnd_start50,TSPB,53971,27481,26490,0,100,200
NearestNeighborEnd_start51,TSPB,54400,27408,26992,0,100,200
NearestNeighborEnd_start52,TSPB,52612,25446,27166,1,100,200
NearestNeighborEnd_start53,TSPB,53962,25791,28171,0,100,200
NearestNeighborEnd_start54,TSPB,53334,27886,25448,0,100,200
NearestNeighborEnd_start55,TSPB,53739,28975,24764,0,100,200
NearestNeighborEnd_start56,TSPB,56145,26804,29341,1,100,200
NearestNeighborEnd_start57,TSPB,56238,30750,25488,0,100,200
NearestNeighborEnd_start58,TSPB,53867,27415,26452,0,100,200
NearestNeighborEnd_start59,TSPB,52858,25686,27172,1,100,200
NearestNeighborEnd_start60,TSPB,53042,26193,26849,0,100,200
NearestNeighborEnd_start61,TSPB,53914,26752,27162,0,100,200
NearestNeighborEnd_start62,TSPB,58259,27795,30464,1,100,200
NearestNeighborEnd_start63,TSPB,52912,27364,25548,0,100,200
NearestNeighborEnd_start64,TSPB,55997,28849,27148,0,100,200
NearestNeighborEnd_start65,TSPB,53855,25462,28393,0,100,200
NearestNeighborEnd_start66,TSPB,57663,28964,28699,1,100,200
NearestNeighborEnd_start67,TSPB,53809,27850,25959,0,100,200
NearestNeighborEnd_start68,TSPB,56408,26802,29606,0,100,200
NearestNeighborEnd_start69,TSPB,55864,28277,27587,1,100,200
NearestNeighborEnd_start70,TSPB,54206,27341,26865,0,100,200
NearestNeighborEnd_start71,TSPB,53606,27796,25810,0,100,200
NearestNeighborEnd_start72,TSPB,52893,27502,25391,1,100,200
NearestNeighborEnd_start73,TSPB,52595,27001,25594,0,100,200
NearestNeighborEnd_start74,TSPB,54572,27248,27324,0,100,200
NearestNeighborEnd_start75,TSPB,54406,28497,25909,1,100,200
NearestNeighborEnd_start76,TSPB,56502,29515,26987,0,100,200
NearestNeighborEnd_start77,TSPB,53689,27416,26273,0,100,200
NearestNeighborEnd_start78,TSPB,55030,27178,27852,0,100,200
NearestNeighborEnd_start79,TSPB,53049,27836,25213,1,100,200
NearestNeighborEnd_start80,TSPB,53151,25952,27199,0,100,200
NearestNeighborEnd_start81,TSPB,53647,27692,25955,0,100,200
NearestNeighborEnd_start82,TSPB,56090,27065,29025,1,100,200
NearestNeighborEnd_start83,TSPB,54519,26591,27928,0,100,200
NearestNeighborEnd_start84,TSPB,54381,26022,28359,0,100,200
NearestNeighborEnd_start85,TSPB,55431,27806,27625,1,100,200
NearestNeighborEnd_start86,TSPB,56949,28494,28455,0,100,200
NearestNeighborEnd_start87,TSPB,56070,27009,29061,0,100,200
NearestNeighborEnd_start88,TSPB,55898,28837,27061,1,100,200
NearestNeighborEnd_start89,TSPB,54333,27926,26407,0,100,200
NearestNeighborEnd_start90,TSPB,52845,27455,25390,0,100,200
NearestNeighborEnd_start91,TSPB,52867,27915,24952,1,100,200
NearestNeighborEnd_start92,TSPB,53233,27038,26195,0,100,200
NearestNeighborEnd_start93,TSPB,56734,29202,27532,0,100,200
NearestNeighborEnd_start94,TSPB,58049,28953,29096,0,100,200
NearestNeighborEnd_start95,TSPB,52592,25514,27078,1,100,200
NearestNeighborEnd_start96,TSPB,53069,26942,26127,0,100,200
NearestNeighborEnd_start97,TSPB,53853,27673,26180,0,100,200
NearestNeighborEnd_start98,TSPB,54683,27308,27375,1,100,200
NearestNeighborEnd_start99,TSPB,52776,25865,26911,0,100,200
NearestNeighborEnd_start100,TSPB,52824,27537,25287,0,100,200
NearestNeighborEnd_start101,TSPB,53072,25569,27503,1,100,200
NearestNeighborEnd_start102,TSPB,52982,26949,26033,0,100,200
NearestNeighborEnd_start103,TSPB,55426,28903,26523,0,100,200
NearestNeighborEnd_start104,TSPB,55903,26878,29025,0,100,200
NearestNeighborEnd_start105,TSPB,53576,25866,27710,1,100,200
NearestNeighborEnd_start106,TSPB,56723,27753,28970,0,100,200
NearestNeighborEnd_start107,TSPB,52856,27466,25390,0,100,200
NearestNeighborEnd_start108,TSPB,54350,26829,27521,1,100,200
NearestNeighborEnd_start109,TSPB,55438,28323,27115,0,100,200
NearestNeighborEnd_start110,TSPB,57471,28496,28975,0,100,200
NearestNeighborEnd_start111,TSPB,52951,27639,25312,1,100,200
NearestNeighborEnd_start112,TSPB,54633,27293,27340,0,100,200
NearestNeighborEnd_start113,TSPB,55851,29383,26468,0,100,200
NearestNeighborEnd_start114,TSPB,55770,29168,26602,0,100,200
NearestNeighborEnd_start115,TSPB,53557,27694,25863,1,100,200
NearestNeighborEnd_start116,TSPB,54657,27171,27486,0,100,200
NearestNeighborEnd_start117,TSPB,53336,27888,25448,0,100,200
NearestNeighborEnd_start118,TSPB,54507,27238,27269,1,100,200
NearestNeighborEnd_start119,TSPB,56515,27274,29241,0,100,200
NearestNeighborEnd_start120,TSPB,53712,27850,25862,0,100,200
NearestNeighborEnd_start121,TSPB,54767,27844,26923,1,100,200
NearestNeighborEnd_start122,TSPB,52653,27586,25067,0,100,200
NearestNeighborEnd_start123,TSPB,54470,26917,27553,0,100,200
NearestNeighborEnd_start124,TSPB,56865,27895,28970,1,100,200
NearestNeighborEnd_start125,TSPB,53384,27660,25724,0,100,200
NearestNeighborEnd_start126,TSPB,54635,27684,26951,0,100,200
NearestNeighborEnd_start127,TSPB,53717,27751,25966,0,100,200
NearestNeighborEnd_start128,TSPB,58056,27897,30159,1,100,200
NearestNeighborEnd_start129,TSPB,55874,28765,27109,0,100,200
NearestNeighborEnd_start130,TSPB,52874,25963,26911,0,100,200
NearestNeighborEnd_start131,TSPB,54786,27753,27033,1,100,200
NearestNeighborEnd_start132,TSPB,53792,25599,28193,0,100,200
NearestNeighborEnd_start133,TSPB,52853,27786,25067,0,100,200
NearestNeighborEnd_start134,TSPB,55382,27757,27625,0,100,200
NearestNeighborEnd_start135,TSPB,52886,27338,25548,1,100,200
NearestNeighborEnd_start136,TSPB,54927,28004,26923,0,100,200
NearestNeighborEnd_start137,TSPB,53882,27973,25909,0,100,200
NearestNeighborEnd_start138,TSPB,54974,27419,27555,1,100,200
NearestNeighborEnd_start139,TSPB,54369,28091,26278,0,100,200
NearestNeighborEnd_start140,TSPB,55111,26823,28288,1,100,200
NearestNeighborEnd_start141,TSPB,52960,28150,24810,0,100,200
NearestNeighborEnd_start142,TSPB,55197,27180,28017,0,100,200
NearestNeighborEnd_start143,TSPB,55921,27194,28727,0,100,200
NearestNeighborEnd_start144,TSPB,53282,27478,25804,1,100,200
NearestNeighborEnd_start145,TSPB,53934,25741,28193,0,100,200
NearestNeighborEnd_start146,TSPB,55392,26627,28765,0,100,200
NearestNeighborEnd_start147,TSPB,52969,27965,25004,1,100,200
NearestNeighborEnd_start148,TSPB,53140,26291,26849,0,100,200
NearestNeighborEnd_start149,TSPB,52923,25575,27348,0,100,200
NearestNeighborEnd_start150,TSPB,53690,28163,25527,1,100,200
NearestNeighborEnd_start151,TSPB,52638,26856,25782,0,100,200
NearestNeighborEnd_start152,TSPB,54645,26357,28288,0,100,200
NearestNeighborEnd_start153,TSPB,55159,26394,28765,0,100,200
NearestNeighborEnd_start154,TSPB,57975,28879,29096,0,100,200
NearestNeighborEnd_start155,TSPB,54922,26925,27997,0,100,200
NearestNeighborEnd_start156,TSPB,52804,27192,25612,0,100,200
NearestNeighborEnd_start157,TSPB,54084,27910,26174,1,100,200
NearestNeighborEnd_start158,TSPB,54579,27158,27421,0,100,200
NearestNeighborEnd_start159,TSPB,56260,27192,29068,0,100,200
NearestNeighborEnd_start160,TSPB,53088,27349,25739,0,100,200
NearestNeighborEnd_start161,TSPB,54567,27086,27481,0,100,200
NearestNeighborEnd_start162,TSPB,53284,25843,27441,0,100,200
NearestNeighborEnd_start163,TSPB,53497,27531,25966,0,100,200
NearestNeighborEnd_start164,TSPB,52784,26988,25796,0,100,200
NearestNeighborEnd_start165,TSPB,53695,27539,26156,1,100,200
NearestNeighborEnd_start166,TSPB,56154,29166,26988,0,100,200
NearestNeighborEnd_start167,TSPB,55312,26939,28373,0,100,200
NearestNeighborEnd_start168,TSPB,54369,25952,28417,1,100,200
NearestNeighborEnd_start169,TSPB,53861,25668,28193,0,100,200
NearestNeighborEnd_start170,TSPB,53740,25838,27902,1,100,200
NearestNeighborEnd_start171,TSPB,54288,26696,27592,0,100,200
NearestNeighborEnd_start172,TSPB,52407,25469,26938,0,100,200
NearestNeighborEnd_start173,TSPB,52844,27031,25813,0,100,200
NearestNeighborEnd_start174,TSPB,54368,26222,28146,0,100,200
NearestNeighborEnd_start175,TSPB,55778,27632,28146,0,100,200
NearestNeighborEnd_start176,TSPB,55830,29362,26468,0,100,200
NearestNeighborEnd_start177,TSPB,53989,26673,27316,0,100,200
NearestNeighborEnd_start178,TSPB,53342,27565,25777,1,100,200
NearestNeighborEnd_start179,TSPB,52595,25684,26911,0,100,200
NearestNeighborEnd_start180,TSPB,55608,28752,26856,0,100,200
NearestNeighborEnd_start181,TSPB,58682,28122,30560,0,100,200
NearestNeighborEnd_start182,TSPB,54285,26855,27430,0,100,200
NearestNeighborEnd_start183,TSPB,55091,26803,28288,0,100,200
NearestNeighborEnd_start184,TSPB,55108,27108,28000,0,100,200
NearestNeighborEnd_start185,TSPB,52728,25817,26911,1,100,200
NearestNeighborEnd_start186,TSPB,55709,26291,29418,0,100,200
NearestNeighborEnd_start187,TSPB,54088,27815,26273,0,100,200
NearestNeighborEnd_start188,TSPB,53849,25656,28193,0,100,200
NearestNeighborEnd_start189,TSPB,54804,26896,27908,0,100,200
NearestNeighborEnd_start190,TSPB,53189,25990,27199,0,100,200
NearestNeighborEnd_start191,TSPB,53220,27545,25675,0,100,200
NearestNeighborEnd_start192,TSPB,53520,28005,25515,1,100,200
NearestNeighborEnd_start193,TSPB,53429,27981,25448,0,100,200
NearestNeighborEnd_start194,TSPB,56027,29039,26988,0,100,200
NearestNeighborEnd_start195,TSPB,53942,25749,28193,0,100,200
NearestNeighborEnd_start196,TSPB,53643,27547,26096,0,100,200
NearestNeighborEnd_start197,TSPB,52323,26915,25408,0,100,200
NearestNeighborEnd_start198,TSPB,52537,26961,25576,0,100,200
NearestNeighborEnd_start199,TSPB,55398,27110,28288,0,100,200
NearestNeighborAny_start0,TSPB,45371,18161,27210,1,100,200
NearestNeighborAny_start1,TSPB,44472,19667,24805,2,100,200
NearestNeighborAny_start2,TSPB,46939,19609,27330,2,100,200
NearestNeighborAny_start3,TSPB,45841,19126,26715,2,100,200
NearestNeighborAny_start4,TSPB,44446,18973,25473,2,100,200
NearestNeighborAny_start5,TSPB,44472,19667,24805,2,100,200
NearestNeighborAny_start6,TSPB,45371,18161,27210,2,100,200
NearestNeighborAny_start7,TSPB,45101,19038,26063,2,100,200
NearestNeighborAny_start8,TSPB,47851,21849,26002,2,100,200
NearestNeighborAny_start9,TSPB,47550,20413,27137,2,100,200
NearestNeighborAny_start10,TSPB,44670,19991,24679,1,100,200
NearestNeighborAny_start11,TSPB,45371,18161,27210,3,100,200
NearestNeighborAny_start12,TSPB,45611,18200,27411,1,100,200
NearestNeighborAny_start13,TSPB,45371,18161,27210,2,100,200
NearestNeighborAny_start14,TSPB,45095,19057,26038,2,100,200
NearestNeighborAny_start15,TSPB,45841,19126,26715,2,100,200
NearestNeighborAny_start16,TSPB,44472,19667,24805,2,100,200
NearestNeighborAny_start17,TSPB,44977,19732,25245,2,100,200
NearestNeighborAny_start18,TSPB,50566,18953,31613,2,100,200
NearestNeighborAny_start19,TSPB,44804,19666,25138,1,100,200
NearestNeighborAny_start20,TSPB,44446,18973,25473,2,100,200
NearestNeighborAny_start21,TSPB,47785,21676,26109,2,100,200
NearestNeighborAny_start22,TSPB,44484,19011,25473,2,100,200
NearestNeighborAny_start23,TSPB,44878,18965,25913,2,100,200
NearestNeighborAny_start24,TSPB,44682,19315,25367,2,100,200
NearestNeighborAny_start25,TSPB,51172,21049,30123,2,100,200
NearestNeighborAny_start26,TSPB,44723,18922,25801,2,100,200
NearestNeighborAny_start27,TSPB,44472,19667,24805,2,100,200
NearestNeighborAny_start28,TSPB,44446,18973,25473,2,100,200
NearestNeighborAny_start29,TSPB,45371,18161,27210,2,100,200
NearestNeighborAny_start30,TSPB,44743,19366,25377,2,100,200
NearestNeighborAny_start31,TSPB,44472,19667,24805,2,100,200
NearestNeighborAny_start32,TSPB,44830,19587,25243,2,100,200
NearestNeighborAny_start33,TSPB,45371,18161,27210,1,100,200
NearestNeighborAny_start34,TSPB,50566,18953,31613,2,100,200
NearestNeighborAny_start35,TSPB,45371,18161,27210,2,100,200
NearestNeighborAny_start36,TSPB,44446,18973,25473,2,100,200
NearestNeighborAny_start37,TSPB,48665,20179,28486,2,100,200
NearestNeighborAny_start38,TSPB,44472,19667,24805,2,100,200
NearestNeighborAny_start39,TSPB,45582,18173,27409,2,100,200
NearestNeighborAny_start40,TSPB,44683,19751,24932,2,100,200
NearestNeighborAny_start41,TSPB,48053,21900,26153,2,100,200
NearestNeighborAny_start42,TSPB,44709,19595,25114,2,100,200
NearestNeighborAny_start43,TSPB,45407,18251,27156,2,100,200
NearestNeighborAny_start44,TSPB,45034,19770,25264,3,100,200
NearestNeighborAny_start45,TSPB,44472,19667,24805,2,100,200
NearestNeighborAny_start46,TSPB,44818,19677,25141,2,100,200
NearestNeighborAny_start47,TSPB,44446,18973,25473,2,100,200
NearestNeighborAny_start48,TSPB,50606,23459,27147,2,100,200
NearestNeighborAny_start49,TSPB,45540,18318,27222,2,100,200
NearestNeighborAny_start50,TSPB,48178,21897,26281,2,100,200
NearestNeighborAny_start51,TSPB,44683,19751,24932,2,100,200
NearestNeighborAny_start52,TSPB,45035,18873,26162,2,100,200
NearestNeighborAny_start53,TSPB,47812,20773,27039,2,100,200
NearestNeighborAny_start54,TSPB,44472,19667,24805,2,100,200
NearestNeighborAny_start55,TSPB,50566,18953,31613,2,100,200
NearestNeighborAny_start56,TSPB,47991,22037,25954,2,100,200
NearestNeighborAny_start57,TSPB,44916,18893,26023,2,100,200
NearestNeighborAny_start58,TSPB,48948,22248,26700,2,100,200
NearestNeighborAny_start59,TSPB,44795,18926,25869,2,100,200
NearestNeighborAny_start60,TSPB,51462,19544,31918,2,100,200
NearestNeighborAny_start61,TSPB,44446,18973,25473,1,100,200
NearestNeighborAny_start62,TSPB,50566,18953,31613,2,100,200
NearestNeighborAny_start63,TSPB,44683,19751,24932,2,100,200
NearestNeighborAny_start64,TSPB,46180,18726,27454,2,100,200
NearestNeighborAny_start65,TSPB,45635,18209,27426,2,100,200
NearestNeighborAny_start66,TSPB,44446,18973,25473,2,100,200
NearestNeighborAny_start67,TSPB,45648,18237,27411,2,100,200
NearestNeighborAny_start68,TSPB,48214,21885,26329,2,100,200
NearestNeighborAny_start69,TSPB,46138,19138,27000,2,100,200
NearestNeighborAny_start70,TSPB,45841,19126,26715,1,100,200
NearestNeighborAny_start71,TSPB,45451,18189,27262,2,100,200
NearestNeighborAny_start72,TSPB,44866,19722,25144,2,100,200
NearestNeighborAny_start73,TSPB,44431,19626,24805,2,100,200
NearestNeighborAny_start74,TSPB,45005,19519,25486,2,100,200
NearestNeighborAny_start75,TSPB,46115,18951,27164,2,100,200
NearestNeighborAny_start76,TSPB,46253,18969,27284,2,100,200
NearestNeighborAny_start77,TSPB,44446,18973,25473,2,100,200
NearestNeighborAny_start78,TSPB,44472,19667,24805,1,100,200
NearestNeighborAny_start79,TSPB,44823,18921,25902,2,100,200
NearestNeighborAny_start80,TSPB,44472,19667,24805,2,100,200
NearestNeighborAny_start81,TSPB,44446,18973,25473,2,100,200
NearestNeighborAny_start82,TSPB,48377,22444,25933,2,100,200
NearestNeighborAny_start83,TSPB,50589,18976,31613,2,100,200
NearestNeighborAny_start84,TSPB,47703,20742,26961,2,100,200
NearestNeighborAny_start85,TSPB,45689,18403,27286,2,100,200
NearestNeighborAny_start86,TSPB,44446,18973,25473,2,100,200
NearestNeighborAny_start87,TSPB,47856,21670,26186,2,100,200
NearestNeighborAny_start88,TSPB,44682,19004,25678,1,100,200
NearestNeighborAny_start89,TSPB,45544,18334,27210,2,100,200
NearestNeighborAny_start90,TSPB,44746,19929,24817,2,100,200
NearestNeighborAny_start91,TSPB,44446,18973,25473,2,100,200
NearestNeighborAny_start92,TSPB,45078,19738,25340,2,100,200
NearestNeighborAny_start93,TSPB,46892,19368,27524,2,100,200
NearestNeighborAny_start94,TSPB,44446,18973,25473,2,100,200
NearestNeighborAny_start95,TSPB,45317,19485,25832,2,100,200
NearestNeighborAny_start96,TSPB,44866,19594,25272,1,100,200
NearestNeighborAny_start97,TSPB,44743,19021,25722,2,100,200
NearestNeighborAny_start98,TSPB,44834,19379,25455,2,100,200
NearestNeighborAny_start99,TSPB,45317,19485,25832,2,100,200
NearestNeighborAny_start100,TSPB,44683,19751,24932,2,100,200
NearestNeighborAny_start101,TSPB,44949,18925,26024,2,100,200
NearestNeighborAny_start102,TSPB,44801,19623,25178,2,100,200
NearestNeighborAny_start103,TSPB,44446,18973,25473,2,100,200
NearestNeighborAny_start104,TSPB,47851,21849,26002,2,100,200
NearestNeighborAny_start105,TSPB,44826,19615,25211,2,100,200
NearestNeighborAny_start106,TSPB,50566,18953,31613,2,100,200
NearestNeighborAny_start107,TSPB,44683,19751,24932,2,100,200
NearestNeighborAny_start108,TSPB,53438,23051,30387,1,100,200
NearestNeighborAny_start109,TSPB,45371,18161,27210,2,100,200
NearestNeighborAny_start110,TSPB,51341,19052,32289,2,100,200
NearestNeighborAny_start111,TSPB,48200,20132,28068,2,100,200
NearestNeighborAny_start112,TSPB,44779,19671,25108,2,100,200
NearestNeighborAny_start113,TSPB,44446,18973,25473,2,100,200
NearestNeighborAny_start114,TSPB,45544,18334,27210,2,100,200
NearestNeighborAny_start115,TSPB,45456,20014,25442,2,100,200
NearestNeighborAny_start116,TSPB,44898,19644,25254,2,100,200
NearestNeighborAny_start117,TSPB,44472,19667,24805,1,100,200
NearestNeighborAny_start118,TSPB,44915,19566,25349,2,100,200
NearestNeighborAny_start119,TSPB,48629,22074,26555,2,100,200
NearestNeighborAny_start120,TSPB,44879,19637,25242,2,100,200
NearestNeighborAny_start121,TSPB,44779,19671,25108,2,100,200
NearestNeighborAny_start122,TSPB,44683,19751,24932,2,100,200
NearestNeighborAny_start123,TSPB,44931,19482,25449,2,100,200
NearestNeighborAny_start124,TSPB,50566,18953,31613,2,100,200
NearestNeighborAny_start125,TSPB,44738,19757,24981,1,100,200
NearestNeighborAny_start126,TSPB,45944,19036,26908,2,100,200
NearestNeighborAny_start127,TSPB,45544,18334,27210,2,100,200
NearestNeighborAny_start128,TSPB,50566,18953,31613,2,100,200
NearestNeighborAny_start129,TSPB,45358,19352,26006,2,100,200
NearestNeighborAny_start130,TSPB,45317,19485,25832,2,100,200
NearestNeighborAny_start131,TSPB,44836,19963,24873,2,100,200
NearestNeighborAny_start132,TSPB,45371,18161,27210,2,100,200
NearestNeighborAny_start133,TSPB,44670,19991,24679,1,100,200
NearestNeighborAny_start134,TSPB,45495,18459,27036,2,100,200
NearestNeighborAny_start135,TSPB,44683,19751,24932,2,100,200
NearestNeighborAny_start136,TSPB,44431,19626,24805,2,100,200
NearestNeighborAny_start137,TSPB,45544,18334,27210,2,100,200
NearestNeighborAny_start138,TSPB,45371,18161,27210,2,100,200
NearestNeighborAny_start139,TSPB,45371,18161,27210,2,100,200
NearestNeighborAny_start140,TSPB,47604,20834,26770,1,100,200
NearestNeighborAny_start141,TSPB,44446,18973,25473,2,100,200
NearestNeighborAny_start142,TSPB,44472,19667,24805,2,100,200
NearestNeighborAny_start143,TSPB,44546,19073,25473,2,100,200
NearestNeighborAny_start144,TSPB,47921,22068,25853,2,100,200
NearestNeighborAny_start145,TSPB,45841,19126,26715,2,100,200
NearestNeighborAny_start146,TSPB,44875,19042,25833,2,100,200
NearestNeighborAny_start147,TSPB,45371,18161,27210,2,100,200
NearestNeighborAny_start148,TSPB,44446,18973,25473,1,100,200
NearestNeighborAny_start149,TSPB,44446,18973,25473,2,100,200
NearestNeighborAny_start150,TSPB,45619,18178,27441,2,100,200
NearestNeighborAny_start151,TSPB,44717,19595,25122,2,100,200
NearestNeighborAny_start152,TSPB,47604,20834,26770,2,100,200
NearestNeighborAny_start153,TSPB,44446,18973,25473,2,100,200
NearestNeighborAny_start154,TSPB,44845,18945,25900,2,100,200
NearestNeighborAny_start155,TSPB,47404,20778,26626,2,100,200
NearestNeighborAny_start156,TSPB,44472,19667,24805,2,100,200
NearestNeighborAny_start157,TSPB,48182,21959,26223,2,100,200
NearestNeighborAny_start158,TSPB,51172,21049,30123,1,100,200
NearestNeighborAny_start159,TSPB,44861,19066,25795,2,100,200
NearestNeighborAny_start160,TSPB,45371,18161,27210,2,100,200
NearestNeighborAny_start161,TSPB,45342,18116,27226,2,100,200
NearestNeighborAny_start162,TSPB,44472,19667,24805,2,100,200
NearestNeighborAny_start163,TSPB,45544,18334,27210,2,100,200
NearestNeighborAny_start164,TSPB,44492,19267,25225,2,100,200
NearestNeighborAny_start165,TSPB,44745,19118,25627,2,100,200
NearestNeighborAny_start166,TSPB,44446,18973,25473,2,100,200
NearestNeighborAny_start167,TSPB,47799,20837,26962,1,100,200
NearestNeighborAny_start168,TSPB,45371,18161,27210,2,100,200
NearestNeighborAny_start169,TSPB,45371,18161,27210,2,100,200
NearestNeighborAny_start170,TSPB,50566,18953,31613,2,100,200
NearestNeighborAny_start171,TSPB,48577,22367,26210,2,100,200
NearestNeighborAny_start172,TSPB,44726,19069,25657,2,100,200
NearestNeighborAny_start173,TSPB,44953,19800,25153,2,100,200
NearestNeighborAny_start174,TSPB,47686,20486,27200,2,100,200
NearestNeighborAny_start175,TSPB,44472,19667,24805,2,100,200
NearestNeighborAny_start176,TSPB,44446,18973,25473,1,100,200
NearestNeighborAny_start177,TSPB,44472,19667,24805,2,100,200
NearestNeighborAny_start178,TSPB,44869,19741,25128,2,100,200
NearestNeighborAny_start179,TSPB,44446,18973,25473,2,100,200
NearestNeighborAny_start180,TSPB,44446,18973,25473,2,100,200
NearestNeighborAny_start181,TSPB,51548,19314,32234,2,100,200
NearestNeighborAny_start182,TSPB,47972,21970,26002,2,100,200
NearestNeighborAny_start183,TSPB,47604,20834,26770,2,100,200
NearestNeighborAny_start184,TSPB,47404,20778,26626,2,100,200
NearestNeighborAny_start185,TSPB,44446,18973,25473,2,100,200
NearestNeighborAny_start186,TSPB,44818,18609,26209,2,100,200
NearestNeighborAny_start187,TSPB,44446,18973,25473,1,100,200
NearestNeighborAny_start188,TSPB,45371,18161,27210,2,100,200
NearestNeighborAny_start189,TSPB,46027,19349,26678,2,100,200
NearestNeighborAny_start190,TSPB,44472,19667,24805,2,100,200
NearestNeighborAny_start191,TSPB,44746,19929,24817,2,100,200
NearestNeighborAny_start192,TSPB,45592,18163,27429,2,100,200
NearestNeighborAny_start193,TSPB,44417,19612,24805,2,100,200
NearestNeighborAny_start194,TSPB,44446,18973,25473,1,100,200
NearestNeighborAny_start195,TSPB,45371,18161,27210,2,100,200
NearestNeighborAny_start196,TSPB,45790,19430,26360,2,100,200
NearestNeighborAny_start197,TSPB,44683,19309,25374,2,100,200
NearestNeighborAny_start198,TSPB,44472,19667,24805,2,100,200
NearestNeighborAny_start199,TSPB,44824,19087,25737,2,100,200
