algorithm,instance,objective_value,path_length,node_costs,computation_time_ms,selected_nodes,total_nodes
RandomSolution_start0,TSPB,212661,160365,52296,0,100,200
RandomSolution_start1,TSPB,198449,148149,50300,0,100,200
RandomSolution_start2,TSPB,222961,172154,50807,0,100,200
RandomSolution_start3,TSPB,213230,165315,47915,0,100,200
RandomSolution_start4,TSPB,216950,167004,49946,0,100,200
RandomSolution_start5,TSPB,207388,159630,47758,0,100,200
RandomSolution_start6,TSPB,202510,150026,52484,0,100,200
RandomSolution_start7,TSPB,226513,174921,51592,0,100,200
RandomSolution_start8,TSPB,202849,154399,48450,0,100,200
RandomSolution_start9,TSPB,208546,158530,50016,0,100,200
RandomSolution_start10,TSPB,211189,161615,49574,0,100,200
RandomSolution_start11,TSPB,213721,168355,45366,0,100,200
RandomSolution_start12,TSPB,232326,180097,52229,0,100,200
RandomSolution_start13,TSPB,219047,167871,51176,0,100,200
RandomSolution_start14,TSPB,222142,170315,51827,0,100,200
RandomSolution_start15,TSPB,216689,169134,47555,0,100,200
RandomSolution_start16,TSPB,218042,167164,50878,0,100,200
RandomSolution_start17,TSPB,211700,162854,48846,0,100,200
RandomSolution_start18,TSPB,217205,170047,47158,0,100,200
RandomSolution_start19,TSPB,218224,169819,48405,0,100,200
RandomSolution_start20,TSPB,200235,153222,47013,0,100,200
RandomSolution_start21,TSPB,213313,163265,50048,0,100,200
RandomSolution_start22,TSPB,209442,163876,45566,0,100,200
RandomSolution_start23,TSPB,209760,158614,51146,0,100,200
RandomSolution_start24,TSPB,228902,175274,53628,0,100,200
RandomSolution_start25,TSPB,214352,166007,48345,0,100,200
RandomSolution_start26,TSPB,195652,143347,52305,0,100,200
RandomSolution_start27,TSPB,205888,157142,48746,0,100,200
RandomSolution_start28,TSPB,217887,167458,50429,0,100,200
RandomSolution_start29,TSPB,212594,163268,49326,0,100,200
RandomSolution_start30,TSPB,223244,171386,51858,0,100,200
RandomSolution_start31,TSPB,197677,148439,49238,0,100,200
RandomSolution_start32,TSPB,217988,169280,48708,0,100,200
RandomSolution_start33,TSPB,223674,172911,50763,1,100,200
RandomSolution_start34,TSPB,202191,154217,47974,0,100,200
RandomSolution_start35,TSPB,207625,157996,49629,0,100,200
RandomSolution_start36,TSPB,209551,157914,51637,0,100,200
RandomSolution_start37,TSPB,216577,166971,49606,0,100,200
RandomSolution_start38,TSPB,211064,162821,48243,0,100,200
RandomSolution_start39,TSPB,214127,167039,47088,0,100,200
RandomSolution_start40,TSPB,209715,163599,46116,0,100,200
RandomSolution_start41,TSPB,224022,173072,50950,0,100,200
RandomSolution_start42,TSPB,219163,174403,44760,0,100,200
RandomSolution_start43,TSPB,211368,163605,47763,0,100,200
RandomSolution_start44,TSPB,212115,163975,48140,0,100,200
RandomSolution_start45,TSPB,201170,152361,48809,0,100,200
RandomSolution_start46,TSPB,224736,174078,50658,0,100,200
RandomSolution_start47,TSPB,194962,148392,46570,0,100,200
RandomSolution_start48,TSPB,213549,164123,49426,0,100,200
RandomSolution_start49,TSPB,210221,162695,47526,0,100,200
RandomSolution_start50,TSPB,203677,151404,52273,0,100,200
RandomSolution_start51,TSPB,223634,177268,46366,0,100,200
RandomSolution_start52,TSPB,211708,159392,52316,0,100,200
RandomSolution_start53,TSPB,203049,152380,50669,0,100,200
RandomSolution_start54,TSPB,218205,168862,49343,0,100,200
RandomSolution_start55,TSPB,207157,156572,50585,0,100,200
RandomSolution_start56,TSPB,226538,177497,49041,0,100,200
RandomSolution_start57,TSPB,200270,149490,50780,0,100,200
RandomSolution_start58,TSPB,203379,154919,48460,0,100,200
RandomSolution_start59,TSPB,200435,149982,50453,0,100,200
RandomSolution_start60,TSPB,211749,162920,48829,0,100,200
RandomSolution_start61,TSPB,199611,149811,49800,0,100,200
RandomSolution_start62,TSPB,228044,177522,50522,1,100,200
RandomSolution_start63,TSPB,218536,168456,50080,0,100,200
RandomSolution_start64,TSPB,216149,167476,48673,0,100,200
RandomSolution_start65,TSPB,202415,151376,51039,0,100,200
RandomSolution_start66,TSPB,212005,164057,47948,0,100,200
RandomSolution_start67,TSPB,209578,162283,47295,0,100,200
RandomSolution_start68,TSPB,212584,163058,49526,0,100,200
RandomSolution_start69,TSPB,217182,166811,50371,0,100,200
RandomSolution_start70,TSPB,208157,161867,46290,0,100,200
RandomSolution_start71,TSPB,209641,162665,46976,0,100,200
RandomSolution_start72,TSPB,211212,163726,47486,0,100,200
RandomSolution_start73,TSPB,215047,164564,50483,0,100,200
RandomSolution_start74,TSPB,224029,176502,47527,0,100,200
RandomSolution_start75,TSPB,212300,163557,48743,0,100,200
RandomSolution_start76,TSPB,226460,171219,55241,0,100,200
RandomSolution_start77,TSPB,220814,170545,50269,0,100,200
RandomSolution_start78,TSPB,214630,165795,48835,0,100,200
RandomSolution_start79,TSPB,218666,172219,46447,0,100,200
RandomSolution_start80,TSPB,213837,161754,52083,0,100,200
RandomSolution_start81,TSPB,205226,153274,51952,0,100,200
RandomSolution_start82,TSPB,214609,165032,49577,0,100,200
RandomSolution_start83,TSPB,214466,165110,49356,0,100,200
RandomSolution_start84,TSPB,217996,169279,48717,0,100,200
RandomSolution_start85,TSPB,216657,165252,51405,0,100,200
RandomSolution_start86,TSPB,197211,146443,50768,0,100,200
RandomSolution_start87,TSPB,234368,183459,50909,1,100,200
RandomSolution_start88,TSPB,204164,155026,49138,0,100,200
RandomSolution_start89,TSPB,213972,162040,51932,0,100,200
RandomSolution_start90,TSPB,232755,183640,49115,0,100,200
RandomSolution_start91,TSPB,198645,148492,50153,0,100,200
RandomSolution_start92,TSPB,233868,182697,51171,0,100,200
RandomSolution_start93,TSPB,219634,171318,48316,0,100,200
RandomSolution_start94,TSPB,210139,159179,50960,0,100,200
RandomSolution_start95,TSPB,214718,166103,48615,0,100,200
RandomSolution_start96,TSPB,223252,172157,51095,0,100,200
RandomSolution_start97,TSPB,205700,155699,50001,0,100,200
RandomSolution_start98,TSPB,216688,168045,48643,0,100,200
RandomSolution_start99,TSPB,218646,166552,52094,0,100,200
RandomSolution_start100,TSPB,215069,169070,45999,0,100,200
RandomSolution_start101,TSPB,230830,178802,52028,0,100,200
RandomSolution_start102,TSPB,209976,158260,51716,0,100,200
RandomSolution_start103,TSPB,217711,168543,49168,0,100,200
RandomSolution_start104,TSPB,215755,171665,44090,0,100,200
RandomSolution_start105,TSPB,219051,170903,48148,0,100,200
RandomSolution_start106,TSPB,202723,154104,48619,0,100,200
RandomSolution_start107,TSPB,217736,168523,49213,0,100,200
RandomSolution_start108,TSPB,203604,158711,44893,1,100,200
RandomSolution_start109,TSPB,216541,165230,51311,0,100,200
RandomSolution_start110,TSPB,210917,161961,48956,0,100,200
RandomSolution_start111,TSPB,212564,160513,52051,0,100,200
RandomSolution_start112,TSPB,218098,167882,50216,0,100,200
RandomSolution_start113,TSPB,231003,183407,47596,0,100,200
RandomSolution_start114,TSPB,215105,167702,47403,0,100,200
RandomSolution_start115,TSPB,212271,158893,53378,0,100,200
RandomSolution_start116,TSPB,202483,153556,48927,0,100,200
RandomSolution_start117,TSPB,212769,163370,49399,0,100,200
RandomSolution_start118,TSPB,209243,160048,49195,0,100,200
RandomSolution_start119,TSPB,207841,158532,49309,0,100,200
RandomSolution_start120,TSPB,201874,153382,48492,0,100,200
RandomSolution_start121,TSPB,216447,167280,49167,0,100,200
RandomSolution_start122,TSPB,200120,152806,47314,0,100,200
RandomSolution_start123,TSPB,213898,163193,50705,0,100,200
RandomSolution_start124,TSPB,222584,173414,49170,0,100,200
RandomSolution_start125,TSPB,213508,160973,52535,0,100,200
RandomSolution_start126,TSPB,206767,158388,48379,0,100,200
RandomSolution_start127,TSPB,214069,164591,49478,0,100,200
RandomSolution_start128,TSPB,196705,148230,48475,0,100,200
RandomSolution_start129,TSPB,204885,152804,52081,0,100,200
RandomSolution_start130,TSPB,200603,152150,48453,0,100,200
RandomSolution_start131,TSPB,221321,169147,52174,1,100,200
RandomSolution_start132,TSPB,209526,160256,49270,0,100,200
RandomSolution_start133,TSPB,218798,171081,47717,0,100,200
RandomSolution_start134,TSPB,221962,168811,53151,0,100,200
RandomSolution_start135,TSPB,209913,160919,48994,0,100,200
RandomSolution_start136,TSPB,228268,176450,51818,0,100,200
RandomSolution_start137,TSPB,226548,176187,50361,0,100,200
RandomSolution_start138,TSPB,218083,169334,48749,0,100,200
RandomSolution_start139,TSPB,216851,167309,49542,0,100,200
RandomSolution_start140,TSPB,216980,166488,50492,0,100,200
RandomSolution_start141,TSPB,214339,167373,46966,0,100,200
RandomSolution_start142,TSPB,202380,154329,48051,0,100,200
RandomSolution_start143,TSPB,210545,160485,50060,0,100,200
RandomSolution_start144,TSPB,200752,149728,51024,0,100,200
RandomSolution_start145,TSPB,202463,156109,46354,0,100,200
RandomSolution_start146,TSPB,195638,148808,46830,0,100,200
RandomSolution_start147,TSPB,221025,170847,50178,0,100,200
RandomSolution_start148,TSPB,203650,154681,48969,0,100,200
RandomSolution_start149,TSPB,217039,167942,49097,0,100,200
RandomSolution_start150,TSPB,207930,155695,52235,0,100,200
RandomSolution_start151,TSPB,219172,167174,51998,0,100,200
RandomSolution_start152,TSPB,211334,163196,48138,1,100,200
RandomSolution_start153,TSPB,217932,165524,52408,0,100,200
RandomSolution_start154,TSPB,205469,156192,49277,0,100,200
RandomSolution_start155,TSPB,210345,163653,46692,0,100,200
RandomSolution_start156,TSPB,214905,166517,48388,0,100,200
RandomSolution_start157,TSPB,210435,161088,49347,0,100,200
RandomSolution_start158,TSPB,205747,156314,49433,0,100,200
RandomSolution_start159,TSPB,215905,166493,49412,0,100,200
RandomSolution_start160,TSPB,201914,151521,50393,0,100,200
RandomSolution_start161,TSPB,214066,165836,48230,0,100,200
RandomSolution_start162,TSPB,216768,166054,50714,0,100,200
RandomSolution_start163,TSPB,209643,162878,46765,0,100,200
RandomSolution_start164,TSPB,215744,164637,51107,0,100,200
RandomSolution_start165,TSPB,214658,166590,48068,0,100,200
RandomSolution_start166,TSPB,211277,162137,49140,0,100,200
RandomSolution_start167,TSPB,209615,162835,46780,0,100,200
RandomSolution_start168,TSPB,219927,169866,50061,0,100,200
RandomSolution_start169,TSPB,207980,159263,48717,0,100,200
RandomSolution_start170,TSPB,209601,157959,51642,0,100,200
RandomSolution_start171,TSPB,212016,160929,51087,0,100,200
RandomSolution_start172,TSPB,223419,168326,55093,0,100,200
RandomSolution_start173,TSPB,212863,163601,49262,0,100,200
RandomSolution_start174,TSPB,201281,151971,49310,1,100,200
RandomSolution_start175,TSPB,202817,152915,49902,0,100,200
RandomSolution_start176,TSPB,220503,175175,45328,0,100,200
RandomSolution_start177,TSPB,201424,150852,50572,0,100,200
RandomSolution_start178,TSPB,215689,164309,51380,0,100,200
RandomSolution_start179,TSPB,214420,163070,51350,0,100,200
RandomSolution_start180,TSPB,209078,158548,50530,0,100,200
RandomSolution_start181,TSPB,211139,160643,50496,0,100,200
RandomSolution_start182,TSPB,206927,156020,50907,0,100,200
RandomSolution_start183,TSPB,245960,191489,54471,0,100,200
RandomSolution_start184,TSPB,219302,167536,51766,0,100,200
RandomSolution_start185,TSPB,197483,151714,45769,0,100,200
RandomSolution_start186,TSPB,227117,177973,49144,0,100,200
RandomSolution_start187,TSPB,212270,162837,49433,0,100,200
RandomSolution_start188,TSPB,207577,164155,43422,0,100,200
RandomSolution_start189,TSPB,225458,176327,49131,0,100,200
RandomSolution_start190,TSPB,231666,183622,48044,0,100,200
RandomSolution_start191,TSPB,194376,148923,45453,0,100,200
RandomSolution_start192,TSPB,212650,163167,49483,0,100,200
RandomSolution_start193,TSPB,221650,172959,48691,0,100,200
RandomSolution_start194,TSPB,199772,149801,49971,0,100,200
RandomSolution_start195,TSPB,204683,154283,50400,0,100,200
RandomSolution_start196,TSPB,213017,165864,47153,0,100,200
RandomSolution_start197,TSPB,221665,168363,53302,0,100,200
RandomSolution_start198,TSPB,210430,163997,46433,0,100,200
RandomSolution_start199,TSPB,199426,146769,52657,0,100,200
GreedyCycle_start0,TSPB,50243,20579,29664,2,100,200
GreedyCycle_start1,TSPB,52933,20350,32583,4,100,200
GreedyCycle_start2,TSPB,49617,20111,29506,3,100,200
GreedyCycle_start3,TSPB,52260,19636,32624,2,100,200
GreedyCycle_start4,TSPB,51849,19333,32516,2,100,200
GreedyCycle_start5,TSPB,49394,21169,28225,2,100,200
GreedyCycle_start6,TSPB,49413,20201,29212,2,100,200
GreedyCycle_start7,TSPB,49836,21178,28658,2,100,200
GreedyCycle_start8,TSPB,50141,20317,29824,2,100,200
GreedyCycle_start9,TSPB,51895,19379,32516,2,100,200
GreedyCycle_start10,TSPB,52665,20954,31711,2,100,200
GreedyCycle_start11,TSPB,50243,20579,29664,2,100,200
GreedyCycle_start12,TSPB,50536,20334,30202,2,100,200
GreedyCycle_start13,TSPB,49413,20201,29212,3,100,200
GreedyCycle_start14,TSPB,50618,20029,30589,2,100,200
GreedyCycle_start15,TSPB,52260,19636,32624,2,100,200
GreedyCycle_start16,TSPB,52985,20415,32570,2,100,200
GreedyCycle_start17,TSPB,57324,19155,38169,2,100,200
GreedyCycle_start18,TSPB,52079,20966,31113,2,100,200
GreedyCycle_start19,TSPB,53026,20443,32583,2,100,200
GreedyCycle_start20,TSPB,52247,19655,32592,1,100,200
GreedyCycle_start21,TSPB,49402,21177,28225,2,100,200
GreedyCycle_start22,TSPB,51149,19545,31604,2,100,200
GreedyCycle_start23,TSPB,52340,19657,32683,2,100,200
GreedyCycle_start24,TSPB,53294,20354,32940,2,100,200
GreedyCycle_start25,TSPB,49678,21453,28225,2,100,200
GreedyCycle_start26,TSPB,50970,19366,31604,2,100,200
GreedyCycle_start27,TSPB,53047,20477,32570,2,100,200
GreedyCycle_start28,TSPB,51849,19333,32516,2,100,200
GreedyCycle_start29,TSPB,50243,20579,29664,2,100,200
GreedyCycle_start30,TSPB,51895,21411,30484,2,100,200
GreedyCycle_start31,TSPB,50608,21253,29355,2,100,200
GreedyCycle_start32,TSPB,52694,20918,31776,2,100,200
GreedyCycle_start33,TSPB,50243,20579,29664,2,100,200
GreedyCycle_start34,TSPB,50997,21068,29929,2,100,200
GreedyCycle_start35,TSPB,50243,20579,29664,2,100,200
GreedyCycle_start36,TSPB,50392,20568,29824,2,100,200
GreedyCycle_start37,TSPB,50760,20139,30621,1,100,200
GreedyCycle_start38,TSPB,52985,20415,32570,2,100,200
GreedyCycle_start39,TSPB,50690,20490,30200,2,100,200
GreedyCycle_start40,TSPB,57140,18971,38169,2,100,200
GreedyCycle_start41,TSPB,50583,20128,30455,2,100,200
GreedyCycle_start42,TSPB,51793,21572,30221,2,100,200
GreedyCycle_start43,TSPB,50042,20218,29824,2,100,200
GreedyCycle_start44,TSPB,52997,20470,32527,1,100,200
GreedyCycle_start45,TSPB,49394,21169,28225,2,100,200
GreedyCycle_start46,TSPB,51188,20942,30246,2,100,200
GreedyCycle_start47,TSPB,52250,19658,32592,2,100,200
GreedyCycle_start48,TSPB,51892,19810,32082,2,100,200
GreedyCycle_start49,TSPB,50057,20233,29824,2,100,200
GreedyCycle_start50,TSPB,50735,20152,30583,2,100,200
GreedyCycle_start51,TSPB,52665,20954,31711,1,100,200
GreedyCycle_start52,TSPB,50970,19366,31604,2,100,200
GreedyCycle_start53,TSPB,51292,18776,32516,2,100,200
GreedyCycle_start54,TSPB,50608,21253,29355,2,100,200
GreedyCycle_start55,TSPB,52079,20966,31113,2,100,200
GreedyCycle_start56,TSPB,49593,21368,28225,2,100,200
GreedyCycle_start57,TSPB,51040,19122,31918,1,100,200
GreedyCycle_start58,TSPB,49459,20677,28782,2,100,200
GreedyCycle_start59,TSPB,51849,19333,32516,2,100,200
GreedyCycle_start60,TSPB,52247,19655,32592,2,100,200
GreedyCycle_start61,TSPB,50392,20568,29824,2,100,200
GreedyCycle_start62,TSPB,52079,20966,31113,2,100,200
GreedyCycle_start63,TSPB,52665,20954,31711,1,100,200
GreedyCycle_start64,TSPB,51588,19371,32217,2,100,200
GreedyCycle_start65,TSPB,52484,19736,32748,2,100,200
GreedyCycle_start66,TSPB,52250,19658,32592,2,100,200
GreedyCycle_start67,TSPB,52887,20941,31946,2,100,200
GreedyCycle_start68,TSPB,50807,20176,30631,2,100,200
GreedyCycle_start69,TSPB,51001,20836,30165,2,100,200
GreedyCycle_start70,TSPB,52260,19636,32624,2,100,200
GreedyCycle_start71,TSPB,52295,21182,31113,2,100,200
GreedyCycle_start72,TSPB,57140,18971,38169,2,100,200
GreedyCycle_start73,TSPB,50608,21253,29355,2,100,200
GreedyCycle_start74,TSPB,53407,20719,32688,2,100,200
GreedyCycle_start75,TSPB,51625,19689,31936,2,100,200
GreedyCycle_start76,TSPB,51591,19535,32056,2,100,200
GreedyCycle_start77,TSPB,50954,19350,31604,2,100,200
GreedyCycle_start78,TSPB,49394,21169,28225,2,100,200
GreedyCycle_start79,TSPB,50674,20221,30453,2,100,200
GreedyCycle_start80,TSPB,50443,21088,29355,3,100,200
GreedyCycle_start81,TSPB,50954,19350,31604,2,100,200
GreedyCycle_start82,TSPB,49402,21177,28225,2,100,200
GreedyCycle_start83,TSPB,51506,19077,32429,2,100,200
GreedyCycle_start84,TSPB,50451,20621,29830,3,100,200
GreedyCycle_start85,TSPB,49001,20856,28145,3,100,200
GreedyCycle_start86,TSPB,50970,19366,31604,3,100,200
GreedyCycle_start87,TSPB,49402,21177,28225,2,100,200
GreedyCycle_start88,TSPB,51490,19360,32130,2,100,200
GreedyCycle_start89,TSPB,50970,19366,31604,4,100,200
GreedyCycle_start90,TSPB,52727,21016,31711,3,100,200
GreedyCycle_start91,TSPB,50392,20568,29824,2,100,200
GreedyCycle_start92,TSPB,53124,20550,32574,2,100,200
GreedyCycle_start93,TSPB,52248,19450,32798,2,100,200
GreedyCycle_start94,TSPB,52250,19658,32592,2,100,200
GreedyCycle_start95,TSPB,50970,19366,31604,2,100,200
GreedyCycle_start96,TSPB,52792,20987,31805,2,100,200
GreedyCycle_start97,TSPB,50954,19350,31604,2,100,200
GreedyCycle_start98,TSPB,53066,20549,32517,2,100,200
GreedyCycle_start99,TSPB,51149,19545,31604,2,100,200
GreedyCycle_start100,TSPB,56757,19324,37433,2,100,200
GreedyCycle_start101,TSPB,52020,19310,32710,2,100,200
GreedyCycle_start102,TSPB,52727,21016,31711,2,100,200
GreedyCycle_start103,TSPB,50970,19366,31604,3,100,200
GreedyCycle_start104,TSPB,50141,20317,29824,2,100,200
GreedyCycle_start105,TSPB,54470,20155,34315,3,100,200
GreedyCycle_start106,TSPB,52079,20966,31113,3,100,200
GreedyCycle_start107,TSPB,57078,18909,38169,2,100,200
GreedyCycle_start108,TSPB,52666,21793,30873,2,100,200
GreedyCycle_start109,TSPB,50243,20579,29664,2,100,200
GreedyCycle_start110,TSPB,51614,18736,32878,5,100,200
GreedyCycle_start111,TSPB,50111,20287,29824,2,100,200
GreedyCycle_start112,TSPB,52964,20381,32583,3,100,200
GreedyCycle_start113,TSPB,50970,19366,31604,3,100,200
GreedyCycle_start114,TSPB,50879,19275,31604,2,100,200
GreedyCycle_start115,TSPB,52614,20817,31797,4,100,200
GreedyCycle_start116,TSPB,52981,20493,32488,54,100,200
GreedyCycle_start117,TSPB,50546,21191,29355,37,100,200
GreedyCycle_start118,TSPB,53066,20549,32517,2,100,200
GreedyCycle_start119,TSPB,51545,20776,30769,2,100,200
GreedyCycle_start120,TSPB,52758,20909,31849,2,100,200
GreedyCycle_start121,TSPB,53026,20443,32583,2,100,200
GreedyCycle_start122,TSPB,52727,21016,31711,4,100,200
GreedyCycle_start123,TSPB,49949,21322,28627,2,100,200
GreedyCycle_start124,TSPB,52079,20966,31113,3,100,200
GreedyCycle_start125,TSPB,52784,21073,31711,2,100,200
GreedyCycle_start126,TSPB,49891,20039,29852,4,100,200
GreedyCycle_start127,TSPB,50970,19366,31604,2,100,200
GreedyCycle_start128,TSPB,51559,18967,32592,2,100,200
GreedyCycle_start129,TSPB,51485,19307,32178,2,100,200
GreedyCycle_start130,TSPB,50970,19366,31604,5,100,200
GreedyCycle_start131,TSPB,52665,20954,31711,11,100,200
GreedyCycle_start132,TSPB,49413,20201,29212,2,100,200
GreedyCycle_start133,TSPB,52727,21016,31711,2,100,200
GreedyCycle_start134,TSPB,49413,20201,29212,12,100,200
GreedyCycle_start135,TSPB,52727,21016,31711,2,100,200
GreedyCycle_start136,TSPB,50443,21088,29355,2,100,200
GreedyCycle_start137,TSPB,50926,19322,31604,2,100,200
GreedyCycle_start138,TSPB,50243,20579,29664,2,100,200
GreedyCycle_start139,TSPB,50243,20579,29664,2,100,200
GreedyCycle_start140,TSPB,51182,18753,32429,2,100,200
GreedyCycle_start141,TSPB,50954,19350,31604,2,100,200
GreedyCycle_start142,TSPB,49394,21169,28225,2,100,200
GreedyCycle_start143,TSPB,50997,21068,29929,2,100,200
GreedyCycle_start144,TSPB,50425,20601,29824,2,100,200
GreedyCycle_start145,TSPB,52260,19636,32624,1,100,200
GreedyCycle_start146,TSPB,50954,19350,31604,2,100,200
GreedyCycle_start147,TSPB,52258,21145,31113,2,100,200
GreedyCycle_start148,TSPB,52250,19658,32592,2,100,200
GreedyCycle_start149,TSPB,51849,19333,32516,2,100,200
GreedyCycle_start150,TSPB,51642,19396,32246,2,100,200
GreedyCycle_start151,TSPB,52933,20350,32583,2,100,200
GreedyCycle_start152,TSPB,51182,18753,32429,2,100,200
GreedyCycle_start153,TSPB,50954,19350,31604,2,100,200
GreedyCycle_start154,TSPB,52250,19658,32592,2,100,200
GreedyCycle_start155,TSPB,50251,20587,29664,1,100,200
GreedyCycle_start156,TSPB,52995,20412,32583,2,100,200
GreedyCycle_start157,TSPB,50611,20086,30525,2,100,200
GreedyCycle_start158,TSPB,49584,22177,27407,2,100,200
GreedyCycle_start159,TSPB,50997,21068,29929,2,100,200
GreedyCycle_start160,TSPB,50243,20579,29664,2,100,200
GreedyCycle_start161,TSPB,52260,19636,32624,2,100,200
GreedyCycle_start162,TSPB,50443,21088,29355,2,100,200
GreedyCycle_start163,TSPB,50970,19366,31604,2,100,200
GreedyCycle_start164,TSPB,50608,21253,29355,2,100,200
GreedyCycle_start165,TSPB,51109,19505,31604,1,100,200
GreedyCycle_start166,TSPB,50970,19366,31604,2,100,200
GreedyCycle_start167,TSPB,50559,20636,29923,2,100,200
GreedyCycle_start168,TSPB,49413,20201,29212,3,100,200
GreedyCycle_start169,TSPB,49413,20201,29212,2,100,200
GreedyCycle_start170,TSPB,51099,21170,29929,2,100,200
GreedyCycle_start171,TSPB,49641,20782,28859,2,100,200
GreedyCycle_start172,TSPB,50970,19366,31604,2,100,200
GreedyCycle_start173,TSPB,50807,20322,30485,2,100,200
GreedyCycle_start174,TSPB,51403,18912,32491,2,100,200
GreedyCycle_start175,TSPB,49394,21169,28225,2,100,200
GreedyCycle_start176,TSPB,50970,19366,31604,2,100,200
GreedyCycle_start177,TSPB,49394,21169,28225,2,100,200
GreedyCycle_start178,TSPB,52727,21016,31711,2,100,200
GreedyCycle_start179,TSPB,50970,19366,31604,2,100,200
GreedyCycle_start180,TSPB,50970,19366,31604,2,100,200
GreedyCycle_start181,TSPB,51728,19068,32660,2,100,200
GreedyCycle_start182,TSPB,50243,20579,29664,2,100,200
GreedyCycle_start183,TSPB,51182,18753,32429,2,100,200
GreedyCycle_start184,TSPB,51221,21406,29815,2,100,200
GreedyCycle_start185,TSPB,50970,19366,31604,2,100,200
GreedyCycle_start186,TSPB,51534,19292,32242,2,100,200
GreedyCycle_start187,TSPB,50954,19350,31604,2,100,200
GreedyCycle_start188,TSPB,49413,20201,29212,2,100,200
GreedyCycle_start189,TSPB,50043,20932,29111,2,100,200
GreedyCycle_start190,TSPB,50443,21088,29355,1,100,200
GreedyCycle_start191,TSPB,52665,20954,31711,2,100,200
GreedyCycle_start192,TSPB,51626,19392,32234,2,100,200
GreedyCycle_start193,TSPB,50608,21253,29355,2,100,200
GreedyCycle_start194,TSPB,50970,19366,31604,2,100,200
GreedyCycle_start195,TSPB,49413,20201,29212,1,100,200
GreedyCycle_start196,TSPB,52611,21451,31160,2,100,200
GreedyCycle_start197,TSPB,53314,20367,32947,2,100,200
GreedyCycle_start198,TSPB,50549,21194,29355,2,100,200
GreedyCycle_start199,TSPB,52247,19655,32592,2,100,200
NearestNeighborEnd_start0,TSPB,55374,28259,27115,0,100,200
NearestNeighborEnd_start1,TSPB,52584,27231,25353,0,100,200
NearestNeighborEnd_start2,TSPB,54369,25952,28417,1,100,200
NearestNeighborEnd_start3,TSPB,53796,25603,28193,0,100,200
NearestNeighborEnd_start4,TSPB,55335,27047,28288,0,100,200
NearestNeighborEnd_start5,TSPB,54997,27145,27852,0,100,200
NearestNeighborEnd_start6,TSPB,55492,28416,27076,0,100,200
NearestNeighborEnd_start7,TSPB,54592,27008,27584,0,100,200
NearestNeighborEnd_start8,TSPB,55937,26791,29146,0,100,200
NearestNeighborEnd_start9,TSPB,54625,26635,27990,0,100,200
NearestNeighborEnd_start10,TSPB,52543,27651,24892,1,100,200
NearestNeighborEnd_start11,TSPB,53417,27062,26355,0,100,200
NearestNeighborEnd_start12,TSPB,55436,27812,27624,0,100,200
NearestNeighborEnd_start13,TSPB,54637,26220,28417,0,100,200
NearestNeighborEnd_start14,TSPB,54085,27589,26496,0,100,200
NearestNeighborEnd_start15,TSPB,54628,26182,28446,0,100,200
NearestNeighborEnd_start16,TSPB,52319,27165,25154,0,100,200
NearestNeighborEnd_start17,TSPB,53001,27509,25492,1,100,200
NearestNeighborEnd_start18,TSPB,55232,27122,28110,0,100,200
NearestNeighborEnd_start19,TSPB,54778,27408,27370,0,100,200
NearestNeighborEnd_start20,TSPB,52915,25884,27031,0,100,200
NearestNeighborEnd_start21,TSPB,56255,27312,28943,0,100,200
NearestNeighborEnd_start22,TSPB,52703,25792,26911,0,100,200
NearestNeighborEnd_start23,TSPB,53255,26126,27129,0,100,200
NearestNeighborEnd_start24,TSPB,53085,27147,25938,1,100,200
NearestNeighborEnd_start25,TSPB,54829,26421,28408,0,100,200
NearestNeighborEnd_start26,TSPB,55766,28862,26904,0,100,200
NearestNeighborEnd_start27,TSPB,53306,27576,25730,0,100,200
NearestNeighborEnd_start28,TSPB,53083,25867,27216,0,100,200
NearestNeighborEnd_start29,TSPB,55210,28095,27115,0,100,200
NearestNeighborEnd_start30,TSPB,52983,27035,25948,0,100,200
NearestNeighborEnd_start31,TSPB,53381,27933,25448,1,100,200
NearestNeighborEnd_start32,TSPB,53008,26910,26098,0,100,200
NearestNeighborEnd_start33,TSPB,53527,27468,26059,0,100,200
NearestNeighborEnd_start34,TSPB,59030,28904,30126,0,100,200
NearestNeighborEnd_start35,TSPB,55417,28302,27115,0,100,200
NearestNeighborEnd_start36,TSPB,52756,27946,24810,0,100,200
NearestNeighborEnd_start37,TSPB,55806,28123,27683,0,100,200
NearestNeighborEnd_start38,TSPB,53038,27353,25685,0,100,200
NearestNeighborEnd_start39,TSPB,55314,27692,27622,1,100,200
NearestNeighborEnd_start40,TSPB,52893,27503,25390,0,100,200
NearestNeighborEnd_start41,TSPB,55825,28308,27517,0,100,200
NearestNeighborEnd_start42,TSPB,53159,27474,25685,1,100,200
NearestNeighborEnd_start43,TSPB,54620,27410,27210,0,100,200
NearestNeighborEnd_start44,TSPB,52993,27725,25268,0,100,200
NearestNeighborEnd_start45,TSPB,55165,27218,27947,0,100,200
NearestNeighborEnd_start46,TSPB,53649,25872,27777,0,100,200
NearestNeighborEnd_start47,TSPB,58125,29029,29096,0,100,200
NearestNeighborEnd_start48,TSPB,56010,28585,27425,0,100,200
NearestNeighborEnd_start49,TSPB,53423,27401,26022,1,100,200
NearestNeighborEnd_start50,TSPB,53971,27481,26490,0,100,200
NearestNeighborEnd_start51,TSPB,54400,27408,26992,0,100,200
NearestNeighborEnd_start52,TSPB,52612,25446,27166,0,100,200
NearestNeighborEnd_start53,TSPB,53962,25791,28171,0,100,200
NearestNeighborEnd_start54,TSPB,53334,27886,25448,0,100,200
NearestNeighborEnd_start55,TSPB,53739,28975,24764,1,100,200
NearestNeighborEnd_start56,TSPB,56145,26804,29341,0,100,200
NearestNeighborEnd_start57,TSPB,56238,30750,25488,0,100,200
NearestNeighborEnd_start58,TSPB,53867,27415,26452,0,100,200
NearestNeighborEnd_start59,TSPB,52858,25686,27172,0,100,200
NearestNeighborEnd_start60,TSPB,53042,26193,26849,0,100,200
NearestNeighborEnd_start61,TSPB,53914,26752,27162,0,100,200
NearestNeighborEnd_start62,TSPB,58259,27795,30464,0,100,200
NearestNeighborEnd_start63,TSPB,52912,27364,25548,0,100,200
NearestNeighborEnd_start64,TSPB,55997,28849,27148,1,100,200
NearestNeighborEnd_start65,TSPB,53855,25462,28393,0,100,200
NearestNeighborEnd_start66,TSPB,57663,28964,28699,0,100,200
NearestNeighborEnd_start67,TSPB,53809,27850,25959,0,100,200
NearestNeighborEnd_start68,TSPB,56408,26802,29606,0,100,200
NearestNeighborEnd_start69,TSPB,55864,28277,27587,0,100,200
NearestNeighborEnd_start70,TSPB,54206,27341,26865,0,100,200
NearestNeighborEnd_start71,TSPB,53606,27796,25810,1,100,200
NearestNeighborEnd_start72,TSPB,52893,27502,25391,0,100,200
NearestNeighborEnd_start73,TSPB,52595,27001,25594,0,100,200
NearestNeighborEnd_start74,TSPB,54572,27248,27324,0,100,200
NearestNeighborEnd_start75,TSPB,54406,28497,25909,0,100,200
NearestNeighborEnd_start76,TSPB,56502,29515,26987,0,100,200
NearestNeighborEnd_start77,TSPB,53689,27416,26273,1,100,200
NearestNeighborEnd_start78,TSPB,55030,27178,27852,0,100,200
NearestNeighborEnd_start79,TSPB,53049,27836,25213,0,100,200
NearestNeighborEnd_start80,TSPB,53151,25952,27199,0,100,200
NearestNeighborEnd_start81,TSPB,53647,27692,25955,0,100,200
NearestNeighborEnd_start82,TSPB,56090,27065,29025,0,100,200
NearestNeighborEnd_start83,TSPB,54519,26591,27928,0,100,200
NearestNeighborEnd_start84,TSPB,54381,26022,28359,0,100,200
NearestNeighborEnd_start85,TSPB,55431,27806,27625,1,100,200
NearestNeighborEnd_start86,TSPB,56949,28494,28455,0,100,200
NearestNeighborEnd_start87,TSPB,56070,27009,29061,0,100,200
NearestNeighborEnd_start88,TSPB,55898,28837,27061,0,100,200
NearestNeighborEnd_start89,TSPB,54333,27926,26407,0,100,200
NearestNeighborEnd_start90,TSPB,52845,27455,25390,0,100,200
NearestNeighborEnd_start91,TSPB,52867,27915,24952,0,100,200
NearestNeighborEnd_start92,TSPB,53233,27038,26195,1,100,200
NearestNeighborEnd_start93,TSPB,56734,29202,27532,0,100,200
NearestNeighborEnd_start94,TSPB,58049,28953,29096,0,100,200
NearestNeighborEnd_start95,TSPB,52592,25514,27078,0,100,200
NearestNeighborEnd_start96,TSPB,53069,26942,26127,0,100,200
NearestNeighborEnd_start97,TSPB,53853,27673,26180,0,100,200
NearestNeighborEnd_start98,TSPB,54683,27308,27375,0,100,200
NearestNeighborEnd_start99,TSPB,52776,25865,26911,1,100,200
NearestNeighborEnd_start100,TSPB,52824,27537,25287,0,100,200
NearestNeighborEnd_start101,TSPB,53072,25569,27503,0,100,200
NearestNeighborEnd_start102,TSPB,52982,26949,26033,0,100,200
NearestNeighborEnd_start103,TSPB,55426,28903,26523,0,100,200
NearestNeighborEnd_start104,TSPB,55903,26878,29025,0,100,200
NearestNeighborEnd_start105,TSPB,53576,25866,27710,0,100,200
NearestNeighborEnd_start106,TSPB,56723,27753,28970,1,100,200
NearestNeighborEnd_start107,TSPB,52856,27466,25390,0,100,200
NearestNeighborEnd_start108,TSPB,54350,26829,27521,0,100,200
NearestNeighborEnd_start109,TSPB,55438,28323,27115,0,100,200
NearestNeighborEnd_start110,TSPB,57471,28496,28975,0,100,200
NearestNeighborEnd_start111,TSPB,52951,27639,25312,0,100,200
NearestNeighborEnd_start112,TSPB,54633,27293,27340,0,100,200
NearestNeighborEnd_start113,TSPB,55851,29383,26468,1,100,200
NearestNeighborEnd_start114,TSPB,55770,29168,26602,0,100,200
NearestNeighborEnd_start115,TSPB,53557,27694,25863,0,100,200
NearestNeighborEnd_start116,TSPB,54657,27171,27486,0,100,200
NearestNeighborEnd_start117,TSPB,53336,27888,25448,0,100,200
NearestNeighborEnd_start118,TSPB,54507,27238,27269,0,100,200
NearestNeighborEnd_start119,TSPB,56515,27274,29241,0,100,200
NearestNeighborEnd_start120,TSPB,53712,27850,25862,0,100,200
NearestNeighborEnd_start121,TSPB,54767,27844,26923,1,100,200
NearestNeighborEnd_start122,TSPB,52653,27586,25067,0,100,200
NearestNeighborEnd_start123,TSPB,54470,26917,27553,0,100,200
NearestNeighborEnd_start124,TSPB,56865,27895,28970,0,100,200
NearestNeighborEnd_start125,TSPB,53384,27660,25724,0,100,200
NearestNeighborEnd_start126,TSPB,54635,27684,26951,0,100,200
NearestNeighborEnd_start127,TSPB,53717,27751,25966,0,100,200
NearestNeighborEnd_start128,TSPB,58056,27897,30159,1,100,200
NearestNeighborEnd_start129,TSPB,55874,28765,27109,0,100,200
NearestNeighborEnd_start130,TSPB,52874,25963,26911,0,100,200
NearestNeighborEnd_start131,TSPB,54786,27753,27033,0,100,200
NearestNeighborEnd_start132,TSPB,53792,25599,28193,0,100,200
NearestNeighborEnd_start133,TSPB,52853,27786,25067,0,100,200
NearestNeighborEnd_start134,TSPB,55382,27757,27625,0,100,200
NearestNeighborEnd_start135,TSPB,52886,27338,25548,1,100,200
NearestNeighborEnd_start136,TSPB,54927,28004,26923,0,100,200
NearestNeighborEnd_start137,TSPB,53882,27973,25909,0,100,200
NearestNeighborEnd_start138,TSPB,54974,27419,27555,0,100,200
NearestNeighborEnd_start139,TSPB,54369,28091,26278,0,100,200
NearestNeighborEnd_start140,TSPB,55111,26823,28288,0,100,200
NearestNeighborEnd_start141,TSPB,52960,28150,24810,0,100,200
NearestNeighborEnd_start142,TSPB,55197,27180,28017,1,100,200
NearestNeighborEnd_start143,TSPB,55921,27194,28727,0,100,200
NearestNeighborEnd_start144,TSPB,53282,27478,25804,0,100,200
NearestNeighborEnd_start145,TSPB,53934,25741,28193,0,100,200
NearestNeighborEnd_start146,TSPB,55392,26627,28765,0,100,200
NearestNeighborEnd_start147,TSPB,52969,27965,25004,0,100,200
NearestNeighborEnd_start148,TSPB,53140,26291,26849,1,100,200
NearestNeighborEnd_start149,TSPB,52923,25575,27348,0,100,200
NearestNeighborEnd_start150,TSPB,53690,28163,25527,0,100,200
NearestNeighborEnd_start151,TSPB,52638,26856,25782,0,100,200
NearestNeighborEnd_start152,TSPB,54645,26357,28288,0,100,200
NearestNeighborEnd_start153,TSPB,55159,26394,28765,0,100,200
NearestNeighborEnd_start154,TSPB,57975,28879,29096,0,100,200
NearestNeighborEnd_start155,TSPB,54922,26925,27997,1,100,200
NearestNeighborEnd_start156,TSPB,52804,27192,25612,0,100,200
NearestNeighborEnd_start157,TSPB,54084,27910,26174,0,100,200
NearestNeighborEnd_start158,TSPB,54579,27158,27421,0,100,200
NearestNeighborEnd_start159,TSPB,56260,27192,29068,0,100,200
NearestNeighborEnd_start160,TSPB,53088,27349,25739,1,100,200
NearestNeighborEnd_start161,TSPB,54567,27086,27481,0,100,200
NearestNeighborEnd_start162,TSPB,53284,25843,27441,0,100,200
NearestNeighborEnd_start163,TSPB,53497,27531,25966,0,100,200
NearestNeighborEnd_start164,TSPB,52784,26988,25796,1,100,200
NearestNeighborEnd_start165,TSPB,53695,27539,26156,0,100,200
NearestNeighborEnd_start166,TSPB,56154,29166,26988,0,100,200
NearestNeighborEnd_start167,TSPB,55312,26939,28373,0,100,200
NearestNeighborEnd_start168,TSPB,54369,25952,28417,0,100,200
NearestNeighborEnd_start169,TSPB,53861,25668,28193,0,100,200
NearestNeighborEnd_start170,TSPB,53740,25838,27902,0,100,200
NearestNeighborEnd_start171,TSPB,54288,26696,27592,1,100,200
NearestNeighborEnd_start172,TSPB,52407,25469,26938,0,100,200
NearestNeighborEnd_start173,TSPB,52844,27031,25813,0,100,200
NearestNeighborEnd_start174,TSPB,54368,26222,28146,0,100,200
NearestNeighborEnd_start175,TSPB,55778,27632,28146,0,100,200
NearestNeighborEnd_start176,TSPB,55830,29362,26468,0,100,200
NearestNeighborEnd_start177,TSPB,53989,26673,27316,0,100,200
NearestNeighborEnd_start178,TSPB,53342,27565,25777,1,100,200
NearestNeighborEnd_start179,TSPB,52595,25684,26911,0,100,200
NearestNeighborEnd_start180,TSPB,55608,28752,26856,0,100,200
NearestNeighborEnd_start181,TSPB,58682,28122,30560,0,100,200
NearestNeighborEnd_start182,TSPB,54285,26855,27430,0,100,200
NearestNeighborEnd_start183,TSPB,55091,26803,28288,0,100,200
NearestNeighborEnd_start184,TSPB,55108,27108,28000,0,100,200
NearestNeighborEnd_start185,TSPB,52728,25817,26911,1,100,200
NearestNeighborEnd_start186,TSPB,55709,26291,29418,0,100,200
NearestNeighborEnd_start187,TSPB,54088,27815,26273,0,100,200
NearestNeighborEnd_start188,TSPB,53849,25656,28193,0,100,200
NearestNeighborEnd_start189,TSPB,54804,26896,27908,0,100,200
NearestNeighborEnd_start190,TSPB,53189,25990,27199,0,100,200
NearestNeighborEnd_start191,TSPB,53220,27545,25675,0,100,200
NearestNeighborEnd_start192,TSPB,53520,28005,25515,1,100,200
NearestNeighborEnd_start193,TSPB,53429,27981,25448,0,100,200
NearestNeighborEnd_start194,TSPB,56027,29039,26988,0,100,200
NearestNeighborEnd_start195,TSPB,53942,25749,28193,0,100,200
NearestNeighborEnd_start196,TSPB,53643,27547,26096,0,100,200
NearestNeighborEnd_start197,TSPB,52323,26915,25408,0,100,200
NearestNeighborEnd_start198,TSPB,52537,26961,25576,0,100,200
NearestNeighborEnd_start199,TSPB,55398,27110,28288,1,100,200
NearestNeighborAny_start0,TSPB,45371,18161,27210,2,100,200
NearestNeighborAny_start1,TSPB,44472,19667,24805,2,100,200
NearestNeighborAny_start2,TSPB,46939,19609,27330,3,100,200
NearestNeighborAny_start3,TSPB,45841,19126,26715,3,100,200
NearestNeighborAny_start4,TSPB,44446,18973,25473,2,100,200
NearestNeighborAny_start5,TSPB,44472,19667,24805,2,100,200
NearestNeighborAny_start6,TSPB,45371,18161,27210,2,100,200
NearestNeighborAny_start7,TSPB,45101,19038,26063,2,100,200
NearestNeighborAny_start8,TSPB,47851,21849,26002,2,100,200
NearestNeighborAny_start9,TSPB,47550,20413,27137,2,100,200
NearestNeighborAny_start10,TSPB,44670,19991,24679,3,100,200
NearestNeighborAny_start11,TSPB,45371,18161,27210,2,100,200
NearestNeighborAny_start12,TSPB,45611,18200,27411,2,100,200
NearestNeighborAny_start13,TSPB,45371,18161,27210,2,100,200
NearestNeighborAny_start14,TSPB,45095,19057,26038,2,100,200
NearestNeighborAny_start15,TSPB,45841,19126,26715,2,100,200
NearestNeighborAny_start16,TSPB,44472,19667,24805,2,100,200
NearestNeighborAny_start17,TSPB,44977,19732,25245,3,100,200
NearestNeighborAny_start18,TSPB,50566,18953,31613,2,100,200
NearestNeighborAny_start19,TSPB,44804,19666,25138,2,100,200
NearestNeighborAny_start20,TSPB,44446,18973,25473,2,100,200
NearestNeighborAny_start21,TSPB,47785,21676,26109,2,100,200
NearestNeighborAny_start22,TSPB,44484,19011,25473,2,100,200
NearestNeighborAny_start23,TSPB,44878,18965,25913,2,100,200
NearestNeighborAny_start24,TSPB,44682,19315,25367,2,100,200
NearestNeighborAny_start25,TSPB,51172,21049,30123,2,100,200
NearestNeighborAny_start26,TSPB,44723,18922,25801,3,100,200
NearestNeighborAny_start27,TSPB,44472,19667,24805,2,100,200
NearestNeighborAny_start28,TSPB,44446,18973,25473,2,100,200
NearestNeighborAny_start29,TSPB,45371,18161,27210,2,100,200
NearestNeighborAny_start30,TSPB,44743,19366,25377,2,100,200
NearestNeighborAny_start31,TSPB,44472,19667,24805,2,100,200
NearestNeighborAny_start32,TSPB,44830,19587,25243,3,100,200
NearestNeighborAny_start33,TSPB,45371,18161,27210,2,100,200
NearestNeighborAny_start34,TSPB,50566,18953,31613,2,100,200
NearestNeighborAny_start35,TSPB,45371,18161,27210,2,100,200
NearestNeighborAny_start36,TSPB,44446,18973,25473,2,100,200
NearestNeighborAny_start37,TSPB,48665,20179,28486,3,100,200
NearestNeighborAny_start38,TSPB,44472,19667,24805,2,100,200
NearestNeighborAny_start39,TSPB,45582,18173,27409,2,100,200
NearestNeighborAny_start40,TSPB,44683,19751,24932,2,100,200
NearestNeighborAny_start41,TSPB,48223,20007,28216,2,100,200
NearestNeighborAny_start42,TSPB,44709,19595,25114,3,100,200
NearestNeighborAny_start43,TSPB,45407,18251,27156,2,100,200
NearestNeighborAny_start44,TSPB,45034,19770,25264,2,100,200
NearestNeighborAny_start45,TSPB,44472,19667,24805,2,100,200
NearestNeighborAny_start46,TSPB,44818,19677,25141,3,100,200
NearestNeighborAny_start47,TSPB,44446,18973,25473,2,100,200
NearestNeighborAny_start48,TSPB,50606,23459,27147,2,100,200
NearestNeighborAny_start49,TSPB,45540,18318,27222,2,100,200
NearestNeighborAny_start50,TSPB,48178,21897,26281,2,100,200
NearestNeighborAny_start51,TSPB,44683,19751,24932,2,100,200
NearestNeighborAny_start52,TSPB,45035,18873,26162,2,100,200
NearestNeighborAny_start53,TSPB,47812,20773,27039,2,100,200
NearestNeighborAny_start54,TSPB,44472,19667,24805,2,100,200
NearestNeighborAny_start55,TSPB,50566,18953,31613,2,100,200
NearestNeighborAny_start56,TSPB,47991,22037,25954,2,100,200
NearestNeighborAny_start57,TSPB,44916,18893,26023,2,100,200
NearestNeighborAny_start58,TSPB,48948,22248,26700,2,100,200
NearestNeighborAny_start59,TSPB,44795,18926,25869,2,100,200
NearestNeighborAny_start60,TSPB,51462,19544,31918,2,100,200
NearestNeighborAny_start61,TSPB,44446,18973,25473,2,100,200
NearestNeighborAny_start62,TSPB,50566,18953,31613,2,100,200
NearestNeighborAny_start63,TSPB,44683,19751,24932,2,100,200
NearestNeighborAny_start64,TSPB,46180,18726,27454,2,100,200
NearestNeighborAny_start65,TSPB,45635,18209,27426,2,100,200
NearestNeighborAny_start66,TSPB,44446,18973,25473,2,100,200
NearestNeighborAny_start67,TSPB,45648,18237,27411,2,100,200
NearestNeighborAny_start68,TSPB,48214,21885,26329,2,100,200
NearestNeighborAny_start69,TSPB,46138,19138,27000,2,100,200
NearestNeighborAny_start70,TSPB,45841,19126,26715,2,100,200
NearestNeighborAny_start71,TSPB,45451,18189,27262,2,100,200
NearestNeighborAny_start72,TSPB,44866,19722,25144,2,100,200
NearestNeighborAny_start73,TSPB,44431,19626,24805,2,100,200
NearestNeighborAny_start74,TSPB,45005,19519,25486,2,100,200
NearestNeighborAny_start75,TSPB,46115,18951,27164,2,100,200
NearestNeighborAny_start76,TSPB,46253,18969,27284,2,100,200
NearestNeighborAny_start77,TSPB,44446,18973,25473,2,100,200
NearestNeighborAny_start78,TSPB,44472,19667,24805,2,100,200
NearestNeighborAny_start79,TSPB,44823,18921,25902,2,100,200
NearestNeighborAny_start80,TSPB,44472,19667,24805,2,100,200
NearestNeighborAny_start81,TSPB,44446,18973,25473,2,100,200
NearestNeighborAny_start82,TSPB,48377,22444,25933,2,100,200
NearestNeighborAny_start83,TSPB,50589,18976,31613,2,100,200
NearestNeighborAny_start84,TSPB,47703,20742,26961,2,100,200
NearestNeighborAny_start85,TSPB,45689,18403,27286,2,100,200
NearestNeighborAny_start86,TSPB,44446,18973,25473,2,100,200
NearestNeighborAny_start87,TSPB,47856,21670,26186,1,100,200
NearestNeighborAny_start88,TSPB,44682,19004,25678,2,100,200
NearestNeighborAny_start89,TSPB,45544,18334,27210,3,100,200
NearestNeighborAny_start90,TSPB,44683,19751,24932,2,100,200
NearestNeighborAny_start91,TSPB,44446,18973,25473,2,100,200
NearestNeighborAny_start92,TSPB,45078,19738,25340,2,100,200
NearestNeighborAny_start93,TSPB,51375,24121,27254,2,100,200
NearestNeighborAny_start94,TSPB,44446,18973,25473,2,100,200
NearestNeighborAny_start95,TSPB,45317,19485,25832,1,100,200
NearestNeighborAny_start96,TSPB,44866,19594,25272,2,100,200
NearestNeighborAny_start97,TSPB,44743,19021,25722,3,100,200
NearestNeighborAny_start98,TSPB,44834,19379,25455,2,100,200
NearestNeighborAny_start99,TSPB,45317,19485,25832,2,100,200
NearestNeighborAny_start100,TSPB,44683,19751,24932,2,100,200
NearestNeighborAny_start101,TSPB,44949,18925,26024,2,100,200
NearestNeighborAny_start102,TSPB,44801,19623,25178,2,100,200
NearestNeighborAny_start103,TSPB,44446,18973,25473,2,100,200
NearestNeighborAny_start104,TSPB,47851,21849,26002,2,100,200
NearestNeighborAny_start105,TSPB,44826,19615,25211,2,100,200
NearestNeighborAny_start106,TSPB,50566,18953,31613,2,100,200
NearestNeighborAny_start107,TSPB,44683,19751,24932,2,100,200
NearestNeighborAny_start108,TSPB,53438,23051,30387,2,100,200
NearestNeighborAny_start109,TSPB,45371,18161,27210,3,100,200
NearestNeighborAny_start110,TSPB,51341,19052,32289,2,100,200
NearestNeighborAny_start111,TSPB,48200,20132,28068,2,100,200
NearestNeighborAny_start112,TSPB,44779,19671,25108,2,100,200
NearestNeighborAny_start113,TSPB,44446,18973,25473,2,100,200
NearestNeighborAny_start114,TSPB,45544,18334,27210,2,100,200
NearestNeighborAny_start115,TSPB,44809,19407,25402,2,100,200
NearestNeighborAny_start116,TSPB,44898,19644,25254,2,100,200
NearestNeighborAny_start117,TSPB,44472,19667,24805,2,100,200
NearestNeighborAny_start118,TSPB,44915,19566,25349,2,100,200
NearestNeighborAny_start119,TSPB,48629,22074,26555,2,100,200
NearestNeighborAny_start120,TSPB,44879,19637,25242,2,100,200
NearestNeighborAny_start121,TSPB,44683,19751,24932,2,100,200
NearestNeighborAny_start122,TSPB,44683,19751,24932,2,100,200
NearestNeighborAny_start123,TSPB,44931,19482,25449,2,100,200
NearestNeighborAny_start124,TSPB,50566,18953,31613,2,100,200
NearestNeighborAny_start125,TSPB,44738,19757,24981,2,100,200
NearestNeighborAny_start126,TSPB,45944,19036,26908,2,100,200
NearestNeighborAny_start127,TSPB,45544,18334,27210,3,100,200
NearestNeighborAny_start128,TSPB,50566,18953,31613,2,100,200
NearestNeighborAny_start129,TSPB,44995,18850,26145,2,100,200
NearestNeighborAny_start130,TSPB,45317,19485,25832,1,100,200
NearestNeighborAny_start131,TSPB,44836,19963,24873,2,100,200
NearestNeighborAny_start132,TSPB,45371,18161,27210,2,100,200
NearestNeighborAny_start133,TSPB,44670,19991,24679,2,100,200
NearestNeighborAny_start134,TSPB,45495,18459,27036,2,100,200
NearestNeighborAny_start135,TSPB,44683,19751,24932,3,100,200
NearestNeighborAny_start136,TSPB,44431,19626,24805,2,100,200
NearestNeighborAny_start137,TSPB,45544,18334,27210,2,100,200
NearestNeighborAny_start138,TSPB,45371,18161,27210,2,100,200
NearestNeighborAny_start139,TSPB,45371,18161,27210,2,100,200
NearestNeighborAny_start140,TSPB,47604,20834,26770,2,100,200
NearestNeighborAny_start141,TSPB,44446,18973,25473,1,100,200
NearestNeighborAny_start142,TSPB,44472,19667,24805,2,100,200
NearestNeighborAny_start143,TSPB,44546,19073,25473,3,100,200
NearestNeighborAny_start144,TSPB,47921,22068,25853,2,100,200
NearestNeighborAny_start145,TSPB,45841,19126,26715,2,100,200
NearestNeighborAny_start146,TSPB,44875,19042,25833,2,100,200
NearestNeighborAny_start147,TSPB,45371,18161,27210,2,100,200
NearestNeighborAny_start148,TSPB,44446,18973,25473,2,100,200
NearestNeighborAny_start149,TSPB,44446,18973,25473,2,100,200
NearestNeighborAny_start150,TSPB,45619,18178,27441,2,100,200
NearestNeighborAny_start151,TSPB,44717,19595,25122,2,100,200
NearestNeighborAny_start152,TSPB,47604,20834,26770,2,100,200
NearestNeighborAny_start153,TSPB,44446,18973,25473,2,100,200
NearestNeighborAny_start154,TSPB,44845,18945,25900,2,100,200
NearestNeighborAny_start155,TSPB,47404,20778,26626,2,100,200
NearestNeighborAny_start156,TSPB,44472,19667,24805,2,100,200
NearestNeighborAny_start157,TSPB,48182,21959,26223,2,100,200
NearestNeighborAny_start158,TSPB,51172,21049,30123,2,100,200
NearestNeighborAny_start159,TSPB,44861,19066,25795,2,100,200
NearestNeighborAny_start160,TSPB,45371,18161,27210,2,100,200
NearestNeighborAny_start161,TSPB,45342,18116,27226,1,100,200
NearestNeighborAny_start162,TSPB,44472,19667,24805,2,100,200
NearestNeighborAny_start163,TSPB,44446,18973,25473,3,100,200
NearestNeighborAny_start164,TSPB,44492,19267,25225,1,100,200
NearestNeighborAny_start165,TSPB,44745,19118,25627,2,100,200
NearestNeighborAny_start166,TSPB,44446,18973,25473,2,100,200
NearestNeighborAny_start167,TSPB,47799,20837,26962,2,100,200
NearestNeighborAny_start168,TSPB,45371,18161,27210,2,100,200
NearestNeighborAny_start169,TSPB,45371,18161,27210,2,100,200
NearestNeighborAny_start170,TSPB,50566,18953,31613,2,100,200
NearestNeighborAny_start171,TSPB,48577,22367,26210,2,100,200
NearestNeighborAny_start172,TSPB,44726,19069,25657,2,100,200
NearestNeighborAny_start173,TSPB,44953,19800,25153,2,100,200
NearestNeighborAny_start174,TSPB,47686,20486,27200,2,100,200
NearestNeighborAny_start175,TSPB,44472,19667,24805,2,100,200
NearestNeighborAny_start176,TSPB,44446,18973,25473,2,100,200
NearestNeighborAny_start177,TSPB,44472,19667,24805,2,100,200
NearestNeighborAny_start178,TSPB,44869,19741,25128,2,100,200
NearestNeighborAny_start179,TSPB,44446,18973,25473,1,100,200
NearestNeighborAny_start180,TSPB,44446,18973,25473,2,100,200
NearestNeighborAny_start181,TSPB,51548,19314,32234,2,100,200
NearestNeighborAny_start182,TSPB,47972,21970,26002,2,100,200
NearestNeighborAny_start183,TSPB,47604,20834,26770,2,100,200
NearestNeighborAny_start184,TSPB,47404,20778,26626,2,100,200
NearestNeighborAny_start185,TSPB,44446,18973,25473,2,100,200
NearestNeighborAny_start186,TSPB,44818,18609,26209,2,100,200
NearestNeighborAny_start187,TSPB,44446,18973,25473,2,100,200
NearestNeighborAny_start188,TSPB,45371,18161,27210,2,100,200
NearestNeighborAny_start189,TSPB,46027,19349,26678,2,100,200
NearestNeighborAny_start190,TSPB,44472,19667,24805,2,100,200
NearestNeighborAny_start191,TSPB,44746,19929,24817,2,100,200
NearestNeighborAny_start192,TSPB,45592,18163,27429,1,100,200
NearestNeighborAny_start193,TSPB,44417,19612,24805,2,100,200
NearestNeighborAny_start194,TSPB,44446,18973,25473,2,100,200
NearestNeighborAny_start195,TSPB,45371,18161,27210,2,100,200
NearestNeighborAny_start196,TSPB,45790,19430,26360,2,100,200
NearestNeighborAny_start197,TSPB,44683,19309,25374,2,100,200
NearestNeighborAny_start198,TSPB,44472,19667,24805,2,100,200
NearestNeighborAny_start199,TSPB,44824,19087,25737,2,100,200
