algorithm,instance,objective_value,path_length,node_costs,computation_time_ms,selected_nodes,total_nodes
RandomSolution_start0,TSPB,226054,175909,50145,0,100,200
RandomSolution_start1,TSPB,207950,160606,47344,0,100,200
RandomSolution_start2,TSPB,212832,163577,49255,0,100,200
RandomSolution_start3,TSPB,218552,168733,49819,0,100,200
RandomSolution_start4,TSPB,204134,154972,49162,0,100,200
RandomSolution_start5,TSPB,231004,180972,50032,0,100,200
RandomSolution_start6,TSPB,220944,170517,50427,0,100,200
RandomSolution_start7,TSPB,220783,169821,50962,0,100,200
RandomSolution_start8,TSPB,233544,183221,50323,0,100,200
RandomSolution_start9,TSPB,224461,175674,48787,0,100,200
RandomSolution_start10,TSPB,218548,168149,50399,0,100,200
RandomSolution_start11,TSPB,206350,158124,48226,0,100,200
RandomSolution_start12,TSPB,228873,181438,47435,0,100,200
RandomSolution_start13,TSPB,224074,173729,50345,0,100,200
RandomSolution_start14,TSPB,212670,166378,46292,0,100,200
RandomSolution_start15,TSPB,210401,161911,48490,0,100,200
RandomSolution_start16,TSPB,204808,159745,45063,0,100,200
RandomSolution_start17,TSPB,205367,154208,51159,1,100,200
RandomSolution_start18,TSPB,213613,163565,50048,0,100,200
RandomSolution_start19,TSPB,221519,172858,48661,0,100,200
RandomSolution_start20,TSPB,208739,157059,51680,0,100,200
RandomSolution_start21,TSPB,214275,165476,48799,0,100,200
RandomSolution_start22,TSPB,225163,172726,52437,0,100,200
RandomSolution_start23,TSPB,220089,171122,48967,0,100,200
RandomSolution_start24,TSPB,208340,158882,49458,0,100,200
RandomSolution_start25,TSPB,224185,178200,45985,0,100,200
RandomSolution_start26,TSPB,201733,153344,48389,0,100,200
RandomSolution_start27,TSPB,225286,175075,50211,0,100,200
RandomSolution_start28,TSPB,207766,158420,49346,0,100,200
RandomSolution_start29,TSPB,212795,164809,47986,0,100,200
RandomSolution_start30,TSPB,209851,157390,52461,0,100,200
RandomSolution_start31,TSPB,224769,173406,51363,0,100,200
RandomSolution_start32,TSPB,213608,164078,49530,0,100,200
RandomSolution_start33,TSPB,225097,175605,49492,0,100,200
RandomSolution_start34,TSPB,213209,159685,53524,0,100,200
RandomSolution_start35,TSPB,199085,150363,48722,0,100,200
RandomSolution_start36,TSPB,208701,157931,50770,0,100,200
RandomSolution_start37,TSPB,214696,165509,49187,0,100,200
RandomSolution_start38,TSPB,206447,156639,49808,0,100,200
RandomSolution_start39,TSPB,222350,171219,51131,0,100,200
RandomSolution_start40,TSPB,206137,153830,52307,0,100,200
RandomSolution_start41,TSPB,217575,171447,46128,0,100,200
RandomSolution_start42,TSPB,221715,173146,48569,0,100,200
RandomSolution_start43,TSPB,218667,171778,46889,0,100,200
RandomSolution_start44,TSPB,206709,158041,48668,0,100,200
RandomSolution_start45,TSPB,215508,170249,45259,0,100,200
RandomSolution_start46,TSPB,203823,150301,53522,0,100,200
RandomSolution_start47,TSPB,209260,159834,49426,0,100,200
RandomSolution_start48,TSPB,215152,166203,48949,0,100,200
RandomSolution_start49,TSPB,208834,158984,49850,1,100,200
RandomSolution_start50,TSPB,214450,165532,48918,0,100,200
RandomSolution_start51,TSPB,215999,168144,47855,0,100,200
RandomSolution_start52,TSPB,222789,172107,50682,0,100,200
RandomSolution_start53,TSPB,206718,156246,50472,0,100,200
RandomSolution_start54,TSPB,203377,156125,47252,0,100,200
RandomSolution_start55,TSPB,217105,169558,47547,0,100,200
RandomSolution_start56,TSPB,215980,164474,51506,0,100,200
RandomSolution_start57,TSPB,213984,166297,47687,0,100,200
RandomSolution_start58,TSPB,227979,178381,49598,0,100,200
RandomSolution_start59,TSPB,204598,150198,54400,0,100,200
RandomSolution_start60,TSPB,221647,170831,50816,0,100,200
RandomSolution_start61,TSPB,213610,166900,46710,0,100,200
RandomSolution_start62,TSPB,214838,166977,47861,0,100,200
RandomSolution_start63,TSPB,215521,166650,48871,0,100,200
RandomSolution_start64,TSPB,231463,179770,51693,0,100,200
RandomSolution_start65,TSPB,208275,154247,54028,0,100,200
RandomSolution_start66,TSPB,203146,153577,49569,0,100,200
RandomSolution_start67,TSPB,220621,168180,52441,0,100,200
RandomSolution_start68,TSPB,211721,159899,51822,0,100,200
RandomSolution_start69,TSPB,202276,153802,48474,0,100,200
RandomSolution_start70,TSPB,210622,161706,48916,0,100,200
RandomSolution_start71,TSPB,221355,167887,53468,0,100,200
RandomSolution_start72,TSPB,214805,164475,50330,0,100,200
RandomSolution_start73,TSPB,214481,166992,47489,0,100,200
RandomSolution_start74,TSPB,205156,157359,47797,0,100,200
RandomSolution_start75,TSPB,212967,164663,48304,0,100,200
RandomSolution_start76,TSPB,232922,182392,50530,0,100,200
RandomSolution_start77,TSPB,213977,164520,49457,0,100,200
RandomSolution_start78,TSPB,202558,150464,52094,0,100,200
RandomSolution_start79,TSPB,210941,160064,50877,0,100,200
RandomSolution_start80,TSPB,227575,178256,49319,0,100,200
RandomSolution_start81,TSPB,207242,156007,51235,1,100,200
RandomSolution_start82,TSPB,214485,164814,49671,0,100,200
RandomSolution_start83,TSPB,214996,165895,49101,0,100,200
RandomSolution_start84,TSPB,206521,159071,47450,0,100,200
RandomSolution_start85,TSPB,199484,149199,50285,0,100,200
RandomSolution_start86,TSPB,220908,171058,49850,0,100,200
RandomSolution_start87,TSPB,205626,160241,45385,0,100,200
RandomSolution_start88,TSPB,223889,173841,50048,0,100,200
RandomSolution_start89,TSPB,213428,159638,53790,0,100,200
RandomSolution_start90,TSPB,224905,178379,46526,0,100,200
RandomSolution_start91,TSPB,217581,170219,47362,0,100,200
RandomSolution_start92,TSPB,219453,171458,47995,0,100,200
RandomSolution_start93,TSPB,222852,173652,49200,0,100,200
RandomSolution_start94,TSPB,218220,166471,51749,0,100,200
RandomSolution_start95,TSPB,200915,153359,47556,0,100,200
RandomSolution_start96,TSPB,212631,164247,48384,0,100,200
RandomSolution_start97,TSPB,204190,154700,49490,0,100,200
RandomSolution_start98,TSPB,201023,152240,48783,0,100,200
RandomSolution_start99,TSPB,215915,166860,49055,0,100,200
RandomSolution_start100,TSPB,197663,151016,46647,0,100,200
RandomSolution_start101,TSPB,225254,173431,51823,0,100,200
RandomSolution_start102,TSPB,212280,162646,49634,0,100,200
RandomSolution_start103,TSPB,227461,180695,46766,0,100,200
RandomSolution_start104,TSPB,214078,164888,49190,0,100,200
RandomSolution_start105,TSPB,222641,171265,51376,0,100,200
RandomSolution_start106,TSPB,204782,157670,47112,0,100,200
RandomSolution_start107,TSPB,221381,172104,49277,0,100,200
RandomSolution_start108,TSPB,198929,152777,46152,0,100,200
RandomSolution_start109,TSPB,203771,151534,52237,0,100,200
RandomSolution_start110,TSPB,215620,164793,50827,0,100,200
RandomSolution_start111,TSPB,216349,164654,51695,0,100,200
RandomSolution_start112,TSPB,207668,155669,51999,0,100,200
RandomSolution_start113,TSPB,227704,177403,50301,1,100,200
RandomSolution_start114,TSPB,214083,163495,50588,0,100,200
RandomSolution_start115,TSPB,219059,167309,51750,0,100,200
RandomSolution_start116,TSPB,211162,162187,48975,0,100,200
RandomSolution_start117,TSPB,221969,171179,50790,0,100,200
RandomSolution_start118,TSPB,211629,163879,47750,0,100,200
RandomSolution_start119,TSPB,217131,163919,53212,0,100,200
RandomSolution_start120,TSPB,224324,176385,47939,0,100,200
RandomSolution_start121,TSPB,208756,159199,49557,0,100,200
RandomSolution_start122,TSPB,214019,164145,49874,0,100,200
RandomSolution_start123,TSPB,215141,168406,46735,0,100,200
RandomSolution_start124,TSPB,213966,161124,52842,0,100,200
RandomSolution_start125,TSPB,203580,153623,49957,0,100,200
RandomSolution_start126,TSPB,211084,161776,49308,0,100,200
RandomSolution_start127,TSPB,222764,172250,50514,0,100,200
RandomSolution_start128,TSPB,216578,168335,48243,0,100,200
RandomSolution_start129,TSPB,209443,161121,48322,0,100,200
RandomSolution_start130,TSPB,199327,151711,47616,0,100,200
RandomSolution_start131,TSPB,216350,169335,47015,0,100,200
RandomSolution_start132,TSPB,212880,162633,50247,0,100,200
RandomSolution_start133,TSPB,204616,156162,48454,0,100,200
RandomSolution_start134,TSPB,215270,165152,50118,0,100,200
RandomSolution_start135,TSPB,221583,172462,49121,0,100,200
RandomSolution_start136,TSPB,219679,171198,48481,0,100,200
RandomSolution_start137,TSPB,197164,146862,50302,0,100,200
RandomSolution_start138,TSPB,211533,162647,48886,0,100,200
RandomSolution_start139,TSPB,210916,160778,50138,0,100,200
RandomSolution_start140,TSPB,204246,150824,53422,0,100,200
RandomSolution_start141,TSPB,215555,163300,52255,0,100,200
RandomSolution_start142,TSPB,201324,152970,48354,0,100,200
RandomSolution_start143,TSPB,204898,154711,50187,0,100,200
RandomSolution_start144,TSPB,210025,161575,48450,0,100,200
RandomSolution_start145,TSPB,196731,148644,48087,0,100,200
RandomSolution_start146,TSPB,211634,158409,53225,0,100,200
RandomSolution_start147,TSPB,225325,170541,54784,1,100,200
RandomSolution_start148,TSPB,216757,167363,49394,0,100,200
RandomSolution_start149,TSPB,216071,172466,43605,0,100,200
RandomSolution_start150,TSPB,219356,168784,50572,0,100,200
RandomSolution_start151,TSPB,209519,163364,46155,0,100,200
RandomSolution_start152,TSPB,223290,170761,52529,0,100,200
RandomSolution_start153,TSPB,219285,172464,46821,0,100,200
RandomSolution_start154,TSPB,204746,153548,51198,0,100,200
RandomSolution_start155,TSPB,196222,149884,46338,0,100,200
RandomSolution_start156,TSPB,211625,163257,48368,0,100,200
RandomSolution_start157,TSPB,196341,149018,47323,0,100,200
RandomSolution_start158,TSPB,213571,164228,49343,0,100,200
RandomSolution_start159,TSPB,215030,165212,49818,0,100,200
RandomSolution_start160,TSPB,204951,155930,49021,0,100,200
RandomSolution_start161,TSPB,212660,164263,48397,0,100,200
RandomSolution_start162,TSPB,203247,154450,48797,0,100,200
RandomSolution_start163,TSPB,208234,158698,49536,0,100,200
RandomSolution_start164,TSPB,209376,161076,48300,0,100,200
RandomSolution_start165,TSPB,224250,173333,50917,0,100,200
RandomSolution_start166,TSPB,195192,147933,47259,0,100,200
RandomSolution_start167,TSPB,225065,175444,49621,0,100,200
RandomSolution_start168,TSPB,222315,172302,50013,0,100,200
RandomSolution_start169,TSPB,220312,170246,50066,0,100,200
RandomSolution_start170,TSPB,209809,160547,49262,0,100,200
RandomSolution_start171,TSPB,210696,157725,52971,0,100,200
RandomSolution_start172,TSPB,220248,169777,50471,0,100,200
RandomSolution_start173,TSPB,220955,169453,51502,0,100,200
RandomSolution_start174,TSPB,223496,171381,52115,0,100,200
RandomSolution_start175,TSPB,224001,171456,52545,0,100,200
RandomSolution_start176,TSPB,220495,173152,47343,0,100,200
RandomSolution_start177,TSPB,217600,168265,49335,0,100,200
RandomSolution_start178,TSPB,223180,174167,49013,0,100,200
RandomSolution_start179,TSPB,214617,170053,44564,0,100,200
RandomSolution_start180,TSPB,210324,162186,48138,1,100,200
RandomSolution_start181,TSPB,207543,156084,51459,0,100,200
RandomSolution_start182,TSPB,216229,167800,48429,0,100,200
RandomSolution_start183,TSPB,213096,166754,46342,0,100,200
RandomSolution_start184,TSPB,225798,173234,52564,0,100,200
RandomSolution_start185,TSPB,219809,170634,49175,0,100,200
RandomSolution_start186,TSPB,207333,161461,45872,0,100,200
RandomSolution_start187,TSPB,219748,167472,52276,0,100,200
RandomSolution_start188,TSPB,198072,151638,46434,0,100,200
RandomSolution_start189,TSPB,218481,169125,49356,0,100,200
RandomSolution_start190,TSPB,206984,159517,47467,0,100,200
RandomSolution_start191,TSPB,223094,170912,52182,0,100,200
RandomSolution_start192,TSPB,201565,150002,51563,0,100,200
RandomSolution_start193,TSPB,215464,164350,51114,0,100,200
RandomSolution_start194,TSPB,218647,165947,52700,0,100,200
RandomSolution_start195,TSPB,221061,169760,51301,0,100,200
RandomSolution_start196,TSPB,212451,165139,47312,0,100,200
RandomSolution_start197,TSPB,202538,152940,49598,0,100,200
RandomSolution_start198,TSPB,215284,163917,51367,0,100,200
RandomSolution_start199,TSPB,211570,162249,49321,0,100,200
GreedyCycle_start0,TSPB,50243,20579,29664,2,100,200
GreedyCycle_start1,TSPB,52933,20350,32583,2,100,200
GreedyCycle_start2,TSPB,49617,20111,29506,2,100,200
GreedyCycle_start3,TSPB,52260,19636,32624,1,100,200
GreedyCycle_start4,TSPB,51849,19333,32516,2,100,200
GreedyCycle_start5,TSPB,49394,21169,28225,2,100,200
GreedyCycle_start6,TSPB,49413,20201,29212,2,100,200
GreedyCycle_start7,TSPB,49836,21178,28658,1,100,200
GreedyCycle_start8,TSPB,50141,20317,29824,2,100,200
GreedyCycle_start9,TSPB,51895,19379,32516,2,100,200
GreedyCycle_start10,TSPB,52665,20954,31711,2,100,200
GreedyCycle_start11,TSPB,50243,20579,29664,2,100,200
GreedyCycle_start12,TSPB,50536,20334,30202,1,100,200
GreedyCycle_start13,TSPB,49413,20201,29212,2,100,200
GreedyCycle_start14,TSPB,50618,20029,30589,2,100,200
GreedyCycle_start15,TSPB,52260,19636,32624,2,100,200
GreedyCycle_start16,TSPB,52985,20415,32570,1,100,200
GreedyCycle_start17,TSPB,57324,19155,38169,2,100,200
GreedyCycle_start18,TSPB,52079,20966,31113,2,100,200
GreedyCycle_start19,TSPB,53026,20443,32583,1,100,200
GreedyCycle_start20,TSPB,52247,19655,32592,2,100,200
GreedyCycle_start21,TSPB,49402,21177,28225,2,100,200
GreedyCycle_start22,TSPB,51149,19545,31604,1,100,200
GreedyCycle_start23,TSPB,52340,19657,32683,2,100,200
GreedyCycle_start24,TSPB,53294,20354,32940,2,100,200
GreedyCycle_start25,TSPB,49678,21453,28225,2,100,200
GreedyCycle_start26,TSPB,50970,19366,31604,1,100,200
GreedyCycle_start27,TSPB,53047,20477,32570,2,100,200
GreedyCycle_start28,TSPB,51849,19333,32516,2,100,200
GreedyCycle_start29,TSPB,50243,20579,29664,1,100,200
GreedyCycle_start30,TSPB,51895,21411,30484,2,100,200
GreedyCycle_start31,TSPB,50608,21253,29355,2,100,200
GreedyCycle_start32,TSPB,52694,20918,31776,1,100,200
GreedyCycle_start33,TSPB,50243,20579,29664,2,100,200
GreedyCycle_start34,TSPB,50997,21068,29929,2,100,200
GreedyCycle_start35,TSPB,50243,20579,29664,2,100,200
GreedyCycle_start36,TSPB,50392,20568,29824,1,100,200
GreedyCycle_start37,TSPB,50760,20139,30621,2,100,200
GreedyCycle_start38,TSPB,52985,20415,32570,2,100,200
GreedyCycle_start39,TSPB,50690,20490,30200,1,100,200
GreedyCycle_start40,TSPB,57140,18971,38169,2,100,200
GreedyCycle_start41,TSPB,50583,20128,30455,2,100,200
GreedyCycle_start42,TSPB,51793,21572,30221,2,100,200
GreedyCycle_start43,TSPB,50042,20218,29824,1,100,200
GreedyCycle_start44,TSPB,52997,20470,32527,2,100,200
GreedyCycle_start45,TSPB,49394,21169,28225,2,100,200
GreedyCycle_start46,TSPB,51188,20942,30246,2,100,200
GreedyCycle_start47,TSPB,52250,19658,32592,2,100,200
GreedyCycle_start48,TSPB,51892,19810,32082,1,100,200
GreedyCycle_start49,TSPB,50057,20233,29824,2,100,200
GreedyCycle_start50,TSPB,50735,20152,30583,2,100,200
GreedyCycle_start51,TSPB,52665,20954,31711,2,100,200
GreedyCycle_start52,TSPB,50970,19366,31604,1,100,200
GreedyCycle_start53,TSPB,51292,18776,32516,2,100,200
GreedyCycle_start54,TSPB,50608,21253,29355,2,100,200
GreedyCycle_start55,TSPB,52079,20966,31113,2,100,200
GreedyCycle_start56,TSPB,49593,21368,28225,2,100,200
GreedyCycle_start57,TSPB,51040,19122,31918,2,100,200
GreedyCycle_start58,TSPB,49459,20677,28782,2,100,200
GreedyCycle_start59,TSPB,51849,19333,32516,1,100,200
GreedyCycle_start60,TSPB,52247,19655,32592,2,100,200
GreedyCycle_start61,TSPB,50392,20568,29824,2,100,200
GreedyCycle_start62,TSPB,52079,20966,31113,2,100,200
GreedyCycle_start63,TSPB,52665,20954,31711,1,100,200
GreedyCycle_start64,TSPB,51588,19371,32217,2,100,200
GreedyCycle_start65,TSPB,52484,19736,32748,2,100,200
GreedyCycle_start66,TSPB,52250,19658,32592,1,100,200
GreedyCycle_start67,TSPB,52887,20941,31946,2,100,200
GreedyCycle_start68,TSPB,50807,20176,30631,2,100,200
GreedyCycle_start69,TSPB,51001,20836,30165,1,100,200
GreedyCycle_start70,TSPB,52260,19636,32624,2,100,200
GreedyCycle_start71,TSPB,52295,21182,31113,2,100,200
GreedyCycle_start72,TSPB,57140,18971,38169,2,100,200
GreedyCycle_start73,TSPB,50608,21253,29355,1,100,200
GreedyCycle_start74,TSPB,53407,20719,32688,2,100,200
GreedyCycle_start75,TSPB,51625,19689,31936,2,100,200
GreedyCycle_start76,TSPB,51591,19535,32056,1,100,200
GreedyCycle_start77,TSPB,50954,19350,31604,2,100,200
GreedyCycle_start78,TSPB,49394,21169,28225,2,100,200
GreedyCycle_start79,TSPB,50674,20221,30453,1,100,200
GreedyCycle_start80,TSPB,50443,21088,29355,2,100,200
GreedyCycle_start81,TSPB,50954,19350,31604,2,100,200
GreedyCycle_start82,TSPB,49402,21177,28225,1,100,200
GreedyCycle_start83,TSPB,51506,19077,32429,2,100,200
GreedyCycle_start84,TSPB,50451,20621,29830,2,100,200
GreedyCycle_start85,TSPB,49001,20856,28145,1,100,200
GreedyCycle_start86,TSPB,50970,19366,31604,2,100,200
GreedyCycle_start87,TSPB,49402,21177,28225,2,100,200
GreedyCycle_start88,TSPB,51490,19360,32130,1,100,200
GreedyCycle_start89,TSPB,50970,19366,31604,2,100,200
GreedyCycle_start90,TSPB,52727,21016,31711,2,100,200
GreedyCycle_start91,TSPB,50392,20568,29824,1,100,200
GreedyCycle_start92,TSPB,53124,20550,32574,2,100,200
GreedyCycle_start93,TSPB,52248,19450,32798,2,100,200
GreedyCycle_start94,TSPB,52250,19658,32592,1,100,200
GreedyCycle_start95,TSPB,50970,19366,31604,2,100,200
GreedyCycle_start96,TSPB,52792,20987,31805,2,100,200
GreedyCycle_start97,TSPB,50954,19350,31604,1,100,200
GreedyCycle_start98,TSPB,53066,20549,32517,2,100,200
GreedyCycle_start99,TSPB,51149,19545,31604,2,100,200
GreedyCycle_start100,TSPB,56757,19324,37433,1,100,200
GreedyCycle_start101,TSPB,52020,19310,32710,3,100,200
GreedyCycle_start102,TSPB,52727,21016,31711,2,100,200
GreedyCycle_start103,TSPB,50970,19366,31604,2,100,200
GreedyCycle_start104,TSPB,50141,20317,29824,2,100,200
GreedyCycle_start105,TSPB,54470,20155,34315,2,100,200
GreedyCycle_start106,TSPB,52079,20966,31113,1,100,200
GreedyCycle_start107,TSPB,57078,18909,38169,2,100,200
GreedyCycle_start108,TSPB,52666,21793,30873,2,100,200
GreedyCycle_start109,TSPB,50243,20579,29664,1,100,200
GreedyCycle_start110,TSPB,51614,18736,32878,2,100,200
GreedyCycle_start111,TSPB,50111,20287,29824,2,100,200
GreedyCycle_start112,TSPB,52964,20381,32583,1,100,200
GreedyCycle_start113,TSPB,50970,19366,31604,2,100,200
GreedyCycle_start114,TSPB,50879,19275,31604,2,100,200
GreedyCycle_start115,TSPB,52614,20817,31797,1,100,200
GreedyCycle_start116,TSPB,52981,20493,32488,2,100,200
GreedyCycle_start117,TSPB,50546,21191,29355,2,100,200
GreedyCycle_start118,TSPB,53066,20549,32517,1,100,200
GreedyCycle_start119,TSPB,51545,20776,30769,2,100,200
GreedyCycle_start120,TSPB,52758,20909,31849,2,100,200
GreedyCycle_start121,TSPB,53026,20443,32583,1,100,200
GreedyCycle_start122,TSPB,52727,21016,31711,2,100,200
GreedyCycle_start123,TSPB,49949,21322,28627,2,100,200
GreedyCycle_start124,TSPB,52079,20966,31113,2,100,200
GreedyCycle_start125,TSPB,52784,21073,31711,1,100,200
GreedyCycle_start126,TSPB,49891,20039,29852,2,100,200
GreedyCycle_start127,TSPB,50970,19366,31604,2,100,200
GreedyCycle_start128,TSPB,51559,18967,32592,1,100,200
GreedyCycle_start129,TSPB,51485,19307,32178,2,100,200
GreedyCycle_start130,TSPB,50970,19366,31604,2,100,200
GreedyCycle_start131,TSPB,52665,20954,31711,1,100,200
GreedyCycle_start132,TSPB,49413,20201,29212,2,100,200
GreedyCycle_start133,TSPB,52727,21016,31711,2,100,200
GreedyCycle_start134,TSPB,49413,20201,29212,2,100,200
GreedyCycle_start135,TSPB,52727,21016,31711,1,100,200
GreedyCycle_start136,TSPB,50443,21088,29355,2,100,200
GreedyCycle_start137,TSPB,50926,19322,31604,2,100,200
GreedyCycle_start138,TSPB,50243,20579,29664,1,100,200
GreedyCycle_start139,TSPB,50243,20579,29664,2,100,200
GreedyCycle_start140,TSPB,51182,18753,32429,2,100,200
GreedyCycle_start141,TSPB,50954,19350,31604,1,100,200
GreedyCycle_start142,TSPB,49394,21169,28225,2,100,200
GreedyCycle_start143,TSPB,50997,21068,29929,2,100,200
GreedyCycle_start144,TSPB,50425,20601,29824,2,100,200
GreedyCycle_start145,TSPB,52260,19636,32624,1,100,200
GreedyCycle_start146,TSPB,50954,19350,31604,2,100,200
GreedyCycle_start147,TSPB,52258,21145,31113,2,100,200
GreedyCycle_start148,TSPB,52250,19658,32592,1,100,200
GreedyCycle_start149,TSPB,51849,19333,32516,2,100,200
GreedyCycle_start150,TSPB,51642,19396,32246,2,100,200
GreedyCycle_start151,TSPB,52933,20350,32583,2,100,200
GreedyCycle_start152,TSPB,51182,18753,32429,1,100,200
GreedyCycle_start153,TSPB,50954,19350,31604,2,100,200
GreedyCycle_start154,TSPB,52250,19658,32592,2,100,200
GreedyCycle_start155,TSPB,50251,20587,29664,1,100,200
GreedyCycle_start156,TSPB,52995,20412,32583,2,100,200
GreedyCycle_start157,TSPB,50611,20086,30525,2,100,200
GreedyCycle_start158,TSPB,49584,22177,27407,1,100,200
GreedyCycle_start159,TSPB,50997,21068,29929,2,100,200
GreedyCycle_start160,TSPB,50243,20579,29664,2,100,200
GreedyCycle_start161,TSPB,52260,19636,32624,1,100,200
GreedyCycle_start162,TSPB,50443,21088,29355,2,100,200
GreedyCycle_start163,TSPB,50970,19366,31604,2,100,200
GreedyCycle_start164,TSPB,50608,21253,29355,2,100,200
GreedyCycle_start165,TSPB,51109,19505,31604,1,100,200
GreedyCycle_start166,TSPB,50970,19366,31604,2,100,200
GreedyCycle_start167,TSPB,50559,20636,29923,2,100,200
GreedyCycle_start168,TSPB,49413,20201,29212,1,100,200
GreedyCycle_start169,TSPB,49413,20201,29212,2,100,200
GreedyCycle_start170,TSPB,51099,21170,29929,2,100,200
GreedyCycle_start171,TSPB,49641,20782,28859,1,100,200
GreedyCycle_start172,TSPB,50970,19366,31604,2,100,200
GreedyCycle_start173,TSPB,50807,20322,30485,2,100,200
GreedyCycle_start174,TSPB,51403,18912,32491,2,100,200
GreedyCycle_start175,TSPB,49394,21169,28225,1,100,200
GreedyCycle_start176,TSPB,50970,19366,31604,2,100,200
GreedyCycle_start177,TSPB,49394,21169,28225,2,100,200
GreedyCycle_start178,TSPB,52727,21016,31711,1,100,200
GreedyCycle_start179,TSPB,50970,19366,31604,2,100,200
GreedyCycle_start180,TSPB,50970,19366,31604,2,100,200
GreedyCycle_start181,TSPB,51728,19068,32660,1,100,200
GreedyCycle_start182,TSPB,50243,20579,29664,2,100,200
GreedyCycle_start183,TSPB,51182,18753,32429,2,100,200
GreedyCycle_start184,TSPB,51221,21406,29815,2,100,200
GreedyCycle_start185,TSPB,50970,19366,31604,1,100,200
GreedyCycle_start186,TSPB,51534,19292,32242,2,100,200
GreedyCycle_start187,TSPB,50954,19350,31604,2,100,200
GreedyCycle_start188,TSPB,49413,20201,29212,1,100,200
GreedyCycle_start189,TSPB,50043,20932,29111,2,100,200
GreedyCycle_start190,TSPB,50443,21088,29355,2,100,200
GreedyCycle_start191,TSPB,52665,20954,31711,1,100,200
GreedyCycle_start192,TSPB,51626,19392,32234,2,100,200
GreedyCycle_start193,TSPB,50608,21253,29355,2,100,200
GreedyCycle_start194,TSPB,50970,19366,31604,1,100,200
GreedyCycle_start195,TSPB,49413,20201,29212,2,100,200
GreedyCycle_start196,TSPB,52611,21451,31160,2,100,200
GreedyCycle_start197,TSPB,53314,20367,32947,2,100,200
GreedyCycle_start198,TSPB,50549,21194,29355,1,100,200
GreedyCycle_start199,TSPB,52247,19655,32592,2,100,200
NearestNeighborEnd_start0,TSPB,55374,28259,27115,0,100,200
NearestNeighborEnd_start1,TSPB,52584,27231,25353,0,100,200
NearestNeighborEnd_start2,TSPB,54369,25952,28417,1,100,200
NearestNeighborEnd_start3,TSPB,53796,25603,28193,0,100,200
NearestNeighborEnd_start4,TSPB,55335,27047,28288,0,100,200
NearestNeighborEnd_start5,TSPB,54997,27145,27852,0,100,200
NearestNeighborEnd_start6,TSPB,55492,28416,27076,0,100,200
NearestNeighborEnd_start7,TSPB,54592,27008,27584,0,100,200
NearestNeighborEnd_start8,TSPB,55937,26791,29146,0,100,200
NearestNeighborEnd_start9,TSPB,54625,26635,27990,0,100,200
NearestNeighborEnd_start10,TSPB,52543,27651,24892,1,100,200
NearestNeighborEnd_start11,TSPB,53417,27062,26355,0,100,200
NearestNeighborEnd_start12,TSPB,55436,27812,27624,0,100,200
NearestNeighborEnd_start13,TSPB,54637,26220,28417,0,100,200
NearestNeighborEnd_start14,TSPB,54085,27589,26496,0,100,200
NearestNeighborEnd_start15,TSPB,54628,26182,28446,0,100,200
NearestNeighborEnd_start16,TSPB,52319,27165,25154,0,100,200
NearestNeighborEnd_start17,TSPB,53001,27509,25492,0,100,200
NearestNeighborEnd_start18,TSPB,55232,27122,28110,1,100,200
NearestNeighborEnd_start19,TSPB,54778,27408,27370,0,100,200
NearestNeighborEnd_start20,TSPB,52915,25884,27031,0,100,200
NearestNeighborEnd_start21,TSPB,56255,27312,28943,0,100,200
NearestNeighborEnd_start22,TSPB,52703,25792,26911,0,100,200
NearestNeighborEnd_start23,TSPB,53255,26126,27129,0,100,200
NearestNeighborEnd_start24,TSPB,53085,27147,25938,0,100,200
NearestNeighborEnd_start25,TSPB,54829,26421,28408,0,100,200
NearestNeighborEnd_start26,TSPB,55766,28862,26904,1,100,200
NearestNeighborEnd_start27,TSPB,53306,27576,25730,0,100,200
NearestNeighborEnd_start28,TSPB,53083,25867,27216,0,100,200
NearestNeighborEnd_start29,TSPB,55210,28095,27115,0,100,200
NearestNeighborEnd_start30,TSPB,52983,27035,25948,0,100,200
NearestNeighborEnd_start31,TSPB,53381,27933,25448,0,100,200
NearestNeighborEnd_start32,TSPB,53008,26910,26098,0,100,200
NearestNeighborEnd_start33,TSPB,53527,27468,26059,0,100,200
NearestNeighborEnd_start34,TSPB,59030,28904,30126,1,100,200
NearestNeighborEnd_start35,TSPB,55417,28302,27115,0,100,200
NearestNeighborEnd_start36,TSPB,52756,27946,24810,0,100,200
NearestNeighborEnd_start37,TSPB,55806,28123,27683,0,100,200
NearestNeighborEnd_start38,TSPB,53038,27353,25685,0,100,200
NearestNeighborEnd_start39,TSPB,55314,27692,27622,0,100,200
NearestNeighborEnd_start40,TSPB,52893,27503,25390,0,100,200
NearestNeighborEnd_start41,TSPB,55825,28308,27517,0,100,200
NearestNeighborEnd_start42,TSPB,53159,27474,25685,1,100,200
NearestNeighborEnd_start43,TSPB,54620,27410,27210,0,100,200
NearestNeighborEnd_start44,TSPB,52993,27725,25268,0,100,200
NearestNeighborEnd_start45,TSPB,55165,27218,27947,0,100,200
NearestNeighborEnd_start46,TSPB,53649,25872,27777,0,100,200
NearestNeighborEnd_start47,TSPB,58125,29029,29096,0,100,200
NearestNeighborEnd_start48,TSPB,56010,28585,27425,0,100,200
NearestNeighborEnd_start49,TSPB,53423,27401,26022,0,100,200
NearestNeighborEnd_start50,TSPB,53971,27481,26490,1,100,200
NearestNeighborEnd_start51,TSPB,54400,27408,26992,0,100,200
NearestNeighborEnd_start52,TSPB,52612,25446,27166,0,100,200
NearestNeighborEnd_start53,TSPB,53962,25791,28171,0,100,200
NearestNeighborEnd_start54,TSPB,53334,27886,25448,0,100,200
NearestNeighborEnd_start55,TSPB,53739,28975,24764,0,100,200
NearestNeighborEnd_start56,TSPB,56145,26804,29341,0,100,200
NearestNeighborEnd_start57,TSPB,56238,30750,25488,1,100,200
NearestNeighborEnd_start58,TSPB,53867,27415,26452,0,100,200
NearestNeighborEnd_start59,TSPB,52858,25686,27172,0,100,200
NearestNeighborEnd_start60,TSPB,53042,26193,26849,0,100,200
NearestNeighborEnd_start61,TSPB,53914,26752,27162,0,100,200
NearestNeighborEnd_start62,TSPB,58259,27795,30464,0,100,200
NearestNeighborEnd_start63,TSPB,52912,27364,25548,0,100,200
NearestNeighborEnd_start64,TSPB,55997,28849,27148,1,100,200
NearestNeighborEnd_start65,TSPB,53855,25462,28393,0,100,200
NearestNeighborEnd_start66,TSPB,57663,28964,28699,0,100,200
NearestNeighborEnd_start67,TSPB,53809,27850,25959,0,100,200
NearestNeighborEnd_start68,TSPB,56408,26802,29606,0,100,200
NearestNeighborEnd_start69,TSPB,55864,28277,27587,0,100,200
NearestNeighborEnd_start70,TSPB,54206,27341,26865,0,100,200
NearestNeighborEnd_start71,TSPB,53606,27796,25810,0,100,200
NearestNeighborEnd_start72,TSPB,52893,27502,25391,0,100,200
NearestNeighborEnd_start73,TSPB,52595,27001,25594,1,100,200
NearestNeighborEnd_start74,TSPB,54572,27248,27324,0,100,200
NearestNeighborEnd_start75,TSPB,54406,28497,25909,0,100,200
NearestNeighborEnd_start76,TSPB,56502,29515,26987,0,100,200
NearestNeighborEnd_start77,TSPB,53689,27416,26273,0,100,200
NearestNeighborEnd_start78,TSPB,55030,27178,27852,0,100,200
NearestNeighborEnd_start79,TSPB,53049,27836,25213,0,100,200
NearestNeighborEnd_start80,TSPB,53151,25952,27199,0,100,200
NearestNeighborEnd_start81,TSPB,53647,27692,25955,1,100,200
NearestNeighborEnd_start82,TSPB,56090,27065,29025,0,100,200
NearestNeighborEnd_start83,TSPB,54519,26591,27928,0,100,200
NearestNeighborEnd_start84,TSPB,54381,26022,28359,0,100,200
NearestNeighborEnd_start85,TSPB,55431,27806,27625,0,100,200
NearestNeighborEnd_start86,TSPB,56949,28494,28455,0,100,200
NearestNeighborEnd_start87,TSPB,56070,27009,29061,0,100,200
NearestNeighborEnd_start88,TSPB,55898,28837,27061,0,100,200
NearestNeighborEnd_start89,TSPB,54333,27926,26407,1,100,200
NearestNeighborEnd_start90,TSPB,52845,27455,25390,0,100,200
NearestNeighborEnd_start91,TSPB,52867,27915,24952,0,100,200
NearestNeighborEnd_start92,TSPB,53233,27038,26195,0,100,200
NearestNeighborEnd_start93,TSPB,56734,29202,27532,0,100,200
NearestNeighborEnd_start94,TSPB,58049,28953,29096,0,100,200
NearestNeighborEnd_start95,TSPB,52592,25514,27078,0,100,200
NearestNeighborEnd_start96,TSPB,53069,26942,26127,0,100,200
NearestNeighborEnd_start97,TSPB,53853,27673,26180,1,100,200
NearestNeighborEnd_start98,TSPB,54683,27308,27375,0,100,200
NearestNeighborEnd_start99,TSPB,52776,25865,26911,0,100,200
NearestNeighborEnd_start100,TSPB,52824,27537,25287,0,100,200
NearestNeighborEnd_start101,TSPB,53072,25569,27503,0,100,200
NearestNeighborEnd_start102,TSPB,52982,26949,26033,0,100,200
NearestNeighborEnd_start103,TSPB,55426,28903,26523,0,100,200
NearestNeighborEnd_start104,TSPB,55903,26878,29025,1,100,200
NearestNeighborEnd_start105,TSPB,53576,25866,27710,0,100,200
NearestNeighborEnd_start106,TSPB,56723,27753,28970,0,100,200
NearestNeighborEnd_start107,TSPB,52856,27466,25390,0,100,200
NearestNeighborEnd_start108,TSPB,54350,26829,27521,0,100,200
NearestNeighborEnd_start109,TSPB,55438,28323,27115,0,100,200
NearestNeighborEnd_start110,TSPB,57471,28496,28975,0,100,200
NearestNeighborEnd_start111,TSPB,52951,27639,25312,0,100,200
NearestNeighborEnd_start112,TSPB,54633,27293,27340,1,100,200
NearestNeighborEnd_start113,TSPB,55851,29383,26468,0,100,200
NearestNeighborEnd_start114,TSPB,55770,29168,26602,0,100,200
NearestNeighborEnd_start115,TSPB,53557,27694,25863,0,100,200
NearestNeighborEnd_start116,TSPB,54657,27171,27486,0,100,200
NearestNeighborEnd_start117,TSPB,53336,27888,25448,0,100,200
NearestNeighborEnd_start118,TSPB,54507,27238,27269,0,100,200
NearestNeighborEnd_start119,TSPB,56515,27274,29241,0,100,200
NearestNeighborEnd_start120,TSPB,53712,27850,25862,1,100,200
NearestNeighborEnd_start121,TSPB,54767,27844,26923,0,100,200
NearestNeighborEnd_start122,TSPB,52653,27586,25067,0,100,200
NearestNeighborEnd_start123,TSPB,54470,26917,27553,0,100,200
NearestNeighborEnd_start124,TSPB,56865,27895,28970,0,100,200
NearestNeighborEnd_start125,TSPB,53384,27660,25724,0,100,200
NearestNeighborEnd_start126,TSPB,54635,27684,26951,0,100,200
NearestNeighborEnd_start127,TSPB,53717,27751,25966,0,100,200
NearestNeighborEnd_start128,TSPB,58056,27897,30159,1,100,200
NearestNeighborEnd_start129,TSPB,55874,28765,27109,0,100,200
NearestNeighborEnd_start130,TSPB,52874,25963,26911,0,100,200
NearestNeighborEnd_start131,TSPB,54786,27753,27033,0,100,200
NearestNeighborEnd_start132,TSPB,53792,25599,28193,0,100,200
NearestNeighborEnd_start133,TSPB,52853,27786,25067,0,100,200
NearestNeighborEnd_start134,TSPB,55382,27757,27625,0,100,200
NearestNeighborEnd_start135,TSPB,52886,27338,25548,0,100,200
NearestNeighborEnd_start136,TSPB,54927,28004,26923,1,100,200
NearestNeighborEnd_start137,TSPB,53882,27973,25909,0,100,200
NearestNeighborEnd_start138,TSPB,54974,27419,27555,0,100,200
NearestNeighborEnd_start139,TSPB,54369,28091,26278,0,100,200
NearestNeighborEnd_start140,TSPB,55111,26823,28288,0,100,200
NearestNeighborEnd_start141,TSPB,52960,28150,24810,0,100,200
NearestNeighborEnd_start142,TSPB,55197,27180,28017,0,100,200
NearestNeighborEnd_start143,TSPB,55921,27194,28727,0,100,200
NearestNeighborEnd_start144,TSPB,53282,27478,25804,1,100,200
NearestNeighborEnd_start145,TSPB,53934,25741,28193,0,100,200
NearestNeighborEnd_start146,TSPB,55392,26627,28765,0,100,200
NearestNeighborEnd_start147,TSPB,52969,27965,25004,0,100,200
NearestNeighborEnd_start148,TSPB,53140,26291,26849,0,100,200
NearestNeighborEnd_start149,TSPB,52923,25575,27348,0,100,200
NearestNeighborEnd_start150,TSPB,53690,28163,25527,0,100,200
NearestNeighborEnd_start151,TSPB,52638,26856,25782,0,100,200
NearestNeighborEnd_start152,TSPB,54645,26357,28288,1,100,200
NearestNeighborEnd_start153,TSPB,55159,26394,28765,0,100,200
NearestNeighborEnd_start154,TSPB,57975,28879,29096,0,100,200
NearestNeighborEnd_start155,TSPB,54922,26925,27997,0,100,200
NearestNeighborEnd_start156,TSPB,52804,27192,25612,0,100,200
NearestNeighborEnd_start157,TSPB,54084,27910,26174,0,100,200
NearestNeighborEnd_start158,TSPB,54579,27158,27421,0,100,200
NearestNeighborEnd_start159,TSPB,56260,27192,29068,1,100,200
NearestNeighborEnd_start160,TSPB,53088,27349,25739,0,100,200
NearestNeighborEnd_start161,TSPB,54567,27086,27481,0,100,200
NearestNeighborEnd_start162,TSPB,53284,25843,27441,0,100,200
NearestNeighborEnd_start163,TSPB,53497,27531,25966,0,100,200
NearestNeighborEnd_start164,TSPB,52784,26988,25796,0,100,200
NearestNeighborEnd_start165,TSPB,53695,27539,26156,0,100,200
NearestNeighborEnd_start166,TSPB,56154,29166,26988,0,100,200
NearestNeighborEnd_start167,TSPB,55312,26939,28373,1,100,200
NearestNeighborEnd_start168,TSPB,54369,25952,28417,0,100,200
NearestNeighborEnd_start169,TSPB,53861,25668,28193,0,100,200
NearestNeighborEnd_start170,TSPB,53740,25838,27902,0,100,200
NearestNeighborEnd_start171,TSPB,54288,26696,27592,0,100,200
NearestNeighborEnd_start172,TSPB,52407,25469,26938,0,100,200
NearestNeighborEnd_start173,TSPB,52844,27031,25813,0,100,200
NearestNeighborEnd_start174,TSPB,54368,26222,28146,0,100,200
NearestNeighborEnd_start175,TSPB,55778,27632,28146,1,100,200
NearestNeighborEnd_start176,TSPB,55830,29362,26468,0,100,200
NearestNeighborEnd_start177,TSPB,53989,26673,27316,0,100,200
NearestNeighborEnd_start178,TSPB,53342,27565,25777,0,100,200
NearestNeighborEnd_start179,TSPB,52595,25684,26911,0,100,200
NearestNeighborEnd_start180,TSPB,55608,28752,26856,0,100,200
NearestNeighborEnd_start181,TSPB,58682,28122,30560,0,100,200
NearestNeighborEnd_start182,TSPB,54285,26855,27430,0,100,200
NearestNeighborEnd_start183,TSPB,55091,26803,28288,1,100,200
NearestNeighborEnd_start184,TSPB,55108,27108,28000,0,100,200
NearestNeighborEnd_start185,TSPB,52728,25817,26911,0,100,200
NearestNeighborEnd_start186,TSPB,55709,26291,29418,0,100,200
NearestNeighborEnd_start187,TSPB,54088,27815,26273,0,100,200
NearestNeighborEnd_start188,TSPB,53849,25656,28193,0,100,200
NearestNeighborEnd_start189,TSPB,54804,26896,27908,0,100,200
NearestNeighborEnd_start190,TSPB,53189,25990,27199,0,100,200
NearestNeighborEnd_start191,TSPB,53220,27545,25675,1,100,200
NearestNeighborEnd_start192,TSPB,53520,28005,25515,0,100,200
NearestNeighborEnd_start193,TSPB,53429,27981,25448,0,100,200
NearestNeighborEnd_start194,TSPB,56027,29039,26988,0,100,200
NearestNeighborEnd_start195,TSPB,53942,25749,28193,0,100,200
NearestNeighborEnd_start196,TSPB,53643,27547,26096,0,100,200
NearestNeighborEnd_start197,TSPB,52323,26915,25408,0,100,200
NearestNeighborEnd_start198,TSPB,52537,26961,25576,0,100,200
NearestNeighborEnd_start199,TSPB,55398,27110,28288,1,100,200
NearestNeighborAny_start0,TSPB,50243,20579,29664,1,100,200
NearestNeighborAny_start1,TSPB,52933,20350,32583,2,100,200
NearestNeighborAny_start2,TSPB,49617,20111,29506,1,100,200
NearestNeighborAny_start3,TSPB,52260,19636,32624,2,100,200
NearestNeighborAny_start4,TSPB,51849,19333,32516,2,100,200
NearestNeighborAny_start5,TSPB,49394,21169,28225,1,100,200
NearestNeighborAny_start6,TSPB,49413,20201,29212,2,100,200
NearestNeighborAny_start7,TSPB,49836,21178,28658,1,100,200
NearestNeighborAny_start8,TSPB,50141,20317,29824,2,100,200
NearestNeighborAny_start9,TSPB,51895,19379,32516,2,100,200
NearestNeighborAny_start10,TSPB,52665,20954,31711,1,100,200
NearestNeighborAny_start11,TSPB,50243,20579,29664,2,100,200
NearestNeighborAny_start12,TSPB,50536,20334,30202,1,100,200
NearestNeighborAny_start13,TSPB,49413,20201,29212,2,100,200
NearestNeighborAny_start14,TSPB,50618,20029,30589,2,100,200
NearestNeighborAny_start15,TSPB,52260,19636,32624,1,100,200
NearestNeighborAny_start16,TSPB,52985,20415,32570,2,100,200
NearestNeighborAny_start17,TSPB,57324,19155,38169,1,100,200
NearestNeighborAny_start18,TSPB,52079,20966,31113,2,100,200
NearestNeighborAny_start19,TSPB,53026,20443,32583,2,100,200
NearestNeighborAny_start20,TSPB,52247,19655,32592,1,100,200
NearestNeighborAny_start21,TSPB,49402,21177,28225,2,100,200
NearestNeighborAny_start22,TSPB,51149,19545,31604,2,100,200
NearestNeighborAny_start23,TSPB,52340,19657,32683,1,100,200
NearestNeighborAny_start24,TSPB,53294,20354,32940,2,100,200
NearestNeighborAny_start25,TSPB,49678,21453,28225,1,100,200
NearestNeighborAny_start26,TSPB,50970,19366,31604,2,100,200
NearestNeighborAny_start27,TSPB,53047,20477,32570,2,100,200
NearestNeighborAny_start28,TSPB,51849,19333,32516,1,100,200
NearestNeighborAny_start29,TSPB,50243,20579,29664,2,100,200
NearestNeighborAny_start30,TSPB,51895,21411,30484,2,100,200
NearestNeighborAny_start31,TSPB,50608,21253,29355,1,100,200
NearestNeighborAny_start32,TSPB,52694,20918,31776,2,100,200
NearestNeighborAny_start33,TSPB,50243,20579,29664,2,100,200
NearestNeighborAny_start34,TSPB,50997,21068,29929,1,100,200
NearestNeighborAny_start35,TSPB,50243,20579,29664,2,100,200
NearestNeighborAny_start36,TSPB,50392,20568,29824,2,100,200
NearestNeighborAny_start37,TSPB,50760,20139,30621,1,100,200
NearestNeighborAny_start38,TSPB,52985,20415,32570,2,100,200
NearestNeighborAny_start39,TSPB,50690,20490,30200,1,100,200
NearestNeighborAny_start40,TSPB,57140,18971,38169,2,100,200
NearestNeighborAny_start41,TSPB,50583,20128,30455,2,100,200
NearestNeighborAny_start42,TSPB,51793,21572,30221,1,100,200
NearestNeighborAny_start43,TSPB,50042,20218,29824,2,100,200
NearestNeighborAny_start44,TSPB,52997,20470,32527,2,100,200
NearestNeighborAny_start45,TSPB,49394,21169,28225,1,100,200
NearestNeighborAny_start46,TSPB,51188,20942,30246,2,100,200
NearestNeighborAny_start47,TSPB,52250,19658,32592,2,100,200
NearestNeighborAny_start48,TSPB,51892,19810,32082,1,100,200
NearestNeighborAny_start49,TSPB,50057,20233,29824,2,100,200
NearestNeighborAny_start50,TSPB,50735,20152,30583,2,100,200
NearestNeighborAny_start51,TSPB,52665,20954,31711,1,100,200
NearestNeighborAny_start52,TSPB,50970,19366,31604,2,100,200
NearestNeighborAny_start53,TSPB,51292,18776,32516,1,100,200
NearestNeighborAny_start54,TSPB,50608,21253,29355,2,100,200
NearestNeighborAny_start55,TSPB,52079,20966,31113,2,100,200
NearestNeighborAny_start56,TSPB,49593,21368,28225,1,100,200
NearestNeighborAny_start57,TSPB,51040,19122,31918,2,100,200
NearestNeighborAny_start58,TSPB,49459,20677,28782,2,100,200
NearestNeighborAny_start59,TSPB,51849,19333,32516,1,100,200
NearestNeighborAny_start60,TSPB,52247,19655,32592,2,100,200
NearestNeighborAny_start61,TSPB,50392,20568,29824,2,100,200
NearestNeighborAny_start62,TSPB,52079,20966,31113,1,100,200
NearestNeighborAny_start63,TSPB,52665,20954,31711,2,100,200
NearestNeighborAny_start64,TSPB,51588,19371,32217,1,100,200
NearestNeighborAny_start65,TSPB,52484,19736,32748,2,100,200
NearestNeighborAny_start66,TSPB,52250,19658,32592,2,100,200
NearestNeighborAny_start67,TSPB,52887,20941,31946,1,100,200
NearestNeighborAny_start68,TSPB,50807,20176,30631,2,100,200
NearestNeighborAny_start69,TSPB,51001,20836,30165,2,100,200
NearestNeighborAny_start70,TSPB,52260,19636,32624,1,100,200
NearestNeighborAny_start71,TSPB,52295,21182,31113,2,100,200
NearestNeighborAny_start72,TSPB,57140,18971,38169,1,100,200
NearestNeighborAny_start73,TSPB,50608,21253,29355,2,100,200
NearestNeighborAny_start74,TSPB,53407,20719,32688,1,100,200
NearestNeighborAny_start75,TSPB,51625,19689,31936,2,100,200
NearestNeighborAny_start76,TSPB,51591,19535,32056,2,100,200
NearestNeighborAny_start77,TSPB,50954,19350,31604,1,100,200
NearestNeighborAny_start78,TSPB,49394,21169,28225,2,100,200
NearestNeighborAny_start79,TSPB,50674,20221,30453,2,100,200
NearestNeighborAny_start80,TSPB,50443,21088,29355,1,100,200
NearestNeighborAny_start81,TSPB,50954,19350,31604,2,100,200
NearestNeighborAny_start82,TSPB,49402,21177,28225,2,100,200
NearestNeighborAny_start83,TSPB,51506,19077,32429,1,100,200
NearestNeighborAny_start84,TSPB,50451,20621,29830,2,100,200
NearestNeighborAny_start85,TSPB,49001,20856,28145,2,100,200
NearestNeighborAny_start86,TSPB,50970,19366,31604,1,100,200
NearestNeighborAny_start87,TSPB,49402,21177,28225,2,100,200
NearestNeighborAny_start88,TSPB,51490,19360,32130,2,100,200
NearestNeighborAny_start89,TSPB,50970,19366,31604,1,100,200
NearestNeighborAny_start90,TSPB,52727,21016,31711,2,100,200
NearestNeighborAny_start91,TSPB,50392,20568,29824,1,100,200
NearestNeighborAny_start92,TSPB,53124,20550,32574,2,100,200
NearestNeighborAny_start93,TSPB,52248,19450,32798,2,100,200
NearestNeighborAny_start94,TSPB,52250,19658,32592,1,100,200
NearestNeighborAny_start95,TSPB,50970,19366,31604,2,100,200
NearestNeighborAny_start96,TSPB,52792,20987,31805,2,100,200
NearestNeighborAny_start97,TSPB,50954,19350,31604,1,100,200
NearestNeighborAny_start98,TSPB,53066,20549,32517,2,100,200
NearestNeighborAny_start99,TSPB,51149,19545,31604,2,100,200
NearestNeighborAny_start100,TSPB,56757,19324,37433,1,100,200
NearestNeighborAny_start101,TSPB,52020,19310,32710,2,100,200
NearestNeighborAny_start102,TSPB,52727,21016,31711,2,100,200
NearestNeighborAny_start103,TSPB,50970,19366,31604,1,100,200
NearestNeighborAny_start104,TSPB,50141,20317,29824,2,100,200
NearestNeighborAny_start105,TSPB,54470,20155,34315,2,100,200
NearestNeighborAny_start106,TSPB,52079,20966,31113,1,100,200
NearestNeighborAny_start107,TSPB,57078,18909,38169,2,100,200
NearestNeighborAny_start108,TSPB,52666,21793,30873,1,100,200
NearestNeighborAny_start109,TSPB,50243,20579,29664,2,100,200
NearestNeighborAny_start110,TSPB,51614,18736,32878,2,100,200
NearestNeighborAny_start111,TSPB,50111,20287,29824,1,100,200
NearestNeighborAny_start112,TSPB,52964,20381,32583,2,100,200
NearestNeighborAny_start113,TSPB,50970,19366,31604,2,100,200
NearestNeighborAny_start114,TSPB,50879,19275,31604,1,100,200
NearestNeighborAny_start115,TSPB,52614,20817,31797,2,100,200
NearestNeighborAny_start116,TSPB,52981,20493,32488,2,100,200
NearestNeighborAny_start117,TSPB,50546,21191,29355,1,100,200
NearestNeighborAny_start118,TSPB,53066,20549,32517,2,100,200
NearestNeighborAny_start119,TSPB,51545,20776,30769,1,100,200
NearestNeighborAny_start120,TSPB,52758,20909,31849,2,100,200
NearestNeighborAny_start121,TSPB,53026,20443,32583,2,100,200
NearestNeighborAny_start122,TSPB,52727,21016,31711,1,100,200
NearestNeighborAny_start123,TSPB,49949,21322,28627,2,100,200
NearestNeighborAny_start124,TSPB,52079,20966,31113,2,100,200
NearestNeighborAny_start125,TSPB,52784,21073,31711,1,100,200
NearestNeighborAny_start126,TSPB,49891,20039,29852,2,100,200
NearestNeighborAny_start127,TSPB,50970,19366,31604,1,100,200
NearestNeighborAny_start128,TSPB,51559,18967,32592,2,100,200
NearestNeighborAny_start129,TSPB,51485,19307,32178,2,100,200
NearestNeighborAny_start130,TSPB,50970,19366,31604,3,100,200
NearestNeighborAny_start131,TSPB,52665,20954,31711,1,100,200
NearestNeighborAny_start132,TSPB,49413,20201,29212,2,100,200
NearestNeighborAny_start133,TSPB,52727,21016,31711,3,100,200
NearestNeighborAny_start134,TSPB,49413,20201,29212,2,100,200
NearestNeighborAny_start135,TSPB,52727,21016,31711,3,100,200
NearestNeighborAny_start136,TSPB,50443,21088,29355,1,100,200
NearestNeighborAny_start137,TSPB,50926,19322,31604,2,100,200
NearestNeighborAny_start138,TSPB,50243,20579,29664,2,100,200
NearestNeighborAny_start139,TSPB,50243,20579,29664,1,100,200
NearestNeighborAny_start140,TSPB,51182,18753,32429,2,100,200
NearestNeighborAny_start141,TSPB,50954,19350,31604,1,100,200
NearestNeighborAny_start142,TSPB,49394,21169,28225,2,100,200
NearestNeighborAny_start143,TSPB,50997,21068,29929,2,100,200
NearestNeighborAny_start144,TSPB,50425,20601,29824,1,100,200
NearestNeighborAny_start145,TSPB,52260,19636,32624,2,100,200
NearestNeighborAny_start146,TSPB,50954,19350,31604,2,100,200
NearestNeighborAny_start147,TSPB,52258,21145,31113,1,100,200
NearestNeighborAny_start148,TSPB,52250,19658,32592,2,100,200
NearestNeighborAny_start149,TSPB,51849,19333,32516,1,100,200
NearestNeighborAny_start150,TSPB,51642,19396,32246,1,100,200
NearestNeighborAny_start151,TSPB,52933,20350,32583,2,100,200
NearestNeighborAny_start152,TSPB,51182,18753,32429,2,100,200
NearestNeighborAny_start153,TSPB,50954,19350,31604,1,100,200
NearestNeighborAny_start154,TSPB,52250,19658,32592,2,100,200
NearestNeighborAny_start155,TSPB,50251,20587,29664,1,100,200
NearestNeighborAny_start156,TSPB,52995,20412,32583,2,100,200
NearestNeighborAny_start157,TSPB,50611,20086,30525,2,100,200
NearestNeighborAny_start158,TSPB,49584,22177,27407,1,100,200
NearestNeighborAny_start159,TSPB,50997,21068,29929,2,100,200
NearestNeighborAny_start160,TSPB,50243,20579,29664,2,100,200
NearestNeighborAny_start161,TSPB,52260,19636,32624,1,100,200
NearestNeighborAny_start162,TSPB,50443,21088,29355,2,100,200
NearestNeighborAny_start163,TSPB,50970,19366,31604,2,100,200
NearestNeighborAny_start164,TSPB,50608,21253,29355,1,100,200
NearestNeighborAny_start165,TSPB,51109,19505,31604,2,100,200
NearestNeighborAny_start166,TSPB,50970,19366,31604,1,100,200
NearestNeighborAny_start167,TSPB,50559,20636,29923,2,100,200
NearestNeighborAny_start168,TSPB,49413,20201,29212,2,100,200
NearestNeighborAny_start169,TSPB,49413,20201,29212,1,100,200
NearestNeighborAny_start170,TSPB,51099,21170,29929,2,100,200
NearestNeighborAny_start171,TSPB,49641,20782,28859,2,100,200
NearestNeighborAny_start172,TSPB,50970,19366,31604,1,100,200
NearestNeighborAny_start173,TSPB,50807,20322,30485,2,100,200
NearestNeighborAny_start174,TSPB,51403,18912,32491,2,100,200
NearestNeighborAny_start175,TSPB,49394,21169,28225,1,100,200
NearestNeighborAny_start176,TSPB,50970,19366,31604,2,100,200
NearestNeighborAny_start177,TSPB,49394,21169,28225,2,100,200
NearestNeighborAny_start178,TSPB,52727,21016,31711,1,100,200
NearestNeighborAny_start179,TSPB,50970,19366,31604,2,100,200
NearestNeighborAny_start180,TSPB,50970,19366,31604,1,100,200
NearestNeighborAny_start181,TSPB,51728,19068,32660,2,100,200
NearestNeighborAny_start182,TSPB,50243,20579,29664,2,100,200
NearestNeighborAny_start183,TSPB,51182,18753,32429,1,100,200
NearestNeighborAny_start184,TSPB,51221,21406,29815,2,100,200
NearestNeighborAny_start185,TSPB,50970,19366,31604,2,100,200
NearestNeighborAny_start186,TSPB,51534,19292,32242,1,100,200
NearestNeighborAny_start187,TSPB,50954,19350,31604,2,100,200
NearestNeighborAny_start188,TSPB,49413,20201,29212,2,100,200
NearestNeighborAny_start189,TSPB,50043,20932,29111,1,100,200
NearestNeighborAny_start190,TSPB,50443,21088,29355,2,100,200
NearestNeighborAny_start191,TSPB,52665,20954,31711,2,100,200
NearestNeighborAny_start192,TSPB,51626,19392,32234,1,100,200
NearestNeighborAny_start193,TSPB,50608,21253,29355,2,100,200
NearestNeighborAny_start194,TSPB,50970,19366,31604,1,100,200
NearestNeighborAny_start195,TSPB,49413,20201,29212,2,100,200
NearestNeighborAny_start196,TSPB,52611,21451,31160,2,100,200
NearestNeighborAny_start197,TSPB,53314,20367,32947,1,100,200
NearestNeighborAny_start198,TSPB,50549,21194,29355,2,100,200
NearestNeighborAny_start199,TSPB,52247,19655,32592,2,100,200
