algorithm,instance,objective_value,path_length,node_costs,computation_time_ms,selected_nodes,total_nodes
SteepestLS_Nodes_Random_start0,TSPA,85818,35825,49993,137,100,200
SteepestLS_Nodes_Random_start1,TSPA,88540,39668,48872,87,100,200
SteepestLS_Nodes_Random_start2,TSPA,84786,36769,48017,80,100,200
SteepestLS_Nodes_Random_start3,TSPA,89283,41013,48270,77,100,200
SteepestLS_Nodes_Random_start4,TSPA,87040,37330,49710,105,100,200
SteepestLS_Nodes_Random_start5,TSPA,91051,41483,49568,59,100,200
SteepestLS_Nodes_Random_start6,TSPA,82625,33818,48807,83,100,200
SteepestLS_Nodes_Random_start7,TSPA,87593,39135,48458,69,100,200
SteepestLS_Nodes_Random_start8,TSPA,93172,43896,49276,88,100,200
SteepestLS_Nodes_Random_start9,TSPA,92714,44555,48159,66,100,200
SteepestLS_Nodes_Random_start10,TSPA,88440,37660,50780,69,100,200
SteepestLS_Nodes_Random_start11,TSPA,91003,43614,47389,70,100,200
SteepestLS_Nodes_Random_start12,TSPA,88776,38641,50135,83,100,200
SteepestLS_Nodes_Random_start13,TSPA,86865,37504,49361,85,100,200
SteepestLS_Nodes_Random_start14,TSPA,84192,35353,48839,67,100,200
SteepestLS_Nodes_Random_start15,TSPA,91924,42156,49768,67,100,200
SteepestLS_Nodes_Random_start16,TSPA,85289,35148,50141,66,100,200
SteepestLS_Nodes_Random_start17,TSPA,80895,31096,49799,69,100,200
SteepestLS_Nodes_Random_start18,TSPA,84763,36171,48592,65,100,200
SteepestLS_Nodes_Random_start19,TSPA,89243,41016,48227,72,100,200
SteepestLS_Nodes_Random_start20,TSPA,97487,49358,48129,61,100,200
SteepestLS_Nodes_Random_start21,TSPA,87563,37090,50473,77,100,200
SteepestLS_Nodes_Random_start22,TSPA,87544,35325,52219,58,100,200
SteepestLS_Nodes_Random_start23,TSPA,94692,46476,48216,67,100,200
SteepestLS_Nodes_Random_start24,TSPA,92234,43370,48864,62,100,200
SteepestLS_Nodes_Random_start25,TSPA,88503,39015,49488,77,100,200
SteepestLS_Nodes_Random_start26,TSPA,83018,34029,48989,72,100,200
SteepestLS_Nodes_Random_start27,TSPA,86101,36846,49255,74,100,200
SteepestLS_Nodes_Random_start28,TSPA,91218,43960,47258,58,100,200
SteepestLS_Nodes_Random_start29,TSPA,82423,31687,50736,72,100,200
SteepestLS_Nodes_Random_start30,TSPA,88053,38966,49087,56,100,200
SteepestLS_Nodes_Random_start31,TSPA,86059,35890,50169,69,100,200
SteepestLS_Nodes_Random_start32,TSPA,84509,35580,48929,81,100,200
SteepestLS_Nodes_Random_start33,TSPA,93520,41984,51536,67,100,200
SteepestLS_Nodes_Random_start34,TSPA,87146,38193,48953,63,100,200
SteepestLS_Nodes_Random_start35,TSPA,86817,36279,50538,77,100,200
SteepestLS_Nodes_Random_start36,TSPA,89931,38847,51084,79,100,200
SteepestLS_Nodes_Random_start37,TSPA,89170,40727,48443,67,100,200
SteepestLS_Nodes_Random_start38,TSPA,90942,42446,48496,67,100,200
SteepestLS_Nodes_Random_start39,TSPA,87453,38828,48625,74,100,200
SteepestLS_Nodes_Random_start40,TSPA,89338,41196,48142,62,100,200
SteepestLS_Nodes_Random_start41,TSPA,84796,35669,49127,90,100,200
SteepestLS_Nodes_Random_start42,TSPA,88535,39954,48581,67,100,200
SteepestLS_Nodes_Random_start43,TSPA,94244,45837,48407,68,100,200
SteepestLS_Nodes_Random_start44,TSPA,86935,36956,49979,59,100,200
SteepestLS_Nodes_Random_start45,TSPA,91249,42176,49073,67,100,200
SteepestLS_Nodes_Random_start46,TSPA,88029,39821,48208,67,100,200
SteepestLS_Nodes_Random_start47,TSPA,89929,41451,48478,66,100,200
SteepestLS_Nodes_Random_start48,TSPA,85225,35551,49674,66,100,200
SteepestLS_Nodes_Random_start49,TSPA,90000,40034,49966,72,100,200
SteepestLS_Nodes_Random_start50,TSPA,88025,37679,50346,70,100,200
SteepestLS_Nodes_Random_start51,TSPA,85845,37537,48308,73,100,200
SteepestLS_Nodes_Random_start52,TSPA,90505,42171,48334,70,100,200
SteepestLS_Nodes_Random_start53,TSPA,89407,40328,49079,65,100,200
SteepestLS_Nodes_Random_start54,TSPA,86435,38362,48073,64,100,200
SteepestLS_Nodes_Random_start55,TSPA,85493,34168,51325,70,100,200
SteepestLS_Nodes_Random_start56,TSPA,86486,36273,50213,66,100,200
SteepestLS_Nodes_Random_start57,TSPA,87407,37166,50241,64,100,200
SteepestLS_Nodes_Random_start58,TSPA,89358,40372,48986,63,100,200
SteepestLS_Nodes_Random_start59,TSPA,87929,39565,48364,78,100,200
SteepestLS_Nodes_Random_start60,TSPA,89533,40780,48753,68,100,200
SteepestLS_Nodes_Random_start61,TSPA,85294,36111,49183,78,100,200
SteepestLS_Nodes_Random_start62,TSPA,92095,43131,48964,60,100,200
SteepestLS_Nodes_Random_start63,TSPA,85342,35131,50211,67,100,200
SteepestLS_Nodes_Random_start64,TSPA,88055,39349,48706,74,100,200
SteepestLS_Nodes_Random_start65,TSPA,87592,39583,48009,66,100,200
SteepestLS_Nodes_Random_start66,TSPA,87478,39337,48141,68,100,200
SteepestLS_Nodes_Random_start67,TSPA,85392,36647,48745,77,100,200
SteepestLS_Nodes_Random_start68,TSPA,89460,40026,49434,73,100,200
SteepestLS_Nodes_Random_start69,TSPA,87385,36879,50506,59,100,200
SteepestLS_Nodes_Random_start70,TSPA,85876,36806,49070,72,100,200
SteepestLS_Nodes_Random_start71,TSPA,89648,40470,49178,73,100,200
SteepestLS_Nodes_Random_start72,TSPA,94628,44104,50524,68,100,200
SteepestLS_Nodes_Random_start73,TSPA,89748,41815,47933,70,100,200
SteepestLS_Nodes_Random_start74,TSPA,87408,39460,47948,64,100,200
SteepestLS_Nodes_Random_start75,TSPA,85874,37477,48397,63,100,200
SteepestLS_Nodes_Random_start76,TSPA,82575,32990,49585,66,100,200
SteepestLS_Nodes_Random_start77,TSPA,90148,41209,48939,68,100,200
SteepestLS_Nodes_Random_start78,TSPA,89098,39057,50041,68,100,200
SteepestLS_Nodes_Random_start79,TSPA,91486,41941,49545,78,100,200
SteepestLS_Nodes_Random_start80,TSPA,83201,33843,49358,63,100,200
SteepestLS_Nodes_Random_start81,TSPA,89168,41286,47882,69,100,200
SteepestLS_Nodes_Random_start82,TSPA,81374,32381,48993,68,100,200
SteepestLS_Nodes_Random_start83,TSPA,89928,37353,52575,68,100,200
SteepestLS_Nodes_Random_start84,TSPA,88420,37232,51188,71,100,200
SteepestLS_Nodes_Random_start85,TSPA,89741,41591,48150,76,100,200
SteepestLS_Nodes_Random_start86,TSPA,94153,45492,48661,58,100,200
SteepestLS_Nodes_Random_start87,TSPA,88774,39351,49423,55,100,200
SteepestLS_Nodes_Random_start88,TSPA,88505,38643,49862,76,100,200
SteepestLS_Nodes_Random_start89,TSPA,83671,35623,48048,70,100,200
SteepestLS_Nodes_Random_start90,TSPA,86194,36036,50158,77,100,200
SteepestLS_Nodes_Random_start91,TSPA,87907,39616,48291,66,100,200
SteepestLS_Nodes_Random_start92,TSPA,83599,33837,49762,71,100,200
SteepestLS_Nodes_Random_start93,TSPA,89638,37767,51871,64,100,200
SteepestLS_Nodes_Random_start94,TSPA,91844,42927,48917,59,100,200
SteepestLS_Nodes_Random_start95,TSPA,87709,39094,48615,77,100,200
SteepestLS_Nodes_Random_start96,TSPA,90679,42102,48577,70,100,200
SteepestLS_Nodes_Random_start97,TSPA,87225,38886,48339,79,100,200
SteepestLS_Nodes_Random_start98,TSPA,82416,33049,49367,63,100,200
SteepestLS_Nodes_Random_start99,TSPA,87896,38753,49143,65,100,200
SteepestLS_Nodes_Random_start100,TSPA,87924,40017,47907,63,100,200
SteepestLS_Nodes_Random_start101,TSPA,85663,36924,48739,75,100,200
SteepestLS_Nodes_Random_start102,TSPA,83510,34214,49296,67,100,200
SteepestLS_Nodes_Random_start103,TSPA,95640,45788,49852,64,100,200
SteepestLS_Nodes_Random_start104,TSPA,90914,41239,49675,61,100,200
SteepestLS_Nodes_Random_start105,TSPA,92023,43289,48734,70,100,200
SteepestLS_Nodes_Random_start106,TSPA,92212,42661,49551,54,100,200
SteepestLS_Nodes_Random_start107,TSPA,86446,36553,49893,75,100,200
SteepestLS_Nodes_Random_start108,TSPA,91188,41618,49570,70,100,200
SteepestLS_Nodes_Random_start109,TSPA,83829,34714,49115,66,100,200
SteepestLS_Nodes_Random_start110,TSPA,84326,35127,49199,67,100,200
SteepestLS_Nodes_Random_start111,TSPA,91749,44128,47621,64,100,200
SteepestLS_Nodes_Random_start112,TSPA,89125,39964,49161,68,100,200
SteepestLS_Nodes_Random_start113,TSPA,91055,42189,48866,67,100,200
SteepestLS_Nodes_Random_start114,TSPA,89480,40567,48913,68,100,200
SteepestLS_Nodes_Random_start115,TSPA,88354,38876,49478,65,100,200
SteepestLS_Nodes_Random_start116,TSPA,88968,39258,49710,65,100,200
SteepestLS_Nodes_Random_start117,TSPA,84123,35637,48486,70,100,200
SteepestLS_Nodes_Random_start118,TSPA,87271,35404,51867,64,100,200
SteepestLS_Nodes_Random_start119,TSPA,91207,42227,48980,58,100,200
SteepestLS_Nodes_Random_start120,TSPA,89836,39898,49938,59,100,200
SteepestLS_Nodes_Random_start121,TSPA,90018,39672,50346,68,100,200
SteepestLS_Nodes_Random_start122,TSPA,87036,36411,50625,57,100,200
SteepestLS_Nodes_Random_start123,TSPA,83356,32270,51086,76,100,200
SteepestLS_Nodes_Random_start124,TSPA,89659,39150,50509,68,100,200
SteepestLS_Nodes_Random_start125,TSPA,86463,37075,49388,57,100,200
SteepestLS_Nodes_Random_start126,TSPA,91678,42662,49016,68,100,200
SteepestLS_Nodes_Random_start127,TSPA,89996,39986,50010,72,100,200
SteepestLS_Nodes_Random_start128,TSPA,91310,40760,50550,64,100,200
SteepestLS_Nodes_Random_start129,TSPA,84437,35205,49232,77,100,200
SteepestLS_Nodes_Random_start130,TSPA,84734,35216,49518,75,100,200
SteepestLS_Nodes_Random_start131,TSPA,85918,37074,48844,77,100,200
SteepestLS_Nodes_Random_start132,TSPA,84150,35559,48591,67,100,200
SteepestLS_Nodes_Random_start133,TSPA,84381,35504,48877,70,100,200
SteepestLS_Nodes_Random_start134,TSPA,83592,34570,49022,76,100,200
SteepestLS_Nodes_Random_start135,TSPA,92185,42205,49980,58,100,200
SteepestLS_Nodes_Random_start136,TSPA,88391,38772,49619,78,100,200
SteepestLS_Nodes_Random_start137,TSPA,86181,36171,50010,66,100,200
SteepestLS_Nodes_Random_start138,TSPA,91781,41265,50516,60,100,200
SteepestLS_Nodes_Random_start139,TSPA,87576,37911,49665,69,100,200
SteepestLS_Nodes_Random_start140,TSPA,85213,35482,49731,78,100,200
SteepestLS_Nodes_Random_start141,TSPA,89410,39570,49840,63,100,200
SteepestLS_Nodes_Random_start142,TSPA,87312,35683,51629,68,100,200
SteepestLS_Nodes_Random_start143,TSPA,83989,35957,48032,72,100,200
SteepestLS_Nodes_Random_start144,TSPA,91534,42350,49184,62,100,200
SteepestLS_Nodes_Random_start145,TSPA,88942,37148,51794,69,100,200
SteepestLS_Nodes_Random_start146,TSPA,89693,37904,51789,68,100,200
SteepestLS_Nodes_Random_start147,TSPA,87413,37652,49761,67,100,200
SteepestLS_Nodes_Random_start148,TSPA,90822,40857,49965,73,100,200
SteepestLS_Nodes_Random_start149,TSPA,90674,41310,49364,62,100,200
SteepestLS_Nodes_Random_start150,TSPA,91184,41643,49541,60,100,200
SteepestLS_Nodes_Random_start151,TSPA,92647,44286,48361,64,100,200
SteepestLS_Nodes_Random_start152,TSPA,88100,40136,47964,58,100,200
SteepestLS_Nodes_Random_start153,TSPA,85178,35642,49536,72,100,200
SteepestLS_Nodes_Random_start154,TSPA,87048,37569,49479,58,100,200
SteepestLS_Nodes_Random_start155,TSPA,89938,40402,49536,67,100,200
SteepestLS_Nodes_Random_start156,TSPA,87160,36678,50482,62,100,200
SteepestLS_Nodes_Random_start157,TSPA,86714,37149,49565,75,100,200
SteepestLS_Nodes_Random_start158,TSPA,86862,38462,48400,78,100,200
SteepestLS_Nodes_Random_start159,TSPA,86357,37373,48984,65,100,200
SteepestLS_Nodes_Random_start160,TSPA,92203,42478,49725,78,100,200
SteepestLS_Nodes_Random_start161,TSPA,90451,42406,48045,72,100,200
SteepestLS_Nodes_Random_start162,TSPA,86088,37369,48719,70,100,200
SteepestLS_Nodes_Random_start163,TSPA,89639,36856,52783,65,100,200
SteepestLS_Nodes_Random_start164,TSPA,83160,34794,48366,76,100,200
SteepestLS_Nodes_Random_start165,TSPA,87358,39089,48269,82,100,200
SteepestLS_Nodes_Random_start166,TSPA,89800,42409,47391,62,100,200
SteepestLS_Nodes_Random_start167,TSPA,90374,41226,49148,76,100,200
SteepestLS_Nodes_Random_start168,TSPA,92380,44525,47855,71,100,200
SteepestLS_Nodes_Random_start169,TSPA,90248,41513,48735,63,100,200
SteepestLS_Nodes_Random_start170,TSPA,91640,43202,48438,65,100,200
SteepestLS_Nodes_Random_start171,TSPA,92990,43887,49103,68,100,200
SteepestLS_Nodes_Random_start172,TSPA,90217,41129,49088,64,100,200
SteepestLS_Nodes_Random_start173,TSPA,94116,40782,53334,65,100,200
SteepestLS_Nodes_Random_start174,TSPA,83246,34412,48834,79,100,200
SteepestLS_Nodes_Random_start175,TSPA,91991,43580,48411,77,100,200
SteepestLS_Nodes_Random_start176,TSPA,84257,34416,49841,68,100,200
SteepestLS_Nodes_Random_start177,TSPA,84378,36141,48237,63,100,200
SteepestLS_Nodes_Random_start178,TSPA,80976,30922,50054,72,100,200
SteepestLS_Nodes_Random_start179,TSPA,81105,32811,48294,73,100,200
SteepestLS_Nodes_Random_start180,TSPA,91379,41198,50181,66,100,200
SteepestLS_Nodes_Random_start181,TSPA,88207,37643,50564,68,100,200
SteepestLS_Nodes_Random_start182,TSPA,91326,41797,49529,69,100,200
SteepestLS_Nodes_Random_start183,TSPA,87635,40025,47610,65,100,200
SteepestLS_Nodes_Random_start184,TSPA,92179,43223,48956,58,100,200
SteepestLS_Nodes_Random_start185,TSPA,82519,33439,49080,75,100,200
SteepestLS_Nodes_Random_start186,TSPA,88789,37915,50874,61,100,200
SteepestLS_Nodes_Random_start187,TSPA,84266,35050,49216,69,100,200
SteepestLS_Nodes_Random_start188,TSPA,87072,38409,48663,78,100,200
SteepestLS_Nodes_Random_start189,TSPA,86065,36539,49526,58,100,200
SteepestLS_Nodes_Random_start190,TSPA,87977,37484,50493,76,100,200
SteepestLS_Nodes_Random_start191,TSPA,94707,46642,48065,70,100,200
SteepestLS_Nodes_Random_start192,TSPA,84732,36819,47913,64,100,200
SteepestLS_Nodes_Random_start193,TSPA,82842,33504,49338,57,100,200
SteepestLS_Nodes_Random_start194,TSPA,93287,43142,50145,66,100,200
SteepestLS_Nodes_Random_start195,TSPA,91533,42500,49033,68,100,200
SteepestLS_Nodes_Random_start196,TSPA,88500,38392,50108,68,100,200
SteepestLS_Nodes_Random_start197,TSPA,88050,40031,48019,68,100,200
SteepestLS_Nodes_Random_start198,TSPA,92515,44081,48434,66,100,200
SteepestLS_Nodes_Random_start199,TSPA,89640,41099,48541,66,100,200
SteepestLS_Nodes_GreedyCycle_start0,TSPA,73725,26425,47300,49,100,200
SteepestLS_Nodes_GreedyCycle_start1,TSPA,78761,30598,48163,53,100,200
SteepestLS_Nodes_GreedyCycle_start2,TSPA,75773,27833,47940,41,100,200
SteepestLS_Nodes_GreedyCycle_start3,TSPA,80316,32473,47843,35,100,200
SteepestLS_Nodes_GreedyCycle_start4,TSPA,74595,26371,48224,34,100,200
SteepestLS_Nodes_GreedyCycle_start5,TSPA,76586,27157,49429,42,100,200
SteepestLS_Nodes_GreedyCycle_start6,TSPA,76937,27754,49183,33,100,200
SteepestLS_Nodes_GreedyCycle_start7,TSPA,76490,29250,47240,28,100,200
SteepestLS_Nodes_GreedyCycle_start8,TSPA,75999,28328,47671,34,100,200
SteepestLS_Nodes_GreedyCycle_start9,TSPA,79579,31912,47667,35,100,200
SteepestLS_Nodes_GreedyCycle_start10,TSPA,74128,26582,47546,30,100,200
SteepestLS_Nodes_GreedyCycle_start11,TSPA,77446,26417,51029,37,100,200
SteepestLS_Nodes_GreedyCycle_start12,TSPA,74855,27275,47580,35,100,200
SteepestLS_Nodes_GreedyCycle_start13,TSPA,75533,27583,47950,39,100,200
SteepestLS_Nodes_GreedyCycle_start14,TSPA,78559,30826,47733,36,100,200
SteepestLS_Nodes_GreedyCycle_start15,TSPA,80402,32346,48056,33,100,200
SteepestLS_Nodes_GreedyCycle_start16,TSPA,78137,29463,48674,34,100,200
SteepestLS_Nodes_GreedyCycle_start17,TSPA,76709,28180,48529,30,100,200
SteepestLS_Nodes_GreedyCycle_start18,TSPA,79878,31819,48059,29,100,200
SteepestLS_Nodes_GreedyCycle_start19,TSPA,80964,33633,47331,39,100,200
SteepestLS_Nodes_GreedyCycle_start20,TSPA,76209,28715,47494,39,100,200
SteepestLS_Nodes_GreedyCycle_start21,TSPA,76124,28226,47898,31,100,200
SteepestLS_Nodes_GreedyCycle_start22,TSPA,75442,27702,47740,35,100,200
SteepestLS_Nodes_GreedyCycle_start23,TSPA,75793,28379,47414,28,100,200
SteepestLS_Nodes_GreedyCycle_start24,TSPA,73396,25626,47770,40,100,200
SteepestLS_Nodes_GreedyCycle_start25,TSPA,75721,27502,48219,38,100,200
SteepestLS_Nodes_GreedyCycle_start26,TSPA,75942,28109,47833,33,100,200
SteepestLS_Nodes_GreedyCycle_start27,TSPA,77496,29221,48275,36,100,200
SteepestLS_Nodes_GreedyCycle_start28,TSPA,78461,27660,50801,34,100,200
SteepestLS_Nodes_GreedyCycle_start29,TSPA,75679,26102,49577,35,100,200
SteepestLS_Nodes_GreedyCycle_start30,TSPA,77409,27894,49515,41,100,200
SteepestLS_Nodes_GreedyCycle_start31,TSPA,76128,27501,48627,44,100,200
SteepestLS_Nodes_GreedyCycle_start32,TSPA,79307,31105,48202,35,100,200
SteepestLS_Nodes_GreedyCycle_start33,TSPA,83270,35584,47686,44,100,200
SteepestLS_Nodes_GreedyCycle_start34,TSPA,75351,27766,47585,31,100,200
SteepestLS_Nodes_GreedyCycle_start35,TSPA,78560,27992,50568,32,100,200
SteepestLS_Nodes_GreedyCycle_start36,TSPA,77698,29357,48341,30,100,200
SteepestLS_Nodes_GreedyCycle_start37,TSPA,81792,34380,47412,42,100,200
SteepestLS_Nodes_GreedyCycle_start38,TSPA,77126,29598,47528,46,100,200
SteepestLS_Nodes_GreedyCycle_start39,TSPA,77033,29655,47378,31,100,200
SteepestLS_Nodes_GreedyCycle_start40,TSPA,79802,32420,47382,33,100,200
SteepestLS_Nodes_GreedyCycle_start41,TSPA,75237,27434,47803,37,100,200
SteepestLS_Nodes_GreedyCycle_start42,TSPA,75128,26223,48905,29,100,200
SteepestLS_Nodes_GreedyCycle_start43,TSPA,77213,29447,47766,29,100,200
SteepestLS_Nodes_GreedyCycle_start44,TSPA,73902,26523,47379,33,100,200
SteepestLS_Nodes_GreedyCycle_start45,TSPA,77123,28842,48281,39,100,200
SteepestLS_Nodes_GreedyCycle_start46,TSPA,78026,29720,48306,31,100,200
SteepestLS_Nodes_GreedyCycle_start47,TSPA,74675,27014,47661,38,100,200
SteepestLS_Nodes_GreedyCycle_start48,TSPA,76375,28105,48270,36,100,200
SteepestLS_Nodes_GreedyCycle_start49,TSPA,79061,31199,47862,32,100,200
SteepestLS_Nodes_GreedyCycle_start50,TSPA,78848,30031,48817,37,100,200
SteepestLS_Nodes_GreedyCycle_start51,TSPA,73272,24121,49151,35,100,200
SteepestLS_Nodes_GreedyCycle_start52,TSPA,77739,29175,48564,32,100,200
SteepestLS_Nodes_GreedyCycle_start53,TSPA,78719,30998,47721,33,100,200
SteepestLS_Nodes_GreedyCycle_start54,TSPA,77286,28396,48890,30,100,200
SteepestLS_Nodes_GreedyCycle_start55,TSPA,80601,33213,47388,40,100,200
SteepestLS_Nodes_GreedyCycle_start56,TSPA,77058,29081,47977,33,100,200
SteepestLS_Nodes_GreedyCycle_start57,TSPA,76044,27460,48584,30,100,200
SteepestLS_Nodes_GreedyCycle_start58,TSPA,79276,30458,48818,37,100,200
SteepestLS_Nodes_GreedyCycle_start59,TSPA,77536,28811,48725,29,100,200
SteepestLS_Nodes_GreedyCycle_start60,TSPA,80366,32025,48341,27,100,200
SteepestLS_Nodes_GreedyCycle_start61,TSPA,76184,28095,48089,35,100,200
SteepestLS_Nodes_GreedyCycle_start62,TSPA,77944,29817,48127,38,100,200
SteepestLS_Nodes_GreedyCycle_start63,TSPA,79144,31451,47693,31,100,200
SteepestLS_Nodes_GreedyCycle_start64,TSPA,78492,30791,47701,32,100,200
SteepestLS_Nodes_GreedyCycle_start65,TSPA,77536,28811,48725,30,100,200
SteepestLS_Nodes_GreedyCycle_start66,TSPA,78085,30686,47399,34,100,200
SteepestLS_Nodes_GreedyCycle_start67,TSPA,77094,28513,48581,38,100,200
SteepestLS_Nodes_GreedyCycle_start68,TSPA,77527,29849,47678,33,100,200
SteepestLS_Nodes_GreedyCycle_start69,TSPA,79878,31819,48059,27,100,200
SteepestLS_Nodes_GreedyCycle_start70,TSPA,75083,27413,47670,37,100,200
SteepestLS_Nodes_GreedyCycle_start71,TSPA,79362,31814,47548,33,100,200
SteepestLS_Nodes_GreedyCycle_start72,TSPA,75078,27021,48057,33,100,200
SteepestLS_Nodes_GreedyCycle_start73,TSPA,77886,30007,47879,35,100,200
SteepestLS_Nodes_GreedyCycle_start74,TSPA,76940,28565,48375,36,100,200
SteepestLS_Nodes_GreedyCycle_start75,TSPA,76434,28359,48075,40,100,200
SteepestLS_Nodes_GreedyCycle_start76,TSPA,74971,27268,47703,36,100,200
SteepestLS_Nodes_GreedyCycle_start77,TSPA,79992,31428,48564,31,100,200
SteepestLS_Nodes_GreedyCycle_start78,TSPA,77024,27999,49025,40,100,200
SteepestLS_Nodes_GreedyCycle_start79,TSPA,75940,28068,47872,35,100,200
SteepestLS_Nodes_GreedyCycle_start80,TSPA,78098,29761,48337,29,100,200
SteepestLS_Nodes_GreedyCycle_start81,TSPA,78081,30309,47772,32,100,200
SteepestLS_Nodes_GreedyCycle_start82,TSPA,75270,27209,48061,35,100,200
SteepestLS_Nodes_GreedyCycle_start83,TSPA,78161,29975,48186,40,100,200
SteepestLS_Nodes_GreedyCycle_start84,TSPA,77455,26654,50801,36,100,200
SteepestLS_Nodes_GreedyCycle_start85,TSPA,76501,28420,48081,39,100,200
SteepestLS_Nodes_GreedyCycle_start86,TSPA,75802,27724,48078,38,100,200
SteepestLS_Nodes_GreedyCycle_start87,TSPA,76728,29278,47450,31,100,200
SteepestLS_Nodes_GreedyCycle_start88,TSPA,81464,33922,47542,38,100,200
SteepestLS_Nodes_GreedyCycle_start89,TSPA,76667,28458,48209,35,100,200
SteepestLS_Nodes_GreedyCycle_start90,TSPA,76353,27693,48660,34,100,200
SteepestLS_Nodes_GreedyCycle_start91,TSPA,76407,27739,48668,34,100,200
SteepestLS_Nodes_GreedyCycle_start92,TSPA,77315,28969,48346,31,100,200
SteepestLS_Nodes_GreedyCycle_start93,TSPA,77220,29599,47621,33,100,200
SteepestLS_Nodes_GreedyCycle_start94,TSPA,75897,28396,47501,36,100,200
SteepestLS_Nodes_GreedyCycle_start95,TSPA,76354,27936,48418,34,100,200
SteepestLS_Nodes_GreedyCycle_start96,TSPA,76958,28392,48566,31,100,200
SteepestLS_Nodes_GreedyCycle_start97,TSPA,76697,28717,47980,37,100,200
SteepestLS_Nodes_GreedyCycle_start98,TSPA,76074,28705,47369,38,100,200
SteepestLS_Nodes_GreedyCycle_start99,TSPA,77716,30408,47308,34,100,200
SteepestLS_Nodes_GreedyCycle_start100,TSPA,75308,26473,48835,37,100,200
SteepestLS_Nodes_GreedyCycle_start101,TSPA,77964,30177,47787,35,100,200
SteepestLS_Nodes_GreedyCycle_start102,TSPA,77145,28779,48366,32,100,200
SteepestLS_Nodes_GreedyCycle_start103,TSPA,75950,27221,48729,43,100,200
SteepestLS_Nodes_GreedyCycle_start104,TSPA,78739,30782,47957,28,100,200
SteepestLS_Nodes_GreedyCycle_start105,TSPA,76908,28934,47974,29,100,200
SteepestLS_Nodes_GreedyCycle_start106,TSPA,75672,27830,47842,34,100,200
SteepestLS_Nodes_GreedyCycle_start107,TSPA,77755,29450,48305,36,100,200
SteepestLS_Nodes_GreedyCycle_start108,TSPA,75035,27368,47667,33,100,200
SteepestLS_Nodes_GreedyCycle_start109,TSPA,74449,25629,48820,29,100,200
SteepestLS_Nodes_GreedyCycle_start110,TSPA,77802,29840,47962,33,100,200
SteepestLS_Nodes_GreedyCycle_start111,TSPA,76438,28743,47695,36,100,200
SteepestLS_Nodes_GreedyCycle_start112,TSPA,78111,30070,48041,40,100,200
SteepestLS_Nodes_GreedyCycle_start113,TSPA,78672,30762,47910,38,100,200
SteepestLS_Nodes_GreedyCycle_start114,TSPA,80690,33433,47257,36,100,200
SteepestLS_Nodes_GreedyCycle_start115,TSPA,75877,28040,47837,31,100,200
SteepestLS_Nodes_GreedyCycle_start116,TSPA,74979,27067,47912,35,100,200
SteepestLS_Nodes_GreedyCycle_start117,TSPA,74753,26679,48074,34,100,200
SteepestLS_Nodes_GreedyCycle_start118,TSPA,76367,27321,49046,30,100,200
SteepestLS_Nodes_GreedyCycle_start119,TSPA,75428,27177,48251,40,100,200
SteepestLS_Nodes_GreedyCycle_start120,TSPA,78602,28975,49627,30,100,200
SteepestLS_Nodes_GreedyCycle_start121,TSPA,74519,26047,48472,30,100,200
SteepestLS_Nodes_GreedyCycle_start122,TSPA,74937,26292,48645,34,100,200
SteepestLS_Nodes_GreedyCycle_start123,TSPA,75401,27718,47683,37,100,200
SteepestLS_Nodes_GreedyCycle_start124,TSPA,73448,25728,47720,43,100,200
SteepestLS_Nodes_GreedyCycle_start125,TSPA,79877,31061,48816,44,100,200
SteepestLS_Nodes_GreedyCycle_start126,TSPA,75204,27121,48083,34,100,200
SteepestLS_Nodes_GreedyCycle_start127,TSPA,75977,26779,49198,39,100,200
SteepestLS_Nodes_GreedyCycle_start128,TSPA,76865,28854,48011,35,100,200
SteepestLS_Nodes_GreedyCycle_start129,TSPA,78260,30057,48203,33,100,200
SteepestLS_Nodes_GreedyCycle_start130,TSPA,74855,27275,47580,33,100,200
SteepestLS_Nodes_GreedyCycle_start131,TSPA,75168,26818,48350,34,100,200
SteepestLS_Nodes_GreedyCycle_start132,TSPA,76908,29061,47847,33,100,200
SteepestLS_Nodes_GreedyCycle_start133,TSPA,78057,28653,49404,32,100,200
SteepestLS_Nodes_GreedyCycle_start134,TSPA,78046,29088,48958,33,100,200
SteepestLS_Nodes_GreedyCycle_start135,TSPA,75848,28346,47502,32,100,200
SteepestLS_Nodes_GreedyCycle_start136,TSPA,80621,32967,47654,38,100,200
SteepestLS_Nodes_GreedyCycle_start137,TSPA,75312,26991,48321,33,100,200
SteepestLS_Nodes_GreedyCycle_start138,TSPA,77742,29534,48208,34,100,200
SteepestLS_Nodes_GreedyCycle_start139,TSPA,76157,26786,49371,31,100,200
SteepestLS_Nodes_GreedyCycle_start140,TSPA,74578,27238,47340,34,100,200
SteepestLS_Nodes_GreedyCycle_start141,TSPA,73852,26046,47806,33,100,200
SteepestLS_Nodes_GreedyCycle_start142,TSPA,77883,28925,48958,32,100,200
SteepestLS_Nodes_GreedyCycle_start143,TSPA,78328,30192,48136,28,100,200
SteepestLS_Nodes_GreedyCycle_start144,TSPA,79061,31199,47862,35,100,200
SteepestLS_Nodes_GreedyCycle_start145,TSPA,75865,27092,48773,33,100,200
SteepestLS_Nodes_GreedyCycle_start146,TSPA,75871,27083,48788,39,100,200
SteepestLS_Nodes_GreedyCycle_start147,TSPA,76835,29267,47568,34,100,200
SteepestLS_Nodes_GreedyCycle_start148,TSPA,77876,29954,47922,37,100,200
SteepestLS_Nodes_GreedyCycle_start149,TSPA,75486,26783,48703,33,100,200
SteepestLS_Nodes_GreedyCycle_start150,TSPA,79019,30560,48459,35,100,200
SteepestLS_Nodes_GreedyCycle_start151,TSPA,77852,30003,47849,36,100,200
SteepestLS_Nodes_GreedyCycle_start152,TSPA,77725,30213,47512,39,100,200
SteepestLS_Nodes_GreedyCycle_start153,TSPA,82319,34396,47923,29,100,200
SteepestLS_Nodes_GreedyCycle_start154,TSPA,78839,31462,47377,36,100,200
SteepestLS_Nodes_GreedyCycle_start155,TSPA,79005,31035,47970,29,100,200
SteepestLS_Nodes_GreedyCycle_start156,TSPA,74790,27053,47737,37,100,200
SteepestLS_Nodes_GreedyCycle_start157,TSPA,77126,29598,47528,45,100,200
SteepestLS_Nodes_GreedyCycle_start158,TSPA,77933,29953,47980,32,100,200
SteepestLS_Nodes_GreedyCycle_start159,TSPA,79748,31689,48059,31,100,200
SteepestLS_Nodes_GreedyCycle_start160,TSPA,76676,28494,48182,32,100,200
SteepestLS_Nodes_GreedyCycle_start161,TSPA,77329,28719,48610,32,100,200
SteepestLS_Nodes_GreedyCycle_start162,TSPA,79128,31172,47956,35,100,200
SteepestLS_Nodes_GreedyCycle_start163,TSPA,76413,28253,48160,30,100,200
SteepestLS_Nodes_GreedyCycle_start164,TSPA,77684,30378,47306,31,100,200
SteepestLS_Nodes_GreedyCycle_start165,TSPA,78604,30376,48228,36,100,200
SteepestLS_Nodes_GreedyCycle_start166,TSPA,78461,27660,50801,34,100,200
SteepestLS_Nodes_GreedyCycle_start167,TSPA,74995,26504,48491,32,100,200
SteepestLS_Nodes_GreedyCycle_start168,TSPA,76400,28100,48300,33,100,200
SteepestLS_Nodes_GreedyCycle_start169,TSPA,78332,30127,48205,36,100,200
SteepestLS_Nodes_GreedyCycle_start170,TSPA,77634,27948,49686,27,100,200
SteepestLS_Nodes_GreedyCycle_start171,TSPA,78137,29463,48674,35,100,200
SteepestLS_Nodes_GreedyCycle_start172,TSPA,75550,27470,48080,40,100,200
SteepestLS_Nodes_GreedyCycle_start173,TSPA,76669,27967,48702,35,100,200
SteepestLS_Nodes_GreedyCycle_start174,TSPA,75553,27655,47898,40,100,200
SteepestLS_Nodes_GreedyCycle_start175,TSPA,77677,29700,47977,35,100,200
SteepestLS_Nodes_GreedyCycle_start176,TSPA,78035,30448,47587,31,100,200
SteepestLS_Nodes_GreedyCycle_start177,TSPA,73682,26097,47585,29,100,200
SteepestLS_Nodes_GreedyCycle_start178,TSPA,75946,28135,47811,36,100,200
SteepestLS_Nodes_GreedyCycle_start179,TSPA,76171,28510,47661,33,100,200
SteepestLS_Nodes_GreedyCycle_start180,TSPA,78719,30998,47721,34,100,200
SteepestLS_Nodes_GreedyCycle_start181,TSPA,79444,30036,49408,31,100,200
SteepestLS_Nodes_GreedyCycle_start182,TSPA,80621,32967,47654,42,100,200
SteepestLS_Nodes_GreedyCycle_start183,TSPA,77877,30354,47523,33,100,200
SteepestLS_Nodes_GreedyCycle_start184,TSPA,73195,25189,48006,31,100,200
SteepestLS_Nodes_GreedyCycle_start185,TSPA,78604,30376,48228,34,100,200
SteepestLS_Nodes_GreedyCycle_start186,TSPA,77321,29000,48321,34,100,200
SteepestLS_Nodes_GreedyCycle_start187,TSPA,75273,27313,47960,35,100,200
SteepestLS_Nodes_GreedyCycle_start188,TSPA,76501,28420,48081,37,100,200
SteepestLS_Nodes_GreedyCycle_start189,TSPA,77383,29105,48278,35,100,200
SteepestLS_Nodes_GreedyCycle_start190,TSPA,74083,26417,47666,35,100,200
SteepestLS_Nodes_GreedyCycle_start191,TSPA,76588,28301,48287,32,100,200
SteepestLS_Nodes_GreedyCycle_start192,TSPA,76363,28511,47852,30,100,200
SteepestLS_Nodes_GreedyCycle_start193,TSPA,76157,26786,49371,34,100,200
SteepestLS_Nodes_GreedyCycle_start194,TSPA,77169,28214,48955,33,100,200
SteepestLS_Nodes_GreedyCycle_start195,TSPA,76207,26883,49324,35,100,200
SteepestLS_Nodes_GreedyCycle_start196,TSPA,75591,27492,48099,39,100,200
SteepestLS_Nodes_GreedyCycle_start197,TSPA,75961,26860,49101,31,100,200
SteepestLS_Nodes_GreedyCycle_start198,TSPA,75174,25038,50136,35,100,200
SteepestLS_Nodes_GreedyCycle_start199,TSPA,79761,31702,48059,25,100,200
SteepestLS_Edges_Random_start0,TSPA,73949,22161,51788,70,100,200
SteepestLS_Edges_Random_start1,TSPA,74276,22210,52066,55,100,200
SteepestLS_Edges_Random_start2,TSPA,75243,22659,52584,58,100,200
SteepestLS_Edges_Random_start3,TSPA,74017,23971,50046,58,100,200
SteepestLS_Edges_Random_start4,TSPA,74326,23563,50763,55,100,200
SteepestLS_Edges_Random_start5,TSPA,74120,23318,50802,53,100,200
SteepestLS_Edges_Random_start6,TSPA,72432,22631,49801,52,100,200
SteepestLS_Edges_Random_start7,TSPA,75478,22617,52861,56,100,200
SteepestLS_Edges_Random_start8,TSPA,73105,23394,49711,58,100,200
SteepestLS_Edges_Random_start9,TSPA,73646,22602,51044,53,100,200
SteepestLS_Edges_Random_start10,TSPA,72978,21446,51532,58,100,200
SteepestLS_Edges_Random_start11,TSPA,73471,23480,49991,58,100,200
SteepestLS_Edges_Random_start12,TSPA,73762,23848,49914,56,100,200
SteepestLS_Edges_Random_start13,TSPA,77251,23946,53305,59,100,200
SteepestLS_Edges_Random_start14,TSPA,73214,23599,49615,58,100,200
SteepestLS_Edges_Random_start15,TSPA,73040,23694,49346,55,100,200
SteepestLS_Edges_Random_start16,TSPA,77037,23963,53074,58,100,200
SteepestLS_Edges_Random_start17,TSPA,73077,23602,49475,51,100,200
SteepestLS_Edges_Random_start18,TSPA,74622,22145,52477,54,100,200
SteepestLS_Edges_Random_start19,TSPA,72957,21423,51534,61,100,200
SteepestLS_Edges_Random_start20,TSPA,73037,23391,49646,53,100,200
SteepestLS_Edges_Random_start21,TSPA,73249,22967,50282,56,100,200
SteepestLS_Edges_Random_start22,TSPA,74452,23038,51414,52,100,200
SteepestLS_Edges_Random_start23,TSPA,72405,23812,48593,58,100,200
SteepestLS_Edges_Random_start24,TSPA,73626,23554,50072,52,100,200
SteepestLS_Edges_Random_start25,TSPA,72619,22318,50301,57,100,200
SteepestLS_Edges_Random_start26,TSPA,72282,24038,48244,56,100,200
SteepestLS_Edges_Random_start27,TSPA,75093,23709,51384,48,100,200
SteepestLS_Edges_Random_start28,TSPA,75266,25432,49834,53,100,200
SteepestLS_Edges_Random_start29,TSPA,73112,23070,50042,59,100,200
SteepestLS_Edges_Random_start30,TSPA,75514,23019,52495,58,100,200
SteepestLS_Edges_Random_start31,TSPA,73063,22082,50981,55,100,200
SteepestLS_Edges_Random_start32,TSPA,74365,24449,49916,55,100,200
SteepestLS_Edges_Random_start33,TSPA,73723,22146,51577,53,100,200
SteepestLS_Edges_Random_start34,TSPA,73977,22433,51544,53,100,200
SteepestLS_Edges_Random_start35,TSPA,74066,24019,50047,50,100,200
SteepestLS_Edges_Random_start36,TSPA,72471,23120,49351,62,100,200
SteepestLS_Edges_Random_start37,TSPA,71590,21841,49749,62,100,200
SteepestLS_Edges_Random_start38,TSPA,73133,23493,49640,57,100,200
SteepestLS_Edges_Random_start39,TSPA,73355,23839,49516,63,100,200
SteepestLS_Edges_Random_start40,TSPA,74691,23481,51210,57,100,200
SteepestLS_Edges_Random_start41,TSPA,72219,22980,49239,56,100,200
SteepestLS_Edges_Random_start42,TSPA,73066,24034,49032,58,100,200
SteepestLS_Edges_Random_start43,TSPA,72906,23194,49712,54,100,200
SteepestLS_Edges_Random_start44,TSPA,73885,23360,50525,57,100,200
SteepestLS_Edges_Random_start45,TSPA,75226,24054,51172,56,100,200
SteepestLS_Edges_Random_start46,TSPA,77738,25328,52410,50,100,200
SteepestLS_Edges_Random_start47,TSPA,72525,23791,48734,57,100,200
SteepestLS_Edges_Random_start48,TSPA,74525,23180,51345,52,100,200
SteepestLS_Edges_Random_start49,TSPA,72839,23398,49441,57,100,200
SteepestLS_Edges_Random_start50,TSPA,74280,23247,51033,56,100,200
SteepestLS_Edges_Random_start51,TSPA,74642,24740,49902,48,100,200
SteepestLS_Edges_Random_start52,TSPA,74692,24605,50087,60,100,200
SteepestLS_Edges_Random_start53,TSPA,75340,23530,51810,54,100,200
SteepestLS_Edges_Random_start54,TSPA,73171,24612,48559,51,100,200
SteepestLS_Edges_Random_start55,TSPA,74484,24357,50127,57,100,200
SteepestLS_Edges_Random_start56,TSPA,72138,23582,48556,57,100,200
SteepestLS_Edges_Random_start57,TSPA,73816,22071,51745,56,100,200
SteepestLS_Edges_Random_start58,TSPA,74562,23280,51282,52,100,200
SteepestLS_Edges_Random_start59,TSPA,73957,25256,48701,57,100,200
SteepestLS_Edges_Random_start60,TSPA,74481,23922,50559,59,100,200
SteepestLS_Edges_Random_start61,TSPA,72357,21281,51076,58,100,200
SteepestLS_Edges_Random_start62,TSPA,75967,22747,53220,90,100,200
SteepestLS_Edges_Random_start63,TSPA,73652,22217,51435,56,100,200
SteepestLS_Edges_Random_start64,TSPA,74167,23575,50592,49,100,200
SteepestLS_Edges_Random_start65,TSPA,73496,23125,50371,54,100,200
SteepestLS_Edges_Random_start66,TSPA,73176,23194,49982,55,100,200
SteepestLS_Edges_Random_start67,TSPA,74271,24058,50213,55,100,200
SteepestLS_Edges_Random_start68,TSPA,75335,23811,51524,52,100,200
SteepestLS_Edges_Random_start69,TSPA,75518,23448,52070,55,100,200
SteepestLS_Edges_Random_start70,TSPA,73388,24745,48643,56,100,200
SteepestLS_Edges_Random_start71,TSPA,73325,23222,50103,55,100,200
SteepestLS_Edges_Random_start72,TSPA,74662,23546,51116,56,100,200
SteepestLS_Edges_Random_start73,TSPA,75536,23447,52089,52,100,200
SteepestLS_Edges_Random_start74,TSPA,73864,24321,49543,55,100,200
SteepestLS_Edges_Random_start75,TSPA,73431,23560,49871,59,100,200
SteepestLS_Edges_Random_start76,TSPA,73499,23805,49694,55,100,200
SteepestLS_Edges_Random_start77,TSPA,73709,23545,50164,58,100,200
SteepestLS_Edges_Random_start78,TSPA,73724,23730,49994,51,100,200
SteepestLS_Edges_Random_start79,TSPA,72140,23551,48589,57,100,200
SteepestLS_Edges_Random_start80,TSPA,75568,22753,52815,59,100,200
SteepestLS_Edges_Random_start81,TSPA,73432,24475,48957,56,100,200
SteepestLS_Edges_Random_start82,TSPA,72264,23346,48918,52,100,200
SteepestLS_Edges_Random_start83,TSPA,74329,23378,50951,61,100,200
SteepestLS_Edges_Random_start84,TSPA,73697,24210,49487,56,100,200
SteepestLS_Edges_Random_start85,TSPA,72961,22960,50001,58,100,200
SteepestLS_Edges_Random_start86,TSPA,76441,24001,52440,58,100,200
SteepestLS_Edges_Random_start87,TSPA,73682,22743,50939,58,100,200
SteepestLS_Edges_Random_start88,TSPA,73449,25017,48432,47,100,200
SteepestLS_Edges_Random_start89,TSPA,73254,23852,49402,53,100,200
SteepestLS_Edges_Random_start90,TSPA,72671,23379,49292,55,100,200
SteepestLS_Edges_Random_start91,TSPA,72115,23152,48963,58,100,200
SteepestLS_Edges_Random_start92,TSPA,74433,22951,51482,54,100,200
SteepestLS_Edges_Random_start93,TSPA,75913,24727,51186,53,100,200
SteepestLS_Edges_Random_start94,TSPA,72784,23649,49135,52,100,200
SteepestLS_Edges_Random_start95,TSPA,74403,23561,50842,52,100,200
SteepestLS_Edges_Random_start96,TSPA,73331,22924,50407,53,100,200
SteepestLS_Edges_Random_start97,TSPA,73361,24010,49351,57,100,200
SteepestLS_Edges_Random_start98,TSPA,73023,23172,49851,52,100,200
SteepestLS_Edges_Random_start99,TSPA,74834,23396,51438,54,100,200
SteepestLS_Edges_Random_start100,TSPA,77121,24262,52859,48,100,200
SteepestLS_Edges_Random_start101,TSPA,73873,23857,50016,55,100,200
SteepestLS_Edges_Random_start102,TSPA,74127,23563,50564,51,100,200
SteepestLS_Edges_Random_start103,TSPA,71470,22779,48691,56,100,200
SteepestLS_Edges_Random_start104,TSPA,75085,24890,50195,52,100,200
SteepestLS_Edges_Random_start105,TSPA,75423,25037,50386,53,100,200
SteepestLS_Edges_Random_start106,TSPA,73634,23557,50077,57,100,200
SteepestLS_Edges_Random_start107,TSPA,73897,23779,50118,57,100,200
SteepestLS_Edges_Random_start108,TSPA,72862,22823,50039,58,100,200
SteepestLS_Edges_Random_start109,TSPA,75115,23837,51278,59,100,200
SteepestLS_Edges_Random_start110,TSPA,71447,23177,48270,54,100,200
SteepestLS_Edges_Random_start111,TSPA,73442,22914,50528,54,100,200
SteepestLS_Edges_Random_start112,TSPA,72903,22919,49984,56,100,200
SteepestLS_Edges_Random_start113,TSPA,74706,24664,50042,60,100,200
SteepestLS_Edges_Random_start114,TSPA,75259,25024,50235,50,100,200
SteepestLS_Edges_Random_start115,TSPA,75447,23485,51962,54,100,200
SteepestLS_Edges_Random_start116,TSPA,74724,24710,50014,57,100,200
SteepestLS_Edges_Random_start117,TSPA,72290,23611,48679,59,100,200
SteepestLS_Edges_Random_start118,TSPA,73370,24784,48586,54,100,200
SteepestLS_Edges_Random_start119,TSPA,72508,23206,49302,58,100,200
SteepestLS_Edges_Random_start120,TSPA,73948,24657,49291,53,100,200
SteepestLS_Edges_Random_start121,TSPA,75275,22909,52366,54,100,200
SteepestLS_Edges_Random_start122,TSPA,73811,23527,50284,53,100,200
SteepestLS_Edges_Random_start123,TSPA,73100,22176,50924,56,100,200
SteepestLS_Edges_Random_start124,TSPA,71769,22260,49509,55,100,200
SteepestLS_Edges_Random_start125,TSPA,73304,22049,51255,54,100,200
SteepestLS_Edges_Random_start126,TSPA,74051,24407,49644,53,100,200
SteepestLS_Edges_Random_start127,TSPA,73409,24302,49107,57,100,200
SteepestLS_Edges_Random_start128,TSPA,74938,23357,51581,52,100,200
SteepestLS_Edges_Random_start129,TSPA,72206,23655,48551,53,100,200
SteepestLS_Edges_Random_start130,TSPA,74107,24049,50058,52,100,200
SteepestLS_Edges_Random_start131,TSPA,72556,22245,50311,59,100,200
SteepestLS_Edges_Random_start132,TSPA,75026,24895,50131,52,100,200
SteepestLS_Edges_Random_start133,TSPA,73345,23254,50091,55,100,200
SteepestLS_Edges_Random_start134,TSPA,74865,23512,51353,52,100,200
SteepestLS_Edges_Random_start135,TSPA,73541,23006,50535,57,100,200
SteepestLS_Edges_Random_start136,TSPA,74882,23321,51561,53,100,200
SteepestLS_Edges_Random_start137,TSPA,74163,23881,50282,55,100,200
SteepestLS_Edges_Random_start138,TSPA,72022,22808,49214,54,100,200
SteepestLS_Edges_Random_start139,TSPA,74366,23727,50639,58,100,200
SteepestLS_Edges_Random_start140,TSPA,76514,22821,53693,53,100,200
SteepestLS_Edges_Random_start141,TSPA,73322,22690,50632,55,100,200
SteepestLS_Edges_Random_start142,TSPA,75067,23567,51500,55,100,200
SteepestLS_Edges_Random_start143,TSPA,79087,24579,54508,54,100,200
SteepestLS_Edges_Random_start144,TSPA,74184,22154,52030,51,100,200
SteepestLS_Edges_Random_start145,TSPA,72743,23791,48952,58,100,200
SteepestLS_Edges_Random_start146,TSPA,72501,23414,49087,58,100,200
SteepestLS_Edges_Random_start147,TSPA,72846,22483,50363,51,100,200
SteepestLS_Edges_Random_start148,TSPA,75571,23846,51725,54,100,200
SteepestLS_Edges_Random_start149,TSPA,73643,23888,49755,59,100,200
SteepestLS_Edges_Random_start150,TSPA,74620,22778,51842,51,100,200
SteepestLS_Edges_Random_start151,TSPA,75908,23264,52644,50,100,200
SteepestLS_Edges_Random_start152,TSPA,73700,22767,50933,57,100,200
SteepestLS_Edges_Random_start153,TSPA,73707,23574,50133,48,100,200
SteepestLS_Edges_Random_start154,TSPA,71578,22240,49338,54,100,200
SteepestLS_Edges_Random_start155,TSPA,72882,22575,50307,54,100,200
SteepestLS_Edges_Random_start156,TSPA,72749,23438,49311,55,100,200
SteepestLS_Edges_Random_start157,TSPA,73856,23344,50512,50,100,200
SteepestLS_Edges_Random_start158,TSPA,76116,23605,52511,52,100,200
SteepestLS_Edges_Random_start159,TSPA,72766,22353,50413,47,100,200
SteepestLS_Edges_Random_start160,TSPA,74257,24391,49866,50,100,200
SteepestLS_Edges_Random_start161,TSPA,74538,23427,51111,54,100,200
SteepestLS_Edges_Random_start162,TSPA,72788,23980,48808,46,100,200
SteepestLS_Edges_Random_start163,TSPA,73930,24568,49362,51,100,200
SteepestLS_Edges_Random_start164,TSPA,71509,22220,49289,47,100,200
SteepestLS_Edges_Random_start165,TSPA,75330,25959,49371,51,100,200
SteepestLS_Edges_Random_start166,TSPA,72874,22256,50618,53,100,200
SteepestLS_Edges_Random_start167,TSPA,74619,24355,50264,54,100,200
SteepestLS_Edges_Random_start168,TSPA,73307,24221,49086,49,100,200
SteepestLS_Edges_Random_start169,TSPA,73460,23174,50286,53,100,200
SteepestLS_Edges_Random_start170,TSPA,73318,22916,50402,55,100,200
SteepestLS_Edges_Random_start171,TSPA,74694,24522,50172,46,100,200
SteepestLS_Edges_Random_start172,TSPA,76482,22525,53957,50,100,200
SteepestLS_Edges_Random_start173,TSPA,71845,22640,49205,55,100,200
SteepestLS_Edges_Random_start174,TSPA,73023,23155,49868,54,100,200
SteepestLS_Edges_Random_start175,TSPA,73334,22984,50350,56,100,200
SteepestLS_Edges_Random_start176,TSPA,73972,24278,49694,53,100,200
SteepestLS_Edges_Random_start177,TSPA,73874,23860,50014,45,100,200
SteepestLS_Edges_Random_start178,TSPA,73180,23877,49303,47,100,200
SteepestLS_Edges_Random_start179,TSPA,73300,24125,49175,55,100,200
SteepestLS_Edges_Random_start180,TSPA,72993,22702,50291,44,100,200
SteepestLS_Edges_Random_start181,TSPA,72810,22245,50565,57,100,200
SteepestLS_Edges_Random_start182,TSPA,76746,24081,52665,51,100,200
SteepestLS_Edges_Random_start183,TSPA,73983,23842,50141,54,100,200
SteepestLS_Edges_Random_start184,TSPA,73081,23156,49925,45,100,200
SteepestLS_Edges_Random_start185,TSPA,74024,24291,49733,55,100,200
SteepestLS_Edges_Random_start186,TSPA,77340,23709,53631,45,100,200
SteepestLS_Edges_Random_start187,TSPA,74996,24029,50967,45,100,200
SteepestLS_Edges_Random_start188,TSPA,73748,23090,50658,45,100,200
SteepestLS_Edges_Random_start189,TSPA,75043,23427,51616,54,100,200
SteepestLS_Edges_Random_start190,TSPA,72176,23603,48573,53,100,200
SteepestLS_Edges_Random_start191,TSPA,74403,22884,51519,55,100,200
SteepestLS_Edges_Random_start192,TSPA,73410,23525,49885,52,100,200
SteepestLS_Edges_Random_start193,TSPA,74932,22971,51961,51,100,200
SteepestLS_Edges_Random_start194,TSPA,74254,24749,49505,46,100,200
SteepestLS_Edges_Random_start195,TSPA,74020,23660,50360,54,100,200
SteepestLS_Edges_Random_start196,TSPA,75546,23865,51681,46,100,200
SteepestLS_Edges_Random_start197,TSPA,73989,24275,49714,54,100,200
SteepestLS_Edges_Random_start198,TSPA,77676,22751,54925,53,100,200
SteepestLS_Edges_Random_start199,TSPA,73834,22823,51011,51,100,200
SteepestLS_Edges_GreedyCycle_start0,TSPA,70549,22850,47699,33,100,200
SteepestLS_Edges_GreedyCycle_start1,TSPA,72786,24166,48620,34,100,200
SteepestLS_Edges_GreedyCycle_start2,TSPA,71104,23139,47965,32,100,200
SteepestLS_Edges_GreedyCycle_start3,TSPA,71661,23879,47782,31,100,200
SteepestLS_Edges_GreedyCycle_start4,TSPA,72437,23844,48593,31,100,200
SteepestLS_Edges_GreedyCycle_start5,TSPA,72434,23064,49370,34,100,200
SteepestLS_Edges_GreedyCycle_start6,TSPA,71585,22270,49315,29,100,200
SteepestLS_Edges_GreedyCycle_start7,TSPA,72112,24282,47830,31,100,200
SteepestLS_Edges_GreedyCycle_start8,TSPA,70821,23084,47737,36,100,200
SteepestLS_Edges_GreedyCycle_start9,TSPA,73511,25370,48141,31,100,200
SteepestLS_Edges_GreedyCycle_start10,TSPA,72457,24768,47689,28,100,200
SteepestLS_Edges_GreedyCycle_start11,TSPA,73577,22297,51280,31,100,200
SteepestLS_Edges_GreedyCycle_start12,TSPA,72089,24130,47959,34,100,200
SteepestLS_Edges_GreedyCycle_start13,TSPA,71882,23619,48263,33,100,200
SteepestLS_Edges_GreedyCycle_start14,TSPA,71216,22704,48512,33,100,200
SteepestLS_Edges_GreedyCycle_start15,TSPA,70576,22300,48276,35,100,200
SteepestLS_Edges_GreedyCycle_start16,TSPA,72166,23229,48937,30,100,200
SteepestLS_Edges_GreedyCycle_start17,TSPA,72425,23989,48436,34,100,200
SteepestLS_Edges_GreedyCycle_start18,TSPA,72103,24138,47965,30,100,200
SteepestLS_Edges_GreedyCycle_start19,TSPA,71284,23495,47789,36,100,200
SteepestLS_Edges_GreedyCycle_start20,TSPA,71230,23205,48025,30,100,200
SteepestLS_Edges_GreedyCycle_start21,TSPA,70869,23390,47479,31,100,200
SteepestLS_Edges_GreedyCycle_start22,TSPA,70925,23384,47541,38,100,200
SteepestLS_Edges_GreedyCycle_start23,TSPA,71542,23967,47575,28,100,200
SteepestLS_Edges_GreedyCycle_start24,TSPA,71136,23772,47364,28,100,200
SteepestLS_Edges_GreedyCycle_start25,TSPA,71459,22834,48625,33,100,200
SteepestLS_Edges_GreedyCycle_start26,TSPA,70875,23099,47776,35,100,200
SteepestLS_Edges_GreedyCycle_start27,TSPA,71666,23323,48343,28,100,200
SteepestLS_Edges_GreedyCycle_start28,TSPA,73671,22403,51268,32,100,200
SteepestLS_Edges_GreedyCycle_start29,TSPA,72082,22589,49493,28,100,200
SteepestLS_Edges_GreedyCycle_start30,TSPA,72954,23213,49741,31,100,200
SteepestLS_Edges_GreedyCycle_start31,TSPA,72165,24129,48036,31,100,200
SteepestLS_Edges_GreedyCycle_start32,TSPA,71614,23401,48213,31,100,200
SteepestLS_Edges_GreedyCycle_start33,TSPA,71194,23508,47686,37,100,200
SteepestLS_Edges_GreedyCycle_start34,TSPA,71519,23151,48368,29,100,200
SteepestLS_Edges_GreedyCycle_start35,TSPA,73808,22540,51268,30,100,200
SteepestLS_Edges_GreedyCycle_start36,TSPA,71315,22131,49184,28,100,200
SteepestLS_Edges_GreedyCycle_start37,TSPA,71186,23500,47686,37,100,200
SteepestLS_Edges_GreedyCycle_start38,TSPA,73568,24713,48855,32,100,200
SteepestLS_Edges_GreedyCycle_start39,TSPA,71178,23510,47668,36,100,200
SteepestLS_Edges_GreedyCycle_start40,TSPA,72319,24330,47989,38,100,200
SteepestLS_Edges_GreedyCycle_start41,TSPA,72736,24111,48625,33,100,200
SteepestLS_Edges_GreedyCycle_start42,TSPA,72017,23112,48905,37,100,200
SteepestLS_Edges_GreedyCycle_start43,TSPA,71327,23273,48054,34,100,200
SteepestLS_Edges_GreedyCycle_start44,TSPA,71521,24057,47464,34,100,200
SteepestLS_Edges_GreedyCycle_start45,TSPA,72208,23149,49059,34,100,200
SteepestLS_Edges_GreedyCycle_start46,TSPA,71596,22664,48932,30,100,200
SteepestLS_Edges_GreedyCycle_start47,TSPA,71085,22178,48907,35,100,200
SteepestLS_Edges_GreedyCycle_start48,TSPA,72269,22815,49454,31,100,200
SteepestLS_Edges_GreedyCycle_start49,TSPA,71691,23201,48490,30,100,200
SteepestLS_Edges_GreedyCycle_start50,TSPA,72348,24058,48290,31,100,200
SteepestLS_Edges_GreedyCycle_start51,TSPA,72354,22327,50027,31,100,200
SteepestLS_Edges_GreedyCycle_start52,TSPA,71887,23838,48049,31,100,200
SteepestLS_Edges_GreedyCycle_start53,TSPA,72510,23983,48527,31,100,200
SteepestLS_Edges_GreedyCycle_start54,TSPA,70627,21111,49516,31,100,200
SteepestLS_Edges_GreedyCycle_start55,TSPA,70784,23007,47777,35,100,200
SteepestLS_Edges_GreedyCycle_start56,TSPA,70341,21788,48553,34,100,200
SteepestLS_Edges_GreedyCycle_start57,TSPA,72739,24528,48211,29,100,200
SteepestLS_Edges_GreedyCycle_start58,TSPA,73908,24406,49502,31,100,200
SteepestLS_Edges_GreedyCycle_start59,TSPA,72405,23057,49348,27,100,200
SteepestLS_Edges_GreedyCycle_start60,TSPA,72967,23990,48977,27,100,200
SteepestLS_Edges_GreedyCycle_start61,TSPA,70861,22322,48539,30,100,200
SteepestLS_Edges_GreedyCycle_start62,TSPA,71425,23478,47947,35,100,200
SteepestLS_Edges_GreedyCycle_start63,TSPA,72403,23182,49221,31,100,200
SteepestLS_Edges_GreedyCycle_start64,TSPA,70836,22265,48571,30,100,200
SteepestLS_Edges_GreedyCycle_start65,TSPA,72405,23057,49348,27,100,200
SteepestLS_Edges_GreedyCycle_start66,TSPA,70940,23535,47405,37,100,200
SteepestLS_Edges_GreedyCycle_start67,TSPA,71945,22399,49546,29,100,200
SteepestLS_Edges_GreedyCycle_start68,TSPA,71096,23008,48088,31,100,200
SteepestLS_Edges_GreedyCycle_start69,TSPA,72103,24138,47965,33,100,200
SteepestLS_Edges_GreedyCycle_start70,TSPA,70490,22411,48079,34,100,200
SteepestLS_Edges_GreedyCycle_start71,TSPA,72008,23441,48567,32,100,200
SteepestLS_Edges_GreedyCycle_start72,TSPA,72549,24255,48294,28,100,200
SteepestLS_Edges_GreedyCycle_start73,TSPA,72630,25184,47446,32,100,200
SteepestLS_Edges_GreedyCycle_start74,TSPA,72325,23730,48595,32,100,200
SteepestLS_Edges_GreedyCycle_start75,TSPA,71856,23921,47935,32,100,200
SteepestLS_Edges_GreedyCycle_start76,TSPA,72001,24002,47999,30,100,200
SteepestLS_Edges_GreedyCycle_start77,TSPA,71534,23669,47865,31,100,200
SteepestLS_Edges_GreedyCycle_start78,TSPA,72625,23212,49413,32,100,200
SteepestLS_Edges_GreedyCycle_start79,TSPA,72374,23702,48672,33,100,200
SteepestLS_Edges_GreedyCycle_start80,TSPA,72120,24290,47830,34,100,200
SteepestLS_Edges_GreedyCycle_start81,TSPA,71065,23326,47739,30,100,200
SteepestLS_Edges_GreedyCycle_start82,TSPA,71630,23269,48361,31,100,200
SteepestLS_Edges_GreedyCycle_start83,TSPA,71210,22278,48932,35,100,200
SteepestLS_Edges_GreedyCycle_start84,TSPA,73772,22504,51268,31,100,200
SteepestLS_Edges_GreedyCycle_start85,TSPA,70543,21961,48582,34,100,200
SteepestLS_Edges_GreedyCycle_start86,TSPA,70641,22698,47943,28,100,200
SteepestLS_Edges_GreedyCycle_start87,TSPA,72128,24019,48109,33,100,200
SteepestLS_Edges_GreedyCycle_start88,TSPA,72085,24369,47716,34,100,200
SteepestLS_Edges_GreedyCycle_start89,TSPA,70766,22302,48464,33,100,200
SteepestLS_Edges_GreedyCycle_start90,TSPA,72034,24031,48003,33,100,200
SteepestLS_Edges_GreedyCycle_start91,TSPA,70835,23029,47806,31,100,200
SteepestLS_Edges_GreedyCycle_start92,TSPA,72252,23335,48917,30,100,200
SteepestLS_Edges_GreedyCycle_start93,TSPA,71826,23923,47903,28,100,200
SteepestLS_Edges_GreedyCycle_start94,TSPA,71673,23864,47809,30,100,200
SteepestLS_Edges_GreedyCycle_start95,TSPA,72192,24153,48039,30,100,200
SteepestLS_Edges_GreedyCycle_start96,TSPA,71487,23385,48102,32,100,200
SteepestLS_Edges_GreedyCycle_start97,TSPA,71630,23088,48542,31,100,200
SteepestLS_Edges_GreedyCycle_start98,TSPA,72214,24346,47868,36,100,200
SteepestLS_Edges_GreedyCycle_start99,TSPA,71234,23224,48010,32,100,200
SteepestLS_Edges_GreedyCycle_start100,TSPA,72294,22260,50034,30,100,200
SteepestLS_Edges_GreedyCycle_start101,TSPA,71371,23795,47576,33,100,200
SteepestLS_Edges_GreedyCycle_start102,TSPA,71075,22709,48366,31,100,200
SteepestLS_Edges_GreedyCycle_start103,TSPA,72117,23833,48284,35,100,200
SteepestLS_Edges_GreedyCycle_start104,TSPA,71943,23917,48026,30,100,200
SteepestLS_Edges_GreedyCycle_start105,TSPA,71225,22842,48383,35,100,200
SteepestLS_Edges_GreedyCycle_start106,TSPA,70807,22005,48802,29,100,200
SteepestLS_Edges_GreedyCycle_start107,TSPA,72207,23304,48903,28,100,200
SteepestLS_Edges_GreedyCycle_start108,TSPA,70541,22701,47840,30,100,200
SteepestLS_Edges_GreedyCycle_start109,TSPA,71957,22836,49121,32,100,200
SteepestLS_Edges_GreedyCycle_start110,TSPA,73896,25589,48307,30,100,200
SteepestLS_Edges_GreedyCycle_start111,TSPA,70043,22469,47574,34,100,200
SteepestLS_Edges_GreedyCycle_start112,TSPA,72046,23077,48969,35,100,200
SteepestLS_Edges_GreedyCycle_start113,TSPA,71668,23932,47736,30,100,200
SteepestLS_Edges_GreedyCycle_start114,TSPA,70952,23729,47223,33,100,200
SteepestLS_Edges_GreedyCycle_start115,TSPA,72019,23746,48273,28,100,200
SteepestLS_Edges_GreedyCycle_start116,TSPA,71497,23409,48088,31,100,200
SteepestLS_Edges_GreedyCycle_start117,TSPA,70636,22532,48104,29,100,200
SteepestLS_Edges_GreedyCycle_start118,TSPA,71793,22527,49266,30,100,200
SteepestLS_Edges_GreedyCycle_start119,TSPA,71571,23460,48111,35,100,200
SteepestLS_Edges_GreedyCycle_start120,TSPA,72391,22810,49581,31,100,200
SteepestLS_Edges_GreedyCycle_start121,TSPA,71763,24264,47499,31,100,200
SteepestLS_Edges_GreedyCycle_start122,TSPA,71604,23037,48567,35,100,200
SteepestLS_Edges_GreedyCycle_start123,TSPA,72266,23975,48291,32,100,200
SteepestLS_Edges_GreedyCycle_start124,TSPA,71707,24108,47599,30,100,200
SteepestLS_Edges_GreedyCycle_start125,TSPA,71948,24007,47941,36,100,200
SteepestLS_Edges_GreedyCycle_start126,TSPA,71595,23474,48121,35,100,200
SteepestLS_Edges_GreedyCycle_start127,TSPA,72152,22004,50148,34,100,200
SteepestLS_Edges_GreedyCycle_start128,TSPA,70663,22202,48461,32,100,200
SteepestLS_Edges_GreedyCycle_start129,TSPA,72405,24230,48175,31,100,200
SteepestLS_Edges_GreedyCycle_start130,TSPA,72089,24130,47959,35,100,200
SteepestLS_Edges_GreedyCycle_start131,TSPA,71974,23416,48558,28,100,200
SteepestLS_Edges_GreedyCycle_start132,TSPA,70872,22575,48297,31,100,200
SteepestLS_Edges_GreedyCycle_start133,TSPA,72313,22492,49821,32,100,200
SteepestLS_Edges_GreedyCycle_start134,TSPA,71968,22518,49450,32,100,200
SteepestLS_Edges_GreedyCycle_start135,TSPA,71857,23713,48144,30,100,200
SteepestLS_Edges_GreedyCycle_start136,TSPA,71833,24078,47755,28,100,200
SteepestLS_Edges_GreedyCycle_start137,TSPA,71309,22733,48576,32,100,200
SteepestLS_Edges_GreedyCycle_start138,TSPA,71299,23273,48026,32,100,200
SteepestLS_Edges_GreedyCycle_start139,TSPA,71408,21443,49965,33,100,200
SteepestLS_Edges_GreedyCycle_start140,TSPA,71644,23889,47755,28,100,200
SteepestLS_Edges_GreedyCycle_start141,TSPA,72663,24486,48177,28,100,200
SteepestLS_Edges_GreedyCycle_start142,TSPA,72520,23189,49331,32,100,200
SteepestLS_Edges_GreedyCycle_start143,TSPA,70082,22727,47355,31,100,200
SteepestLS_Edges_GreedyCycle_start144,TSPA,71746,23538,48208,33,100,200
SteepestLS_Edges_GreedyCycle_start145,TSPA,73141,24419,48722,30,100,200
SteepestLS_Edges_GreedyCycle_start146,TSPA,72023,23847,48176,34,100,200
SteepestLS_Edges_GreedyCycle_start147,TSPA,72336,23879,48457,33,100,200
SteepestLS_Edges_GreedyCycle_start148,TSPA,71023,22890,48133,35,100,200
SteepestLS_Edges_GreedyCycle_start149,TSPA,72123,22912,49211,29,100,200
SteepestLS_Edges_GreedyCycle_start150,TSPA,72635,23797,48838,33,100,200
SteepestLS_Edges_GreedyCycle_start151,TSPA,72349,24909,47440,27,100,200
SteepestLS_Edges_GreedyCycle_start152,TSPA,72472,24531,47941,34,100,200
SteepestLS_Edges_GreedyCycle_start153,TSPA,71716,23230,48486,32,100,200
SteepestLS_Edges_GreedyCycle_start154,TSPA,71647,24036,47611,29,100,200
SteepestLS_Edges_GreedyCycle_start155,TSPA,72868,24082,48786,32,100,200
SteepestLS_Edges_GreedyCycle_start156,TSPA,70514,22824,47690,33,100,200
SteepestLS_Edges_GreedyCycle_start157,TSPA,73568,24713,48855,32,100,200
SteepestLS_Edges_GreedyCycle_start158,TSPA,71479,23288,48191,31,100,200
SteepestLS_Edges_GreedyCycle_start159,TSPA,72064,24011,48053,30,100,200
SteepestLS_Edges_GreedyCycle_start160,TSPA,72263,22766,49497,29,100,200
SteepestLS_Edges_GreedyCycle_start161,TSPA,71438,22743,48695,28,100,200
SteepestLS_Edges_GreedyCycle_start162,TSPA,71741,23915,47826,30,100,200
SteepestLS_Edges_GreedyCycle_start163,TSPA,71998,23589,48409,32,100,200
SteepestLS_Edges_GreedyCycle_start164,TSPA,71515,22149,49366,33,100,200
SteepestLS_Edges_GreedyCycle_start165,TSPA,71266,22681,48585,32,100,200
SteepestLS_Edges_GreedyCycle_start166,TSPA,73671,22403,51268,35,100,200
SteepestLS_Edges_GreedyCycle_start167,TSPA,70113,22148,47965,30,100,200
SteepestLS_Edges_GreedyCycle_start168,TSPA,71846,23359,48487,32,100,200
SteepestLS_Edges_GreedyCycle_start169,TSPA,71359,22928,48431,35,100,200
SteepestLS_Edges_GreedyCycle_start170,TSPA,71582,22516,49066,37,100,200
SteepestLS_Edges_GreedyCycle_start171,TSPA,72166,23229,48937,34,100,200
SteepestLS_Edges_GreedyCycle_start172,TSPA,71840,24000,47840,31,100,200
SteepestLS_Edges_GreedyCycle_start173,TSPA,72304,23921,48383,31,100,200
SteepestLS_Edges_GreedyCycle_start174,TSPA,70646,23129,47517,28,100,200
SteepestLS_Edges_GreedyCycle_start175,TSPA,70341,21788,48553,33,100,200
SteepestLS_Edges_GreedyCycle_start176,TSPA,73436,24477,48959,32,100,200
SteepestLS_Edges_GreedyCycle_start177,TSPA,71652,24127,47525,30,100,200
SteepestLS_Edges_GreedyCycle_start178,TSPA,70923,23391,47532,32,100,200
SteepestLS_Edges_GreedyCycle_start179,TSPA,71826,24029,47797,28,100,200
SteepestLS_Edges_GreedyCycle_start180,TSPA,72510,23983,48527,31,100,200
SteepestLS_Edges_GreedyCycle_start181,TSPA,72089,22814,49275,33,100,200
SteepestLS_Edges_GreedyCycle_start182,TSPA,71833,24078,47755,28,100,200
SteepestLS_Edges_GreedyCycle_start183,TSPA,72111,23524,48587,35,100,200
SteepestLS_Edges_GreedyCycle_start184,TSPA,72110,23925,48185,32,100,200
SteepestLS_Edges_GreedyCycle_start185,TSPA,71266,22681,48585,32,100,200
SteepestLS_Edges_GreedyCycle_start186,TSPA,71452,23124,48328,33,100,200
SteepestLS_Edges_GreedyCycle_start187,TSPA,71899,23808,48091,30,100,200
SteepestLS_Edges_GreedyCycle_start188,TSPA,70543,21961,48582,37,100,200
SteepestLS_Edges_GreedyCycle_start189,TSPA,72210,24267,47943,31,100,200
SteepestLS_Edges_GreedyCycle_start190,TSPA,71933,24366,47567,29,100,200
SteepestLS_Edges_GreedyCycle_start191,TSPA,71610,23606,48004,33,100,200
SteepestLS_Edges_GreedyCycle_start192,TSPA,72075,23420,48655,28,100,200
SteepestLS_Edges_GreedyCycle_start193,TSPA,71408,21443,49965,33,100,200
SteepestLS_Edges_GreedyCycle_start194,TSPA,71931,22976,48955,36,100,200
SteepestLS_Edges_GreedyCycle_start195,TSPA,72474,23531,48943,34,100,200
SteepestLS_Edges_GreedyCycle_start196,TSPA,70978,23053,47925,31,100,200
SteepestLS_Edges_GreedyCycle_start197,TSPA,71760,22317,49443,32,100,200
SteepestLS_Edges_GreedyCycle_start198,TSPA,71733,21679,50054,33,100,200
SteepestLS_Edges_GreedyCycle_start199,TSPA,72060,24095,47965,29,100,200
GreedyLS_Nodes_Random_start0,TSPA,88069,39839,48230,206,100,200
GreedyLS_Nodes_Random_start1,TSPA,84825,34345,50480,205,100,200
GreedyLS_Nodes_Random_start2,TSPA,83265,33244,50021,214,100,200
GreedyLS_Nodes_Random_start3,TSPA,85405,35092,50313,226,100,200
GreedyLS_Nodes_Random_start4,TSPA,85792,36819,48973,187,100,200
GreedyLS_Nodes_Random_start5,TSPA,83263,33030,50233,205,100,200
GreedyLS_Nodes_Random_start6,TSPA,88161,37519,50642,179,100,200
GreedyLS_Nodes_Random_start7,TSPA,84757,34176,50581,200,100,200
GreedyLS_Nodes_Random_start8,TSPA,84954,36080,48874,210,100,200
GreedyLS_Nodes_Random_start9,TSPA,85421,34519,50902,161,100,200
GreedyLS_Nodes_Random_start10,TSPA,83582,34217,49365,219,100,200
GreedyLS_Nodes_Random_start11,TSPA,87472,35830,51642,201,100,200
GreedyLS_Nodes_Random_start12,TSPA,91832,37311,54521,185,100,200
GreedyLS_Nodes_Random_start13,TSPA,83711,34771,48940,228,100,200
GreedyLS_Nodes_Random_start14,TSPA,82879,33523,49356,186,100,200
GreedyLS_Nodes_Random_start15,TSPA,90005,40734,49271,179,100,200
GreedyLS_Nodes_Random_start16,TSPA,90191,40716,49475,191,100,200
GreedyLS_Nodes_Random_start17,TSPA,86758,38279,48479,195,100,200
GreedyLS_Nodes_Random_start18,TSPA,92992,43716,49276,180,100,200
GreedyLS_Nodes_Random_start19,TSPA,84829,34531,50298,200,100,200
GreedyLS_Nodes_Random_start20,TSPA,83649,34163,49486,214,100,200
GreedyLS_Nodes_Random_start21,TSPA,87122,37337,49785,192,100,200
GreedyLS_Nodes_Random_start22,TSPA,80038,31973,48065,200,100,200
GreedyLS_Nodes_Random_start23,TSPA,81392,31864,49528,223,100,200
GreedyLS_Nodes_Random_start24,TSPA,87092,35994,51098,197,100,200
GreedyLS_Nodes_Random_start25,TSPA,84234,34242,49992,249,100,200
GreedyLS_Nodes_Random_start26,TSPA,86273,36724,49549,197,100,200
GreedyLS_Nodes_Random_start27,TSPA,86616,35278,51338,204,100,200
GreedyLS_Nodes_Random_start28,TSPA,84674,35382,49292,180,100,200
GreedyLS_Nodes_Random_start29,TSPA,85628,37025,48603,211,100,200
GreedyLS_Nodes_Random_start30,TSPA,88499,40114,48385,198,100,200
GreedyLS_Nodes_Random_start31,TSPA,87235,37925,49310,201,100,200
GreedyLS_Nodes_Random_start32,TSPA,94173,45383,48790,180,100,200
GreedyLS_Nodes_Random_start33,TSPA,83681,33484,50197,190,100,200
GreedyLS_Nodes_Random_start34,TSPA,89911,40234,49677,200,100,200
GreedyLS_Nodes_Random_start35,TSPA,86166,37430,48736,184,100,200
GreedyLS_Nodes_Random_start36,TSPA,82636,31245,51391,214,100,200
GreedyLS_Nodes_Random_start37,TSPA,88860,38357,50503,197,100,200
GreedyLS_Nodes_Random_start38,TSPA,87224,37393,49831,183,100,200
GreedyLS_Nodes_Random_start39,TSPA,83172,33480,49692,186,100,200
GreedyLS_Nodes_Random_start40,TSPA,87632,38798,48834,203,100,200
GreedyLS_Nodes_Random_start41,TSPA,86583,37831,48752,180,100,200
GreedyLS_Nodes_Random_start42,TSPA,90169,38553,51616,202,100,200
GreedyLS_Nodes_Random_start43,TSPA,90894,42113,48781,191,100,200
GreedyLS_Nodes_Random_start44,TSPA,85192,36659,48533,180,100,200
GreedyLS_Nodes_Random_start45,TSPA,91821,43506,48315,191,100,200
GreedyLS_Nodes_Random_start46,TSPA,86989,39239,47750,209,100,200
GreedyLS_Nodes_Random_start47,TSPA,84693,35148,49545,205,100,200
GreedyLS_Nodes_Random_start48,TSPA,83042,34823,48219,221,100,200
GreedyLS_Nodes_Random_start49,TSPA,85887,36249,49638,188,100,200
GreedyLS_Nodes_Random_start50,TSPA,82323,33258,49065,182,100,200
GreedyLS_Nodes_Random_start51,TSPA,85982,37065,48917,202,100,200
GreedyLS_Nodes_Random_start52,TSPA,88986,38808,50178,200,100,200
GreedyLS_Nodes_Random_start53,TSPA,87181,38428,48753,192,100,200
GreedyLS_Nodes_Random_start54,TSPA,86862,38315,48547,206,100,200
GreedyLS_Nodes_Random_start55,TSPA,82412,33345,49067,199,100,200
GreedyLS_Nodes_Random_start56,TSPA,89518,38515,51003,199,100,200
GreedyLS_Nodes_Random_start57,TSPA,83152,35027,48125,219,100,200
GreedyLS_Nodes_Random_start58,TSPA,84489,35414,49075,191,100,200
GreedyLS_Nodes_Random_start59,TSPA,83112,34571,48541,218,100,200
GreedyLS_Nodes_Random_start60,TSPA,86267,36674,49593,176,100,200
GreedyLS_Nodes_Random_start61,TSPA,84895,34711,50184,189,100,200
GreedyLS_Nodes_Random_start62,TSPA,83431,33510,49921,219,100,200
GreedyLS_Nodes_Random_start63,TSPA,85631,36665,48966,206,100,200
GreedyLS_Nodes_Random_start64,TSPA,86670,36511,50159,222,100,200
GreedyLS_Nodes_Random_start65,TSPA,93339,42180,51159,170,100,200
GreedyLS_Nodes_Random_start66,TSPA,86781,35079,51702,192,100,200
GreedyLS_Nodes_Random_start67,TSPA,86948,38133,48815,220,100,200
GreedyLS_Nodes_Random_start68,TSPA,82736,35215,47521,190,100,200
GreedyLS_Nodes_Random_start69,TSPA,89093,39175,49918,211,100,200
GreedyLS_Nodes_Random_start70,TSPA,88008,38490,49518,188,100,200
GreedyLS_Nodes_Random_start71,TSPA,88431,39213,49218,220,100,200
GreedyLS_Nodes_Random_start72,TSPA,82829,33991,48838,193,100,200
GreedyLS_Nodes_Random_start73,TSPA,86713,36973,49740,210,100,200
GreedyLS_Nodes_Random_start74,TSPA,85887,35066,50821,210,100,200
GreedyLS_Nodes_Random_start75,TSPA,83730,35806,47924,228,100,200
GreedyLS_Nodes_Random_start76,TSPA,85519,36268,49251,196,100,200
GreedyLS_Nodes_Random_start77,TSPA,83789,36333,47456,207,100,200
GreedyLS_Nodes_Random_start78,TSPA,88759,39415,49344,195,100,200
GreedyLS_Nodes_Random_start79,TSPA,83121,34444,48677,198,100,200
GreedyLS_Nodes_Random_start80,TSPA,86809,38608,48201,199,100,200
GreedyLS_Nodes_Random_start81,TSPA,84449,32710,51739,174,100,200
GreedyLS_Nodes_Random_start82,TSPA,90997,41613,49384,189,100,200
GreedyLS_Nodes_Random_start83,TSPA,89302,40671,48631,185,100,200
GreedyLS_Nodes_Random_start84,TSPA,86825,37932,48893,188,100,200
GreedyLS_Nodes_Random_start85,TSPA,82575,33600,48975,216,100,200
GreedyLS_Nodes_Random_start86,TSPA,83363,33295,50068,202,100,200
GreedyLS_Nodes_Random_start87,TSPA,84259,34184,50075,213,100,200
GreedyLS_Nodes_Random_start88,TSPA,83916,34016,49900,214,100,200
GreedyLS_Nodes_Random_start89,TSPA,85501,34421,51080,210,100,200
GreedyLS_Nodes_Random_start90,TSPA,86950,34906,52044,194,100,200
GreedyLS_Nodes_Random_start91,TSPA,88208,38215,49993,182,100,200
GreedyLS_Nodes_Random_start92,TSPA,88416,38118,50298,178,100,200
GreedyLS_Nodes_Random_start93,TSPA,84176,34890,49286,209,100,200
GreedyLS_Nodes_Random_start94,TSPA,85899,34841,51058,216,100,200
GreedyLS_Nodes_Random_start95,TSPA,92399,42987,49412,174,100,200
GreedyLS_Nodes_Random_start96,TSPA,84596,36056,48540,193,100,200
GreedyLS_Nodes_Random_start97,TSPA,85302,35517,49785,215,100,200
GreedyLS_Nodes_Random_start98,TSPA,81576,32386,49190,204,100,200
GreedyLS_Nodes_Random_start99,TSPA,87541,37973,49568,194,100,200
GreedyLS_Nodes_Random_start100,TSPA,82960,33778,49182,193,100,200
GreedyLS_Nodes_Random_start101,TSPA,88362,37119,51243,229,100,200
GreedyLS_Nodes_Random_start102,TSPA,84517,35027,49490,218,100,200
GreedyLS_Nodes_Random_start103,TSPA,86134,35495,50639,213,100,200
GreedyLS_Nodes_Random_start104,TSPA,82282,31890,50392,224,100,200
GreedyLS_Nodes_Random_start105,TSPA,84806,35263,49543,230,100,200
GreedyLS_Nodes_Random_start106,TSPA,88080,38783,49297,241,100,200
GreedyLS_Nodes_Random_start107,TSPA,86555,36194,50361,251,100,200
GreedyLS_Nodes_Random_start108,TSPA,85747,35386,50361,202,100,200
GreedyLS_Nodes_Random_start109,TSPA,86197,36412,49785,221,100,200
GreedyLS_Nodes_Random_start110,TSPA,87375,35553,51822,202,100,200
GreedyLS_Nodes_Random_start111,TSPA,85571,37089,48482,253,100,200
GreedyLS_Nodes_Random_start112,TSPA,86443,35101,51342,220,100,200
GreedyLS_Nodes_Random_start113,TSPA,87114,38133,48981,236,100,200
GreedyLS_Nodes_Random_start114,TSPA,85735,37183,48552,227,100,200
GreedyLS_Nodes_Random_start115,TSPA,85960,35776,50184,207,100,200
GreedyLS_Nodes_Random_start116,TSPA,90824,40307,50517,219,100,200
GreedyLS_Nodes_Random_start117,TSPA,84864,35446,49418,246,100,200
GreedyLS_Nodes_Random_start118,TSPA,89092,39069,50023,189,100,200
GreedyLS_Nodes_Random_start119,TSPA,86570,36242,50328,220,100,200
GreedyLS_Nodes_Random_start120,TSPA,88691,37218,51473,216,100,200
GreedyLS_Nodes_Random_start121,TSPA,82858,33943,48915,214,100,200
GreedyLS_Nodes_Random_start122,TSPA,85763,36468,49295,197,100,200
GreedyLS_Nodes_Random_start123,TSPA,86106,36772,49334,223,100,200
GreedyLS_Nodes_Random_start124,TSPA,80943,33219,47724,225,100,200
GreedyLS_Nodes_Random_start125,TSPA,82217,32387,49830,225,100,200
GreedyLS_Nodes_Random_start126,TSPA,86913,36513,50400,214,100,200
GreedyLS_Nodes_Random_start127,TSPA,85405,36633,48772,213,100,200
GreedyLS_Nodes_Random_start128,TSPA,83248,32869,50379,226,100,200
GreedyLS_Nodes_Random_start129,TSPA,87653,38961,48692,214,100,200
GreedyLS_Nodes_Random_start130,TSPA,89623,41290,48333,198,100,200
GreedyLS_Nodes_Random_start131,TSPA,85302,36351,48951,211,100,200
GreedyLS_Nodes_Random_start132,TSPA,87404,37164,50240,199,100,200
GreedyLS_Nodes_Random_start133,TSPA,88734,40014,48720,220,100,200
GreedyLS_Nodes_Random_start134,TSPA,84163,35125,49038,212,100,200
GreedyLS_Nodes_Random_start135,TSPA,83784,34119,49665,213,100,200
GreedyLS_Nodes_Random_start136,TSPA,86070,37041,49029,227,100,200
GreedyLS_Nodes_Random_start137,TSPA,84886,36105,48781,236,100,200
GreedyLS_Nodes_Random_start138,TSPA,86345,35540,50805,203,100,200
GreedyLS_Nodes_Random_start139,TSPA,86673,35996,50677,209,100,200
GreedyLS_Nodes_Random_start140,TSPA,89705,40019,49686,228,100,200
GreedyLS_Nodes_Random_start141,TSPA,90361,40152,50209,197,100,200
GreedyLS_Nodes_Random_start142,TSPA,85504,35159,50345,195,100,200
GreedyLS_Nodes_Random_start143,TSPA,90876,42531,48345,222,100,200
GreedyLS_Nodes_Random_start144,TSPA,90366,41823,48543,204,100,200
GreedyLS_Nodes_Random_start145,TSPA,84013,33333,50680,235,100,200
GreedyLS_Nodes_Random_start146,TSPA,89339,39204,50135,225,100,200
GreedyLS_Nodes_Random_start147,TSPA,89043,39154,49889,187,100,200
GreedyLS_Nodes_Random_start148,TSPA,88875,37602,51273,233,100,200
GreedyLS_Nodes_Random_start149,TSPA,82962,33918,49044,211,100,200
GreedyLS_Nodes_Random_start150,TSPA,84725,36159,48566,206,100,200
GreedyLS_Nodes_Random_start151,TSPA,83204,33325,49879,221,100,200
GreedyLS_Nodes_Random_start152,TSPA,85002,35544,49458,202,100,200
GreedyLS_Nodes_Random_start153,TSPA,85337,35022,50315,198,100,200
GreedyLS_Nodes_Random_start154,TSPA,88150,39250,48900,199,100,200
GreedyLS_Nodes_Random_start155,TSPA,83119,33921,49198,238,100,200
GreedyLS_Nodes_Random_start156,TSPA,85830,36101,49729,240,100,200
GreedyLS_Nodes_Random_start157,TSPA,86364,34706,51658,201,100,200
GreedyLS_Nodes_Random_start158,TSPA,85143,34864,50279,238,100,200
GreedyLS_Nodes_Random_start159,TSPA,91476,41714,49762,211,100,200
GreedyLS_Nodes_Random_start160,TSPA,92065,44075,47990,228,100,200
GreedyLS_Nodes_Random_start161,TSPA,89946,39690,50256,202,100,200
GreedyLS_Nodes_Random_start162,TSPA,86314,37033,49281,181,100,200
GreedyLS_Nodes_Random_start163,TSPA,83459,33763,49696,229,100,200
GreedyLS_Nodes_Random_start164,TSPA,88884,37818,51066,222,100,200
GreedyLS_Nodes_Random_start165,TSPA,85762,36993,48769,216,100,200
GreedyLS_Nodes_Random_start166,TSPA,84924,35811,49113,220,100,200
GreedyLS_Nodes_Random_start167,TSPA,85132,35059,50073,222,100,200
GreedyLS_Nodes_Random_start168,TSPA,87619,39301,48318,220,100,200
GreedyLS_Nodes_Random_start169,TSPA,89912,41421,48491,186,100,200
GreedyLS_Nodes_Random_start170,TSPA,89467,40180,49287,196,100,200
GreedyLS_Nodes_Random_start171,TSPA,92673,42109,50564,205,100,200
GreedyLS_Nodes_Random_start172,TSPA,87055,37966,49089,197,100,200
GreedyLS_Nodes_Random_start173,TSPA,82686,33471,49215,236,100,200
GreedyLS_Nodes_Random_start174,TSPA,84786,34966,49820,222,100,200
GreedyLS_Nodes_Random_start175,TSPA,87776,38504,49272,229,100,200
GreedyLS_Nodes_Random_start176,TSPA,87160,37624,49536,225,100,200
GreedyLS_Nodes_Random_start177,TSPA,82901,33422,49479,212,100,200
GreedyLS_Nodes_Random_start178,TSPA,86752,37557,49195,223,100,200
GreedyLS_Nodes_Random_start179,TSPA,88770,39730,49040,208,100,200
GreedyLS_Nodes_Random_start180,TSPA,87912,36745,51167,208,100,200
GreedyLS_Nodes_Random_start181,TSPA,85548,35131,50417,205,100,200
GreedyLS_Nodes_Random_start182,TSPA,82202,32507,49695,229,100,200
GreedyLS_Nodes_Random_start183,TSPA,84815,36162,48653,222,100,200
GreedyLS_Nodes_Random_start184,TSPA,86977,37752,49225,223,100,200
GreedyLS_Nodes_Random_start185,TSPA,90706,40963,49743,243,100,200
GreedyLS_Nodes_Random_start186,TSPA,86609,36848,49761,229,100,200
GreedyLS_Nodes_Random_start187,TSPA,86237,36210,50027,259,100,200
GreedyLS_Nodes_Random_start188,TSPA,89098,40840,48258,215,100,200
GreedyLS_Nodes_Random_start189,TSPA,84355,36854,47501,220,100,200
GreedyLS_Nodes_Random_start190,TSPA,88594,39062,49532,202,100,200
GreedyLS_Nodes_Random_start191,TSPA,86316,36735,49581,191,100,200
GreedyLS_Nodes_Random_start192,TSPA,80598,30835,49763,237,100,200
GreedyLS_Nodes_Random_start193,TSPA,85924,36274,49650,191,100,200
GreedyLS_Nodes_Random_start194,TSPA,82732,34150,48582,193,100,200
GreedyLS_Nodes_Random_start195,TSPA,88205,37937,50268,185,100,200
GreedyLS_Nodes_Random_start196,TSPA,80539,30271,50268,226,100,200
GreedyLS_Nodes_Random_start197,TSPA,84968,36406,48562,177,100,200
GreedyLS_Nodes_Random_start198,TSPA,86675,36276,50399,211,100,200
GreedyLS_Nodes_Random_start199,TSPA,86328,36739,49589,180,100,200
GreedyLS_Nodes_GreedyCycle_start0,TSPA,75545,27826,47719,104,100,200
GreedyLS_Nodes_GreedyCycle_start1,TSPA,75652,27113,48539,98,100,200
GreedyLS_Nodes_GreedyCycle_start2,TSPA,77768,29024,48744,93,100,200
GreedyLS_Nodes_GreedyCycle_start3,TSPA,83442,33819,49623,93,100,200
GreedyLS_Nodes_GreedyCycle_start4,TSPA,74937,26464,48473,71,100,200
GreedyLS_Nodes_GreedyCycle_start5,TSPA,77972,28611,49361,102,100,200
GreedyLS_Nodes_GreedyCycle_start6,TSPA,77282,29017,48265,99,100,200
GreedyLS_Nodes_GreedyCycle_start7,TSPA,76923,28334,48589,95,100,200
GreedyLS_Nodes_GreedyCycle_start8,TSPA,78251,28777,49474,96,100,200
GreedyLS_Nodes_GreedyCycle_start9,TSPA,78812,30184,48628,101,100,200
GreedyLS_Nodes_GreedyCycle_start10,TSPA,77560,27515,50045,80,100,200
GreedyLS_Nodes_GreedyCycle_start11,TSPA,79271,27824,51447,98,100,200
GreedyLS_Nodes_GreedyCycle_start12,TSPA,75960,27411,48549,93,100,200
GreedyLS_Nodes_GreedyCycle_start13,TSPA,78856,27993,50863,106,100,200
GreedyLS_Nodes_GreedyCycle_start14,TSPA,80198,31856,48342,106,100,200
GreedyLS_Nodes_GreedyCycle_start15,TSPA,76973,27700,49273,145,100,200
GreedyLS_Nodes_GreedyCycle_start16,TSPA,77023,28022,49001,107,100,200
GreedyLS_Nodes_GreedyCycle_start17,TSPA,77727,28903,48824,92,100,200
GreedyLS_Nodes_GreedyCycle_start18,TSPA,79435,31155,48280,89,100,200
GreedyLS_Nodes_GreedyCycle_start19,TSPA,79283,31525,47758,126,100,200
GreedyLS_Nodes_GreedyCycle_start20,TSPA,79714,29727,49987,82,100,200
GreedyLS_Nodes_GreedyCycle_start21,TSPA,76082,27324,48758,108,100,200
GreedyLS_Nodes_GreedyCycle_start22,TSPA,79808,31501,48307,80,100,200
GreedyLS_Nodes_GreedyCycle_start23,TSPA,76997,28934,48063,88,100,200
GreedyLS_Nodes_GreedyCycle_start24,TSPA,74579,25223,49356,110,100,200
GreedyLS_Nodes_GreedyCycle_start25,TSPA,78851,29750,49101,95,100,200
GreedyLS_Nodes_GreedyCycle_start26,TSPA,77774,30020,47754,107,100,200
GreedyLS_Nodes_GreedyCycle_start27,TSPA,79905,30328,49577,94,100,200
GreedyLS_Nodes_GreedyCycle_start28,TSPA,78197,28537,49660,104,100,200
GreedyLS_Nodes_GreedyCycle_start29,TSPA,76657,27260,49397,77,100,200
GreedyLS_Nodes_GreedyCycle_start30,TSPA,76496,26482,50014,117,100,200
GreedyLS_Nodes_GreedyCycle_start31,TSPA,80644,31669,48975,111,100,200
GreedyLS_Nodes_GreedyCycle_start32,TSPA,76653,28322,48331,87,100,200
GreedyLS_Nodes_GreedyCycle_start33,TSPA,79125,28069,51056,103,100,200
GreedyLS_Nodes_GreedyCycle_start34,TSPA,76686,27150,49536,90,100,200
GreedyLS_Nodes_GreedyCycle_start35,TSPA,79341,30177,49164,99,100,200
GreedyLS_Nodes_GreedyCycle_start36,TSPA,75018,25729,49289,90,100,200
GreedyLS_Nodes_GreedyCycle_start37,TSPA,80747,30742,50005,115,100,200
GreedyLS_Nodes_GreedyCycle_start38,TSPA,80359,30980,49379,126,100,200
GreedyLS_Nodes_GreedyCycle_start39,TSPA,78300,29002,49298,104,100,200
GreedyLS_Nodes_GreedyCycle_start40,TSPA,75368,27314,48054,100,100,200
GreedyLS_Nodes_GreedyCycle_start41,TSPA,75483,26876,48607,103,100,200
GreedyLS_Nodes_GreedyCycle_start42,TSPA,75163,26234,48929,83,100,200
GreedyLS_Nodes_GreedyCycle_start43,TSPA,76162,27432,48730,78,100,200
GreedyLS_Nodes_GreedyCycle_start44,TSPA,76853,27600,49253,113,100,200
GreedyLS_Nodes_GreedyCycle_start45,TSPA,78896,29354,49542,100,100,200
GreedyLS_Nodes_GreedyCycle_start46,TSPA,75208,26556,48652,105,100,200
GreedyLS_Nodes_GreedyCycle_start47,TSPA,76531,27845,48686,86,100,200
GreedyLS_Nodes_GreedyCycle_start48,TSPA,79657,28019,51638,104,100,200
GreedyLS_Nodes_GreedyCycle_start49,TSPA,77984,29120,48864,98,100,200
GreedyLS_Nodes_GreedyCycle_start50,TSPA,78968,29572,49396,107,100,200
GreedyLS_Nodes_GreedyCycle_start51,TSPA,73052,24807,48245,90,100,200
GreedyLS_Nodes_GreedyCycle_start52,TSPA,79087,30218,48869,94,100,200
GreedyLS_Nodes_GreedyCycle_start53,TSPA,77858,28975,48883,97,100,200
GreedyLS_Nodes_GreedyCycle_start54,TSPA,75341,25771,49570,109,100,200
GreedyLS_Nodes_GreedyCycle_start55,TSPA,78920,28710,50210,117,100,200
GreedyLS_Nodes_GreedyCycle_start56,TSPA,76902,27577,49325,118,100,200
GreedyLS_Nodes_GreedyCycle_start57,TSPA,78849,30026,48823,90,100,200
GreedyLS_Nodes_GreedyCycle_start58,TSPA,78724,30939,47785,110,100,200
GreedyLS_Nodes_GreedyCycle_start59,TSPA,77374,28222,49152,93,100,200
GreedyLS_Nodes_GreedyCycle_start60,TSPA,77565,28078,49487,95,100,200
GreedyLS_Nodes_GreedyCycle_start61,TSPA,75304,26420,48884,806,100,200
GreedyLS_Nodes_GreedyCycle_start62,TSPA,81941,30204,51737,900,100,200
GreedyLS_Nodes_GreedyCycle_start63,TSPA,75786,25926,49860,109,100,200
GreedyLS_Nodes_GreedyCycle_start64,TSPA,73097,24832,48265,102,100,200
GreedyLS_Nodes_GreedyCycle_start65,TSPA,78600,29315,49285,75,100,200
GreedyLS_Nodes_GreedyCycle_start66,TSPA,79990,30222,49768,118,100,200
GreedyLS_Nodes_GreedyCycle_start67,TSPA,76800,27062,49738,101,100,200
GreedyLS_Nodes_GreedyCycle_start68,TSPA,77159,28683,48476,94,100,200
GreedyLS_Nodes_GreedyCycle_start69,TSPA,80607,30496,50111,96,100,200
GreedyLS_Nodes_GreedyCycle_start70,TSPA,76584,28575,48009,100,100,200
GreedyLS_Nodes_GreedyCycle_start71,TSPA,78381,29725,48656,96,100,200
GreedyLS_Nodes_GreedyCycle_start72,TSPA,76278,26291,49987,78,100,200
GreedyLS_Nodes_GreedyCycle_start73,TSPA,79694,30736,48958,90,100,200
GreedyLS_Nodes_GreedyCycle_start74,TSPA,76607,27988,48619,100,100,200
GreedyLS_Nodes_GreedyCycle_start75,TSPA,76422,26696,49726,107,100,200
GreedyLS_Nodes_GreedyCycle_start76,TSPA,73767,25651,48116,115,100,200
GreedyLS_Nodes_GreedyCycle_start77,TSPA,78969,29378,49591,92,100,200
GreedyLS_Nodes_GreedyCycle_start78,TSPA,75812,27141,48671,95,100,200
GreedyLS_Nodes_GreedyCycle_start79,TSPA,78156,29035,49121,97,100,200
GreedyLS_Nodes_GreedyCycle_start80,TSPA,76904,28038,48866,95,100,200
GreedyLS_Nodes_GreedyCycle_start81,TSPA,76607,26079,50528,97,100,200
GreedyLS_Nodes_GreedyCycle_start82,TSPA,76712,27754,48958,109,100,200
GreedyLS_Nodes_GreedyCycle_start83,TSPA,80595,32273,48322,105,100,200
GreedyLS_Nodes_GreedyCycle_start84,TSPA,79081,26839,52242,88,100,200
GreedyLS_Nodes_GreedyCycle_start85,TSPA,76762,27484,49278,97,100,200
GreedyLS_Nodes_GreedyCycle_start86,TSPA,77333,28040,49293,86,100,200
GreedyLS_Nodes_GreedyCycle_start87,TSPA,77361,28914,48447,91,100,200
GreedyLS_Nodes_GreedyCycle_start88,TSPA,79147,28711,50436,105,100,200
GreedyLS_Nodes_GreedyCycle_start89,TSPA,76837,27901,48936,94,100,200
GreedyLS_Nodes_GreedyCycle_start90,TSPA,77890,29734,48156,93,100,200
GreedyLS_Nodes_GreedyCycle_start91,TSPA,77853,28506,49347,91,100,200
GreedyLS_Nodes_GreedyCycle_start92,TSPA,75350,26575,48775,91,100,200
GreedyLS_Nodes_GreedyCycle_start93,TSPA,75236,27205,48031,97,100,200
GreedyLS_Nodes_GreedyCycle_start94,TSPA,75994,26985,49009,83,100,200
GreedyLS_Nodes_GreedyCycle_start95,TSPA,77271,27981,49290,107,100,200
GreedyLS_Nodes_GreedyCycle_start96,TSPA,77091,27868,49223,97,100,200
GreedyLS_Nodes_GreedyCycle_start97,TSPA,78148,29345,48803,94,100,200
GreedyLS_Nodes_GreedyCycle_start98,TSPA,78607,28872,49735,100,100,200
GreedyLS_Nodes_GreedyCycle_start99,TSPA,78858,30186,48672,106,100,200
GreedyLS_Nodes_GreedyCycle_start100,TSPA,77963,28923,49040,103,100,200
GreedyLS_Nodes_GreedyCycle_start101,TSPA,79766,31141,48625,103,100,200
GreedyLS_Nodes_GreedyCycle_start102,TSPA,74987,26365,48622,97,100,200
GreedyLS_Nodes_GreedyCycle_start103,TSPA,76031,27001,49030,106,100,200
GreedyLS_Nodes_GreedyCycle_start104,TSPA,76892,27981,48911,114,100,200
GreedyLS_Nodes_GreedyCycle_start105,TSPA,76829,28238,48591,74,100,200
GreedyLS_Nodes_GreedyCycle_start106,TSPA,78310,30385,47925,95,100,200
GreedyLS_Nodes_GreedyCycle_start107,TSPA,79687,29669,50018,87,100,200
GreedyLS_Nodes_GreedyCycle_start108,TSPA,77097,27564,49533,90,100,200
GreedyLS_Nodes_GreedyCycle_start109,TSPA,75679,25463,50216,81,100,200
GreedyLS_Nodes_GreedyCycle_start110,TSPA,78479,29295,49184,97,100,200
GreedyLS_Nodes_GreedyCycle_start111,TSPA,74824,26098,48726,118,100,200
GreedyLS_Nodes_GreedyCycle_start112,TSPA,79087,29812,49275,97,100,200
GreedyLS_Nodes_GreedyCycle_start113,TSPA,80102,31537,48565,104,100,200
GreedyLS_Nodes_GreedyCycle_start114,TSPA,79662,30660,49002,82,100,200
GreedyLS_Nodes_GreedyCycle_start115,TSPA,76398,27315,49083,92,100,200
GreedyLS_Nodes_GreedyCycle_start116,TSPA,77041,28605,48436,81,100,200
GreedyLS_Nodes_GreedyCycle_start117,TSPA,77284,28446,48838,96,100,200
GreedyLS_Nodes_GreedyCycle_start118,TSPA,76705,27800,48905,85,100,200
GreedyLS_Nodes_GreedyCycle_start119,TSPA,79596,29958,49638,89,100,200
GreedyLS_Nodes_GreedyCycle_start120,TSPA,76594,27500,49094,107,100,200
GreedyLS_Nodes_GreedyCycle_start121,TSPA,75032,26362,48670,92,100,200
GreedyLS_Nodes_GreedyCycle_start122,TSPA,75033,25343,49690,90,100,200
GreedyLS_Nodes_GreedyCycle_start123,TSPA,75159,27186,47973,122,100,200
GreedyLS_Nodes_GreedyCycle_start124,TSPA,76350,26697,49653,103,100,200
GreedyLS_Nodes_GreedyCycle_start125,TSPA,79639,29144,50495,116,100,200
GreedyLS_Nodes_GreedyCycle_start126,TSPA,77519,27551,49968,121,100,200
GreedyLS_Nodes_GreedyCycle_start127,TSPA,78355,29891,48464,103,100,200
GreedyLS_Nodes_GreedyCycle_start128,TSPA,76096,26762,49334,84,100,200
GreedyLS_Nodes_GreedyCycle_start129,TSPA,78520,29788,48732,108,100,200
GreedyLS_Nodes_GreedyCycle_start130,TSPA,75700,27574,48126,86,100,200
GreedyLS_Nodes_GreedyCycle_start131,TSPA,76208,26975,49233,86,100,200
GreedyLS_Nodes_GreedyCycle_start132,TSPA,75602,26171,49431,92,100,200
GreedyLS_Nodes_GreedyCycle_start133,TSPA,78105,28135,49970,81,100,200
GreedyLS_Nodes_GreedyCycle_start134,TSPA,77681,27845,49836,87,100,200
GreedyLS_Nodes_GreedyCycle_start135,TSPA,78792,29533,49259,76,100,200
GreedyLS_Nodes_GreedyCycle_start136,TSPA,83577,35206,48371,92,100,200
GreedyLS_Nodes_GreedyCycle_start137,TSPA,75961,27097,48864,80,100,200
GreedyLS_Nodes_GreedyCycle_start138,TSPA,77079,27006,50073,116,100,200
GreedyLS_Nodes_GreedyCycle_start139,TSPA,75489,25456,50033,109,100,200
GreedyLS_Nodes_GreedyCycle_start140,TSPA,74806,26490,48316,76,100,200
GreedyLS_Nodes_GreedyCycle_start141,TSPA,74749,26440,48309,82,100,200
GreedyLS_Nodes_GreedyCycle_start142,TSPA,75793,27293,48500,87,100,200
GreedyLS_Nodes_GreedyCycle_start143,TSPA,75953,27547,48406,95,100,200
GreedyLS_Nodes_GreedyCycle_start144,TSPA,78916,28833,50083,92,100,200
GreedyLS_Nodes_GreedyCycle_start145,TSPA,76561,26912,49649,118,100,200
GreedyLS_Nodes_GreedyCycle_start146,TSPA,77024,27400,49624,77,100,200
GreedyLS_Nodes_GreedyCycle_start147,TSPA,77495,29165,48330,105,100,200
GreedyLS_Nodes_GreedyCycle_start148,TSPA,80236,30508,49728,117,100,200
GreedyLS_Nodes_GreedyCycle_start149,TSPA,76812,26596,50216,86,100,200
GreedyLS_Nodes_GreedyCycle_start150,TSPA,78988,27672,51316,100,100,200
GreedyLS_Nodes_GreedyCycle_start151,TSPA,77092,28139,48953,99,100,200
GreedyLS_Nodes_GreedyCycle_start152,TSPA,78209,28911,49298,121,100,200
GreedyLS_Nodes_GreedyCycle_start153,TSPA,79711,31066,48645,92,100,200
GreedyLS_Nodes_GreedyCycle_start154,TSPA,78145,29435,48710,104,100,200
GreedyLS_Nodes_GreedyCycle_start155,TSPA,79372,30734,48638,102,100,200
GreedyLS_Nodes_GreedyCycle_start156,TSPA,77099,28583,48516,84,100,200
GreedyLS_Nodes_GreedyCycle_start157,TSPA,78657,27736,50921,119,100,200
GreedyLS_Nodes_GreedyCycle_start158,TSPA,77913,28744,49169,106,100,200
GreedyLS_Nodes_GreedyCycle_start159,TSPA,75991,28440,47551,105,100,200
GreedyLS_Nodes_GreedyCycle_start160,TSPA,77641,28751,48890,93,100,200
GreedyLS_Nodes_GreedyCycle_start161,TSPA,76420,27303,49117,103,100,200
GreedyLS_Nodes_GreedyCycle_start162,TSPA,79100,30481,48619,90,100,200
GreedyLS_Nodes_GreedyCycle_start163,TSPA,75140,26701,48439,79,100,200
GreedyLS_Nodes_GreedyCycle_start164,TSPA,75131,27280,47851,85,100,200
GreedyLS_Nodes_GreedyCycle_start165,TSPA,77034,28916,48118,100,100,200
GreedyLS_Nodes_GreedyCycle_start166,TSPA,77677,27929,49748,123,100,200
GreedyLS_Nodes_GreedyCycle_start167,TSPA,75473,26374,49099,94,100,200
GreedyLS_Nodes_GreedyCycle_start168,TSPA,80122,31042,49080,84,100,200
GreedyLS_Nodes_GreedyCycle_start169,TSPA,77062,26631,50431,89,100,200
GreedyLS_Nodes_GreedyCycle_start170,TSPA,77709,28349,49360,90,100,200
GreedyLS_Nodes_GreedyCycle_start171,TSPA,78158,29017,49141,92,100,200
GreedyLS_Nodes_GreedyCycle_start172,TSPA,76205,28014,48191,92,100,200
GreedyLS_Nodes_GreedyCycle_start173,TSPA,76683,28003,48680,87,100,200
GreedyLS_Nodes_GreedyCycle_start174,TSPA,77327,26936,50391,106,100,200
GreedyLS_Nodes_GreedyCycle_start175,TSPA,77710,28200,49510,94,100,200
GreedyLS_Nodes_GreedyCycle_start176,TSPA,78317,29234,49083,92,100,200
GreedyLS_Nodes_GreedyCycle_start177,TSPA,75990,27744,48246,75,100,200
GreedyLS_Nodes_GreedyCycle_start178,TSPA,75336,26275,49061,93,100,200
GreedyLS_Nodes_GreedyCycle_start179,TSPA,75755,26755,49000,92,100,200
GreedyLS_Nodes_GreedyCycle_start180,TSPA,77725,28978,48747,95,100,200
GreedyLS_Nodes_GreedyCycle_start181,TSPA,78879,28663,50216,105,100,200
GreedyLS_Nodes_GreedyCycle_start182,TSPA,81546,32410,49136,88,100,200
GreedyLS_Nodes_GreedyCycle_start183,TSPA,76271,27320,48951,94,100,200
GreedyLS_Nodes_GreedyCycle_start184,TSPA,75196,26292,48904,84,100,200
GreedyLS_Nodes_GreedyCycle_start185,TSPA,75395,27332,48063,92,100,200
GreedyLS_Nodes_GreedyCycle_start186,TSPA,77220,27684,49536,92,100,200
GreedyLS_Nodes_GreedyCycle_start187,TSPA,76292,27002,49290,84,100,200
GreedyLS_Nodes_GreedyCycle_start188,TSPA,76758,26992,49766,100,100,200
GreedyLS_Nodes_GreedyCycle_start189,TSPA,77092,27913,49179,107,100,200
GreedyLS_Nodes_GreedyCycle_start190,TSPA,75974,26915,49059,77,100,200
GreedyLS_Nodes_GreedyCycle_start191,TSPA,76236,27852,48384,95,100,200
GreedyLS_Nodes_GreedyCycle_start192,TSPA,76019,27564,48455,77,100,200
GreedyLS_Nodes_GreedyCycle_start193,TSPA,77322,26874,50448,65,100,200
GreedyLS_Nodes_GreedyCycle_start194,TSPA,77992,27030,50962,90,100,200
GreedyLS_Nodes_GreedyCycle_start195,TSPA,74980,26371,48609,94,100,200
GreedyLS_Nodes_GreedyCycle_start196,TSPA,78239,28808,49431,110,100,200
GreedyLS_Nodes_GreedyCycle_start197,TSPA,76646,27852,48794,89,100,200
GreedyLS_Nodes_GreedyCycle_start198,TSPA,76604,26679,49925,84,100,200
GreedyLS_Nodes_GreedyCycle_start199,TSPA,76462,27451,49011,91,100,200
GreedyLS_Edges_Random_start0,TSPA,72334,22358,49976,203,100,200
GreedyLS_Edges_Random_start1,TSPA,73909,24226,49683,197,100,200
GreedyLS_Edges_Random_start2,TSPA,71731,23377,48354,206,100,200
GreedyLS_Edges_Random_start3,TSPA,74490,25372,49118,197,100,200
GreedyLS_Edges_Random_start4,TSPA,73002,22935,50067,213,100,200
GreedyLS_Edges_Random_start5,TSPA,72686,22266,50420,202,100,200
GreedyLS_Edges_Random_start6,TSPA,74229,22612,51617,186,100,200
GreedyLS_Edges_Random_start7,TSPA,72493,23800,48693,186,100,200
GreedyLS_Edges_Random_start8,TSPA,72124,23963,48161,192,100,200
GreedyLS_Edges_Random_start9,TSPA,74807,24151,50656,192,100,200
GreedyLS_Edges_Random_start10,TSPA,74008,24049,49959,189,100,200
GreedyLS_Edges_Random_start11,TSPA,75146,24231,50915,190,100,200
GreedyLS_Edges_Random_start12,TSPA,72805,24154,48651,200,100,200
GreedyLS_Edges_Random_start13,TSPA,73656,25301,48355,200,100,200
GreedyLS_Edges_Random_start14,TSPA,72445,24494,47951,184,100,200
GreedyLS_Edges_Random_start15,TSPA,73796,23519,50277,201,100,200
GreedyLS_Edges_Random_start16,TSPA,73475,23865,49610,208,100,200
GreedyLS_Edges_Random_start17,TSPA,73415,23542,49873,194,100,200
GreedyLS_Edges_Random_start18,TSPA,73946,24629,49317,177,100,200
GreedyLS_Edges_Random_start19,TSPA,73817,23471,50346,214,100,200
GreedyLS_Edges_Random_start20,TSPA,74408,24021,50387,179,100,200
GreedyLS_Edges_Random_start21,TSPA,72783,21286,51497,214,100,200
GreedyLS_Edges_Random_start22,TSPA,72802,24195,48607,189,100,200
GreedyLS_Edges_Random_start23,TSPA,73800,24326,49474,195,100,200
GreedyLS_Edges_Random_start24,TSPA,74696,24546,50150,171,100,200
GreedyLS_Edges_Random_start25,TSPA,73464,24289,49175,192,100,200
GreedyLS_Edges_Random_start26,TSPA,74174,25288,48886,190,100,200
GreedyLS_Edges_Random_start27,TSPA,74393,22477,51916,189,100,200
GreedyLS_Edges_Random_start28,TSPA,72243,22596,49647,186,100,200
GreedyLS_Edges_Random_start29,TSPA,72506,23124,49382,186,100,200
GreedyLS_Edges_Random_start30,TSPA,73268,23281,49987,173,100,200
GreedyLS_Edges_Random_start31,TSPA,73433,24348,49085,192,100,200
GreedyLS_Edges_Random_start32,TSPA,73486,23515,49971,200,100,200
GreedyLS_Edges_Random_start33,TSPA,73727,24073,49654,187,100,200
GreedyLS_Edges_Random_start34,TSPA,72531,23359,49172,207,100,200
GreedyLS_Edges_Random_start35,TSPA,71871,22997,48874,199,100,200
GreedyLS_Edges_Random_start36,TSPA,74910,23538,51372,203,100,200
GreedyLS_Edges_Random_start37,TSPA,72364,23080,49284,205,100,200
GreedyLS_Edges_Random_start38,TSPA,73645,23517,50128,203,100,200
GreedyLS_Edges_Random_start39,TSPA,72317,23454,48863,204,100,200
GreedyLS_Edges_Random_start40,TSPA,75269,22319,52950,198,100,200
GreedyLS_Edges_Random_start41,TSPA,74961,24980,49981,187,100,200
GreedyLS_Edges_Random_start42,TSPA,74407,23364,51043,190,100,200
GreedyLS_Edges_Random_start43,TSPA,72863,23095,49768,181,100,200
GreedyLS_Edges_Random_start44,TSPA,74162,22957,51205,189,100,200
GreedyLS_Edges_Random_start45,TSPA,72094,22661,49433,206,100,200
GreedyLS_Edges_Random_start46,TSPA,73497,23092,50405,178,100,200
GreedyLS_Edges_Random_start47,TSPA,72773,23257,49516,187,100,200
GreedyLS_Edges_Random_start48,TSPA,73748,23558,50190,189,100,200
GreedyLS_Edges_Random_start49,TSPA,75626,23746,51880,209,100,200
GreedyLS_Edges_Random_start50,TSPA,75417,24615,50802,206,100,200
GreedyLS_Edges_Random_start51,TSPA,75927,25167,50760,209,100,200
GreedyLS_Edges_Random_start52,TSPA,75722,23342,52380,190,100,200
GreedyLS_Edges_Random_start53,TSPA,74572,23971,50601,189,100,200
GreedyLS_Edges_Random_start54,TSPA,73320,22175,51145,188,100,200
GreedyLS_Edges_Random_start55,TSPA,72912,23830,49082,189,100,200
GreedyLS_Edges_Random_start56,TSPA,75203,24314,50889,179,100,200
GreedyLS_Edges_Random_start57,TSPA,74243,24562,49681,195,100,200
GreedyLS_Edges_Random_start58,TSPA,75910,23628,52282,208,100,200
GreedyLS_Edges_Random_start59,TSPA,73926,22788,51138,189,100,200
GreedyLS_Edges_Random_start60,TSPA,72966,21952,51014,211,100,200
GreedyLS_Edges_Random_start61,TSPA,72034,23223,48811,207,100,200
GreedyLS_Edges_Random_start62,TSPA,74354,23362,50992,219,100,200
GreedyLS_Edges_Random_start63,TSPA,71962,22797,49165,208,100,200
GreedyLS_Edges_Random_start64,TSPA,74742,23608,51134,212,100,200
GreedyLS_Edges_Random_start65,TSPA,74152,23354,50798,187,100,200
GreedyLS_Edges_Random_start66,TSPA,73163,23143,50020,205,100,200
GreedyLS_Edges_Random_start67,TSPA,73292,23532,49760,208,100,200
GreedyLS_Edges_Random_start68,TSPA,73238,24149,49089,209,100,200
GreedyLS_Edges_Random_start69,TSPA,72937,23085,49852,227,100,200
GreedyLS_Edges_Random_start70,TSPA,73306,23823,49483,213,100,200
GreedyLS_Edges_Random_start71,TSPA,74537,23594,50943,196,100,200
GreedyLS_Edges_Random_start72,TSPA,73727,23190,50537,213,100,200
GreedyLS_Edges_Random_start73,TSPA,73472,23219,50253,211,100,200
GreedyLS_Edges_Random_start74,TSPA,74331,24363,49968,204,100,200
GreedyLS_Edges_Random_start75,TSPA,74894,24583,50311,191,100,200
GreedyLS_Edges_Random_start76,TSPA,73384,23474,49910,209,100,200
GreedyLS_Edges_Random_start77,TSPA,73846,23599,50247,203,100,200
GreedyLS_Edges_Random_start78,TSPA,72657,22735,49922,204,100,200
GreedyLS_Edges_Random_start79,TSPA,73406,23438,49968,223,100,200
GreedyLS_Edges_Random_start80,TSPA,75857,24445,51412,198,100,200
GreedyLS_Edges_Random_start81,TSPA,73735,23136,50599,215,100,200
GreedyLS_Edges_Random_start82,TSPA,73386,22987,50399,225,100,200
GreedyLS_Edges_Random_start83,TSPA,74042,24719,49323,211,100,200
GreedyLS_Edges_Random_start84,TSPA,72540,23321,49219,211,100,200
GreedyLS_Edges_Random_start85,TSPA,73428,23813,49615,197,100,200
GreedyLS_Edges_Random_start86,TSPA,73994,24062,49932,204,100,200
GreedyLS_Edges_Random_start87,TSPA,74131,24297,49834,210,100,200
GreedyLS_Edges_Random_start88,TSPA,73843,22369,51474,217,100,200
GreedyLS_Edges_Random_start89,TSPA,73774,24498,49276,229,100,200
GreedyLS_Edges_Random_start90,TSPA,73935,22699,51236,235,100,200
GreedyLS_Edges_Random_start91,TSPA,73293,23026,50267,202,100,200
GreedyLS_Edges_Random_start92,TSPA,72818,23246,49572,203,100,200
GreedyLS_Edges_Random_start93,TSPA,74948,23750,51198,215,100,200
GreedyLS_Edges_Random_start94,TSPA,76031,23063,52968,203,100,200
GreedyLS_Edges_Random_start95,TSPA,74021,22731,51290,223,100,200
GreedyLS_Edges_Random_start96,TSPA,71984,22998,48986,212,100,200
GreedyLS_Edges_Random_start97,TSPA,73575,25639,47936,200,100,200
GreedyLS_Edges_Random_start98,TSPA,73279,23087,50192,213,100,200
GreedyLS_Edges_Random_start99,TSPA,74838,25041,49797,206,100,200
GreedyLS_Edges_Random_start100,TSPA,73093,23458,49635,204,100,200
GreedyLS_Edges_Random_start101,TSPA,73622,22776,50846,239,100,200
GreedyLS_Edges_Random_start102,TSPA,72541,24474,48067,206,100,200
GreedyLS_Edges_Random_start103,TSPA,73836,24490,49346,199,100,200
GreedyLS_Edges_Random_start104,TSPA,74537,22458,52079,213,100,200
GreedyLS_Edges_Random_start105,TSPA,74130,24643,49487,228,100,200
GreedyLS_Edges_Random_start106,TSPA,72418,22933,49485,210,100,200
GreedyLS_Edges_Random_start107,TSPA,73881,24949,48932,202,100,200
GreedyLS_Edges_Random_start108,TSPA,74585,23705,50880,197,100,200
GreedyLS_Edges_Random_start109,TSPA,75765,24476,51289,187,100,200
GreedyLS_Edges_Random_start110,TSPA,73851,22631,51220,197,100,200
GreedyLS_Edges_Random_start111,TSPA,73893,22143,51750,218,100,200
GreedyLS_Edges_Random_start112,TSPA,76799,24172,52627,195,100,200
GreedyLS_Edges_Random_start113,TSPA,72908,24645,48263,202,100,200
GreedyLS_Edges_Random_start114,TSPA,72312,23630,48682,217,100,200
GreedyLS_Edges_Random_start115,TSPA,75092,22782,52310,202,100,200
GreedyLS_Edges_Random_start116,TSPA,73299,23799,49500,213,100,200
GreedyLS_Edges_Random_start117,TSPA,72435,23442,48993,223,100,200
GreedyLS_Edges_Random_start118,TSPA,72198,23856,48342,215,100,200
GreedyLS_Edges_Random_start119,TSPA,72781,22903,49878,200,100,200
GreedyLS_Edges_Random_start120,TSPA,73609,23426,50183,195,100,200
GreedyLS_Edges_Random_start121,TSPA,71973,22598,49375,187,100,200
GreedyLS_Edges_Random_start122,TSPA,73573,24030,49543,175,100,200
GreedyLS_Edges_Random_start123,TSPA,73396,23794,49602,204,100,200
GreedyLS_Edges_Random_start124,TSPA,75034,22925,52109,200,100,200
GreedyLS_Edges_Random_start125,TSPA,75650,24233,51417,191,100,200
GreedyLS_Edges_Random_start126,TSPA,75702,23899,51803,179,100,200
GreedyLS_Edges_Random_start127,TSPA,76203,25110,51093,202,100,200
GreedyLS_Edges_Random_start128,TSPA,73173,25515,47658,209,100,200
GreedyLS_Edges_Random_start129,TSPA,73994,23528,50466,185,100,200
GreedyLS_Edges_Random_start130,TSPA,74711,22485,52226,196,100,200
GreedyLS_Edges_Random_start131,TSPA,73653,23528,50125,217,100,200
GreedyLS_Edges_Random_start132,TSPA,72684,22818,49866,215,100,200
GreedyLS_Edges_Random_start133,TSPA,73057,23509,49548,210,100,200
GreedyLS_Edges_Random_start134,TSPA,74287,24261,50026,196,100,200
GreedyLS_Edges_Random_start135,TSPA,73641,23094,50547,190,100,200
GreedyLS_Edges_Random_start136,TSPA,72375,22766,49609,244,100,200
GreedyLS_Edges_Random_start137,TSPA,74624,22794,51830,235,100,200
GreedyLS_Edges_Random_start138,TSPA,74975,22686,52289,191,100,200
GreedyLS_Edges_Random_start139,TSPA,74066,23563,50503,216,100,200
GreedyLS_Edges_Random_start140,TSPA,74411,24479,49932,210,100,200
GreedyLS_Edges_Random_start141,TSPA,74783,24121,50662,215,100,200
GreedyLS_Edges_Random_start142,TSPA,73380,23574,49806,205,100,200
GreedyLS_Edges_Random_start143,TSPA,71678,22905,48773,200,100,200
GreedyLS_Edges_Random_start144,TSPA,71015,21950,49065,220,100,200
GreedyLS_Edges_Random_start145,TSPA,74901,24601,50300,197,100,200
GreedyLS_Edges_Random_start146,TSPA,74187,23761,50426,227,100,200
GreedyLS_Edges_Random_start147,TSPA,73933,23973,49960,201,100,200
GreedyLS_Edges_Random_start148,TSPA,73295,23824,49471,211,100,200
GreedyLS_Edges_Random_start149,TSPA,74313,24865,49448,204,100,200
GreedyLS_Edges_Random_start150,TSPA,75134,24618,50516,205,100,200
GreedyLS_Edges_Random_start151,TSPA,73770,23444,50326,205,100,200
GreedyLS_Edges_Random_start152,TSPA,75064,24287,50777,197,100,200
GreedyLS_Edges_Random_start153,TSPA,74717,23381,51336,202,100,200
GreedyLS_Edges_Random_start154,TSPA,73870,22574,51296,207,100,200
GreedyLS_Edges_Random_start155,TSPA,72961,24618,48343,199,100,200
GreedyLS_Edges_Random_start156,TSPA,72671,23921,48750,217,100,200
GreedyLS_Edges_Random_start157,TSPA,73444,23951,49493,223,100,200
GreedyLS_Edges_Random_start158,TSPA,75265,25738,49527,200,100,200
GreedyLS_Edges_Random_start159,TSPA,73984,23668,50316,232,100,200
GreedyLS_Edges_Random_start160,TSPA,74136,24009,50127,203,100,200
GreedyLS_Edges_Random_start161,TSPA,73222,24591,48631,205,100,200
GreedyLS_Edges_Random_start162,TSPA,75078,23930,51148,225,100,200
GreedyLS_Edges_Random_start163,TSPA,74681,24508,50173,195,100,200
GreedyLS_Edges_Random_start164,TSPA,73903,22088,51815,220,100,200
GreedyLS_Edges_Random_start165,TSPA,74175,23475,50700,199,100,200
GreedyLS_Edges_Random_start166,TSPA,73988,23598,50390,191,100,200
GreedyLS_Edges_Random_start167,TSPA,74132,23670,50462,211,100,200
GreedyLS_Edges_Random_start168,TSPA,74250,24406,49844,216,100,200
GreedyLS_Edges_Random_start169,TSPA,74274,23105,51169,212,100,200
GreedyLS_Edges_Random_start170,TSPA,74650,23715,50935,198,100,200
GreedyLS_Edges_Random_start171,TSPA,75456,23730,51726,208,100,200
GreedyLS_Edges_Random_start172,TSPA,73953,24416,49537,201,100,200
GreedyLS_Edges_Random_start173,TSPA,74339,22337,52002,213,100,200
GreedyLS_Edges_Random_start174,TSPA,74736,24705,50031,194,100,200
GreedyLS_Edges_Random_start175,TSPA,73182,23365,49817,214,100,200
GreedyLS_Edges_Random_start176,TSPA,73807,23736,50071,216,100,200
GreedyLS_Edges_Random_start177,TSPA,73768,23706,50062,194,100,200
GreedyLS_Edges_Random_start178,TSPA,71751,22773,48978,199,100,200
GreedyLS_Edges_Random_start179,TSPA,72710,23972,48738,211,100,200
GreedyLS_Edges_Random_start180,TSPA,73739,23420,50319,200,100,200
GreedyLS_Edges_Random_start181,TSPA,72206,23118,49088,235,100,200
GreedyLS_Edges_Random_start182,TSPA,72271,21880,50391,219,100,200
GreedyLS_Edges_Random_start183,TSPA,72929,24261,48668,215,100,200
GreedyLS_Edges_Random_start184,TSPA,73678,24491,49187,221,100,200
GreedyLS_Edges_Random_start185,TSPA,73286,23379,49907,211,100,200
GreedyLS_Edges_Random_start186,TSPA,73527,24005,49522,211,100,200
GreedyLS_Edges_Random_start187,TSPA,73085,23800,49285,228,100,200
GreedyLS_Edges_Random_start188,TSPA,76933,22418,54515,226,100,200
GreedyLS_Edges_Random_start189,TSPA,73702,23409,50293,197,100,200
GreedyLS_Edges_Random_start190,TSPA,74300,24855,49445,209,100,200
GreedyLS_Edges_Random_start191,TSPA,72992,24363,48629,205,100,200
GreedyLS_Edges_Random_start192,TSPA,75612,24637,50975,203,100,200
GreedyLS_Edges_Random_start193,TSPA,73708,23003,50705,211,100,200
GreedyLS_Edges_Random_start194,TSPA,74164,23638,50526,188,100,200
GreedyLS_Edges_Random_start195,TSPA,73047,22960,50087,223,100,200
GreedyLS_Edges_Random_start196,TSPA,74720,22484,52236,205,100,200
GreedyLS_Edges_Random_start197,TSPA,73208,22806,50402,225,100,200
GreedyLS_Edges_Random_start198,TSPA,72866,23878,48988,204,100,200
GreedyLS_Edges_Random_start199,TSPA,74140,23924,50216,197,100,200
GreedyLS_Edges_GreedyCycle_start0,TSPA,73717,23887,49830,107,100,200
GreedyLS_Edges_GreedyCycle_start1,TSPA,72833,23595,49238,102,100,200
GreedyLS_Edges_GreedyCycle_start2,TSPA,72542,23356,49186,118,100,200
GreedyLS_Edges_GreedyCycle_start3,TSPA,74178,24684,49494,107,100,200
GreedyLS_Edges_GreedyCycle_start4,TSPA,73314,24414,48900,88,100,200
GreedyLS_Edges_GreedyCycle_start5,TSPA,73498,23592,49906,100,100,200
GreedyLS_Edges_GreedyCycle_start6,TSPA,72734,23314,49420,101,100,200
GreedyLS_Edges_GreedyCycle_start7,TSPA,74325,25187,49138,114,100,200
GreedyLS_Edges_GreedyCycle_start8,TSPA,70974,22608,48366,115,100,200
GreedyLS_Edges_GreedyCycle_start9,TSPA,74156,23776,50380,108,100,200
GreedyLS_Edges_GreedyCycle_start10,TSPA,71748,23787,47961,96,100,200
GreedyLS_Edges_GreedyCycle_start11,TSPA,74368,24067,50301,83,100,200
GreedyLS_Edges_GreedyCycle_start12,TSPA,71525,22166,49359,105,100,200
GreedyLS_Edges_GreedyCycle_start13,TSPA,73821,24371,49450,123,100,200
GreedyLS_Edges_GreedyCycle_start14,TSPA,72032,22729,49303,108,100,200
GreedyLS_Edges_GreedyCycle_start15,TSPA,73025,24519,48506,124,100,200
GreedyLS_Edges_GreedyCycle_start16,TSPA,73282,24268,49014,98,100,200
GreedyLS_Edges_GreedyCycle_start17,TSPA,72346,23310,49036,118,100,200
GreedyLS_Edges_GreedyCycle_start18,TSPA,73120,23869,49251,111,100,200
GreedyLS_Edges_GreedyCycle_start19,TSPA,72155,23279,48876,132,100,200
GreedyLS_Edges_GreedyCycle_start20,TSPA,73054,24299,48755,102,100,200
GreedyLS_Edges_GreedyCycle_start21,TSPA,73912,24985,48927,96,100,200
GreedyLS_Edges_GreedyCycle_start22,TSPA,71333,22996,48337,120,100,200
GreedyLS_Edges_GreedyCycle_start23,TSPA,71965,23688,48277,95,100,200
GreedyLS_Edges_GreedyCycle_start24,TSPA,72704,24071,48633,116,100,200
GreedyLS_Edges_GreedyCycle_start25,TSPA,73122,24033,49089,119,100,200
GreedyLS_Edges_GreedyCycle_start26,TSPA,72229,24254,47975,105,100,200
GreedyLS_Edges_GreedyCycle_start27,TSPA,72131,23297,48834,111,100,200
GreedyLS_Edges_GreedyCycle_start28,TSPA,74418,21547,52871,105,100,200
GreedyLS_Edges_GreedyCycle_start29,TSPA,72897,23784,49113,76,100,200
GreedyLS_Edges_GreedyCycle_start30,TSPA,73535,22960,50575,113,100,200
GreedyLS_Edges_GreedyCycle_start31,TSPA,74251,23120,51131,116,100,200
GreedyLS_Edges_GreedyCycle_start32,TSPA,72838,22883,49955,104,100,200
GreedyLS_Edges_GreedyCycle_start33,TSPA,73137,24463,48674,125,100,200
GreedyLS_Edges_GreedyCycle_start34,TSPA,72442,24243,48199,90,100,200
GreedyLS_Edges_GreedyCycle_start35,TSPA,75526,22903,52623,104,100,200
GreedyLS_Edges_GreedyCycle_start36,TSPA,72118,23259,48859,94,100,200
GreedyLS_Edges_GreedyCycle_start37,TSPA,73993,23275,50718,118,100,200
GreedyLS_Edges_GreedyCycle_start38,TSPA,71957,23012,48945,130,100,200
GreedyLS_Edges_GreedyCycle_start39,TSPA,73258,23593,49665,108,100,200
GreedyLS_Edges_GreedyCycle_start40,TSPA,72872,23679,49193,119,100,200
GreedyLS_Edges_GreedyCycle_start41,TSPA,71862,23057,48805,99,100,200
GreedyLS_Edges_GreedyCycle_start42,TSPA,73564,23396,50168,87,100,200
GreedyLS_Edges_GreedyCycle_start43,TSPA,70783,22804,47979,84,100,200
GreedyLS_Edges_GreedyCycle_start44,TSPA,72406,24129,48277,101,100,200
GreedyLS_Edges_GreedyCycle_start45,TSPA,73157,24248,48909,106,100,200
GreedyLS_Edges_GreedyCycle_start46,TSPA,72192,22864,49328,100,100,200
GreedyLS_Edges_GreedyCycle_start47,TSPA,71543,23666,47877,91,100,200
GreedyLS_Edges_GreedyCycle_start48,TSPA,74352,25199,49153,115,100,200
GreedyLS_Edges_GreedyCycle_start49,TSPA,72617,23855,48762,116,100,200
GreedyLS_Edges_GreedyCycle_start50,TSPA,72313,22607,49706,109,100,200
GreedyLS_Edges_GreedyCycle_start51,TSPA,72718,22336,50382,88,100,200
GreedyLS_Edges_GreedyCycle_start52,TSPA,72538,23225,49313,104,100,200
GreedyLS_Edges_GreedyCycle_start53,TSPA,73815,23151,50664,92,100,200
GreedyLS_Edges_GreedyCycle_start54,TSPA,72463,23475,48988,104,100,200
GreedyLS_Edges_GreedyCycle_start55,TSPA,74027,25267,48760,121,100,200
GreedyLS_Edges_GreedyCycle_start56,TSPA,73991,24921,49070,604,100,200
GreedyLS_Edges_GreedyCycle_start57,TSPA,71928,23079,48849,115,100,200
GreedyLS_Edges_GreedyCycle_start58,TSPA,72603,23794,48809,115,100,200
GreedyLS_Edges_GreedyCycle_start59,TSPA,73639,24322,49317,99,100,200
GreedyLS_Edges_GreedyCycle_start60,TSPA,73294,23230,50064,104,100,200
GreedyLS_Edges_GreedyCycle_start61,TSPA,71868,22870,48998,93,100,200
GreedyLS_Edges_GreedyCycle_start62,TSPA,74396,24604,49792,130,100,200
GreedyLS_Edges_GreedyCycle_start63,TSPA,71092,22603,48489,97,100,200
GreedyLS_Edges_GreedyCycle_start64,TSPA,73704,23312,50392,98,100,200
GreedyLS_Edges_GreedyCycle_start65,TSPA,72792,23269,49523,98,100,200
GreedyLS_Edges_GreedyCycle_start66,TSPA,73003,24700,48303,129,100,200
GreedyLS_Edges_GreedyCycle_start67,TSPA,73591,23811,49780,117,100,200
GreedyLS_Edges_GreedyCycle_start68,TSPA,74187,24586,49601,93,100,200
GreedyLS_Edges_GreedyCycle_start69,TSPA,72029,23370,48659,99,100,200
GreedyLS_Edges_GreedyCycle_start70,TSPA,72361,23441,48920,117,100,200
GreedyLS_Edges_GreedyCycle_start71,TSPA,73250,23631,49619,98,100,200
GreedyLS_Edges_GreedyCycle_start72,TSPA,71648,22616,49032,77,100,200
GreedyLS_Edges_GreedyCycle_start73,TSPA,73426,25000,48426,117,100,200
GreedyLS_Edges_GreedyCycle_start74,TSPA,72994,23386,49608,98,100,200
GreedyLS_Edges_GreedyCycle_start75,TSPA,74496,25093,49403,121,100,200
GreedyLS_Edges_GreedyCycle_start76,TSPA,71945,23751,48194,87,100,200
GreedyLS_Edges_GreedyCycle_start77,TSPA,72449,24247,48202,117,100,200
GreedyLS_Edges_GreedyCycle_start78,TSPA,73505,22531,50974,100,100,200
GreedyLS_Edges_GreedyCycle_start79,TSPA,72911,24283,48628,112,100,200
GreedyLS_Edges_GreedyCycle_start80,TSPA,72833,22144,50689,117,100,200
GreedyLS_Edges_GreedyCycle_start81,TSPA,73175,23691,49484,112,100,200
GreedyLS_Edges_GreedyCycle_start82,TSPA,73392,23210,50182,107,100,200
GreedyLS_Edges_GreedyCycle_start83,TSPA,72235,22973,49262,123,100,200
GreedyLS_Edges_GreedyCycle_start84,TSPA,73739,23403,50336,103,100,200
GreedyLS_Edges_GreedyCycle_start85,TSPA,73058,23798,49260,94,100,200
GreedyLS_Edges_GreedyCycle_start86,TSPA,72736,23823,48913,87,100,200
GreedyLS_Edges_GreedyCycle_start87,TSPA,71933,24176,47757,101,100,200
GreedyLS_Edges_GreedyCycle_start88,TSPA,73618,23440,50178,111,100,200
GreedyLS_Edges_GreedyCycle_start89,TSPA,73482,23732,49750,105,100,200
GreedyLS_Edges_GreedyCycle_start90,TSPA,71362,22165,49197,105,100,200
GreedyLS_Edges_GreedyCycle_start91,TSPA,71881,22954,48927,102,100,200
GreedyLS_Edges_GreedyCycle_start92,TSPA,72736,22976,49760,103,100,200
GreedyLS_Edges_GreedyCycle_start93,TSPA,71819,23017,48802,97,100,200
GreedyLS_Edges_GreedyCycle_start94,TSPA,71357,23537,47820,99,100,200
GreedyLS_Edges_GreedyCycle_start95,TSPA,72709,23077,49632,117,100,200
GreedyLS_Edges_GreedyCycle_start96,TSPA,73335,23507,49828,110,100,200
GreedyLS_Edges_GreedyCycle_start97,TSPA,71274,23174,48100,114,100,200
GreedyLS_Edges_GreedyCycle_start98,TSPA,73274,23590,49684,90,100,200
GreedyLS_Edges_GreedyCycle_start99,TSPA,72086,23370,48716,112,100,200
GreedyLS_Edges_GreedyCycle_start100,TSPA,72121,23271,48850,118,100,200
GreedyLS_Edges_GreedyCycle_start101,TSPA,70944,23015,47929,128,100,200
GreedyLS_Edges_GreedyCycle_start102,TSPA,72311,24007,48304,91,100,200
GreedyLS_Edges_GreedyCycle_start103,TSPA,72615,23732,48883,116,100,200
GreedyLS_Edges_GreedyCycle_start104,TSPA,76040,25531,50509,106,100,200
GreedyLS_Edges_GreedyCycle_start105,TSPA,72837,22937,49900,111,100,200
GreedyLS_Edges_GreedyCycle_start106,TSPA,72156,23911,48245,94,100,200
GreedyLS_Edges_GreedyCycle_start107,TSPA,74292,24657,49635,105,100,200
GreedyLS_Edges_GreedyCycle_start108,TSPA,72855,23432,49423,103,100,200
GreedyLS_Edges_GreedyCycle_start109,TSPA,72581,23118,49463,108,100,200
GreedyLS_Edges_GreedyCycle_start110,TSPA,71882,23106,48776,106,100,200
GreedyLS_Edges_GreedyCycle_start111,TSPA,72873,24550,48323,114,100,200
GreedyLS_Edges_GreedyCycle_start112,TSPA,72383,24172,48211,111,100,200
GreedyLS_Edges_GreedyCycle_start113,TSPA,73483,23279,50204,101,100,200
GreedyLS_Edges_GreedyCycle_start114,TSPA,73929,24509,49420,93,100,200
GreedyLS_Edges_GreedyCycle_start115,TSPA,72927,24035,48892,93,100,200
GreedyLS_Edges_GreedyCycle_start116,TSPA,72617,23362,49255,92,100,200
GreedyLS_Edges_GreedyCycle_start117,TSPA,73028,23867,49161,108,100,200
GreedyLS_Edges_GreedyCycle_start118,TSPA,72999,23639,49360,99,100,200
GreedyLS_Edges_GreedyCycle_start119,TSPA,71678,23375,48303,100,100,200
GreedyLS_Edges_GreedyCycle_start120,TSPA,73363,23053,50310,114,100,200
GreedyLS_Edges_GreedyCycle_start121,TSPA,73263,24130,49133,107,100,200
GreedyLS_Edges_GreedyCycle_start122,TSPA,73505,23472,50033,99,100,200
GreedyLS_Edges_GreedyCycle_start123,TSPA,73276,24099,49177,102,100,200
GreedyLS_Edges_GreedyCycle_start124,TSPA,72745,23677,49068,112,100,200
GreedyLS_Edges_GreedyCycle_start125,TSPA,74494,23753,50741,118,100,200
GreedyLS_Edges_GreedyCycle_start126,TSPA,73107,23372,49735,116,100,200
GreedyLS_Edges_GreedyCycle_start127,TSPA,72609,22729,49880,105,100,200
GreedyLS_Edges_GreedyCycle_start128,TSPA,72830,23856,48974,103,100,200
GreedyLS_Edges_GreedyCycle_start129,TSPA,71803,22288,49515,102,100,200
GreedyLS_Edges_GreedyCycle_start130,TSPA,72861,24369,48492,86,100,200
GreedyLS_Edges_GreedyCycle_start131,TSPA,73541,23177,50364,101,100,200
GreedyLS_Edges_GreedyCycle_start132,TSPA,72610,24000,48610,99,100,200
GreedyLS_Edges_GreedyCycle_start133,TSPA,73530,24239,49291,81,100,200
GreedyLS_Edges_GreedyCycle_start134,TSPA,72930,23344,49586,90,100,200
GreedyLS_Edges_GreedyCycle_start135,TSPA,72646,24161,48485,101,100,200
GreedyLS_Edges_GreedyCycle_start136,TSPA,71761,23284,48477,113,100,200
GreedyLS_Edges_GreedyCycle_start137,TSPA,73036,24207,48829,94,100,200
GreedyLS_Edges_GreedyCycle_start138,TSPA,73109,24357,48752,118,100,200
GreedyLS_Edges_GreedyCycle_start139,TSPA,71965,22628,49337,101,100,200
GreedyLS_Edges_GreedyCycle_start140,TSPA,72205,23770,48435,99,100,200
GreedyLS_Edges_GreedyCycle_start141,TSPA,73431,24564,48867,87,100,200
GreedyLS_Edges_GreedyCycle_start142,TSPA,72435,23684,48751,102,100,200
GreedyLS_Edges_GreedyCycle_start143,TSPA,73098,24148,48950,104,100,200
GreedyLS_Edges_GreedyCycle_start144,TSPA,72899,23616,49283,115,100,200
GreedyLS_Edges_GreedyCycle_start145,TSPA,73835,23819,50016,93,100,200
GreedyLS_Edges_GreedyCycle_start146,TSPA,74650,24534,50116,103,100,200
GreedyLS_Edges_GreedyCycle_start147,TSPA,71245,22939,48306,101,100,200
GreedyLS_Edges_GreedyCycle_start148,TSPA,72419,23733,48686,113,100,200
GreedyLS_Edges_GreedyCycle_start149,TSPA,73675,23083,50592,88,100,200
GreedyLS_Edges_GreedyCycle_start150,TSPA,73326,23062,50264,104,100,200
GreedyLS_Edges_GreedyCycle_start151,TSPA,72217,23955,48262,101,100,200
GreedyLS_Edges_GreedyCycle_start152,TSPA,72219,23671,48548,138,100,200
GreedyLS_Edges_GreedyCycle_start153,TSPA,73289,24592,48697,102,100,200
GreedyLS_Edges_GreedyCycle_start154,TSPA,73197,23531,49666,109,100,200
GreedyLS_Edges_GreedyCycle_start155,TSPA,73647,23821,49826,118,100,200
GreedyLS_Edges_GreedyCycle_start156,TSPA,72973,24308,48665,97,100,200
GreedyLS_Edges_GreedyCycle_start157,TSPA,73659,24999,48660,144,100,200
GreedyLS_Edges_GreedyCycle_start158,TSPA,73423,23431,49992,112,100,200
GreedyLS_Edges_GreedyCycle_start159,TSPA,72549,24271,48278,114,100,200
GreedyLS_Edges_GreedyCycle_start160,TSPA,71569,23384,48185,96,100,200
GreedyLS_Edges_GreedyCycle_start161,TSPA,72371,23813,48558,99,100,200
GreedyLS_Edges_GreedyCycle_start162,TSPA,73006,23862,49144,111,100,200
GreedyLS_Edges_GreedyCycle_start163,TSPA,72126,23221,48905,96,100,200
GreedyLS_Edges_GreedyCycle_start164,TSPA,72302,23723,48579,128,100,200
GreedyLS_Edges_GreedyCycle_start165,TSPA,73294,24847,48447,99,100,200
GreedyLS_Edges_GreedyCycle_start166,TSPA,75045,24086,50959,100,100,200
GreedyLS_Edges_GreedyCycle_start167,TSPA,72831,24271,48560,87,100,200
GreedyLS_Edges_GreedyCycle_start168,TSPA,72844,23978,48866,98,100,200
GreedyLS_Edges_GreedyCycle_start169,TSPA,73089,23789,49300,99,100,200
GreedyLS_Edges_GreedyCycle_start170,TSPA,72913,23599,49314,112,100,200
GreedyLS_Edges_GreedyCycle_start171,TSPA,73368,23705,49663,100,100,200
GreedyLS_Edges_GreedyCycle_start172,TSPA,72558,24212,48346,100,100,200
GreedyLS_Edges_GreedyCycle_start173,TSPA,71503,23811,47692,113,100,200
GreedyLS_Edges_GreedyCycle_start174,TSPA,72309,23662,48647,103,100,200
GreedyLS_Edges_GreedyCycle_start175,TSPA,72024,23335,48689,97,100,200
GreedyLS_Edges_GreedyCycle_start176,TSPA,73306,23122,50184,108,100,200
GreedyLS_Edges_GreedyCycle_start177,TSPA,73262,24675,48587,87,100,200
GreedyLS_Edges_GreedyCycle_start178,TSPA,73111,24605,48506,90,100,200
GreedyLS_Edges_GreedyCycle_start179,TSPA,71173,23174,47999,113,100,200
GreedyLS_Edges_GreedyCycle_start180,TSPA,72331,23642,48689,110,100,200
GreedyLS_Edges_GreedyCycle_start181,TSPA,73528,24432,49096,93,100,200
GreedyLS_Edges_GreedyCycle_start182,TSPA,71441,22887,48554,99,100,200
GreedyLS_Edges_GreedyCycle_start183,TSPA,72887,23058,49829,106,100,200
GreedyLS_Edges_GreedyCycle_start184,TSPA,71067,22794,48273,99,100,200
GreedyLS_Edges_GreedyCycle_start185,TSPA,71261,22204,49057,122,100,200
GreedyLS_Edges_GreedyCycle_start186,TSPA,72274,24476,47798,92,100,200
GreedyLS_Edges_GreedyCycle_start187,TSPA,72551,23588,48963,101,100,200
GreedyLS_Edges_GreedyCycle_start188,TSPA,72938,23493,49445,108,100,200
GreedyLS_Edges_GreedyCycle_start189,TSPA,73017,23461,49556,95,100,200
GreedyLS_Edges_GreedyCycle_start190,TSPA,73221,24468,48753,89,100,200
GreedyLS_Edges_GreedyCycle_start191,TSPA,73264,23960,49304,100,100,200
GreedyLS_Edges_GreedyCycle_start192,TSPA,72444,24068,48376,95,100,200
GreedyLS_Edges_GreedyCycle_start193,TSPA,73556,23879,49677,113,100,200
GreedyLS_Edges_GreedyCycle_start194,TSPA,72009,23474,48535,101,100,200
GreedyLS_Edges_GreedyCycle_start195,TSPA,73647,24441,49206,108,100,200
GreedyLS_Edges_GreedyCycle_start196,TSPA,72838,23485,49353,106,100,200
GreedyLS_Edges_GreedyCycle_start197,TSPA,72611,23123,49488,100,100,200
GreedyLS_Edges_GreedyCycle_start198,TSPA,72757,23956,48801,105,100,200
GreedyLS_Edges_GreedyCycle_start199,TSPA,72750,23514,49236,99,100,200
