algorithm,instance,objective_value,path_length,node_costs,computation_time_ms,selected_nodes,total_nodes
SteepestLS_Nodes_Random_start0,TSPA,85818,35825,49993,134,100,200
SteepestLS_Nodes_Random_start1,TSPA,88540,39668,48872,102,100,200
SteepestLS_Nodes_Random_start2,TSPA,84786,36769,48017,70,100,200
SteepestLS_Nodes_Random_start3,TSPA,89283,41013,48270,103,100,200
SteepestLS_Nodes_Random_start4,TSPA,87040,37330,49710,82,100,200
SteepestLS_Nodes_Random_start5,TSPA,91051,41483,49568,60,100,200
SteepestLS_Nodes_Random_start6,TSPA,82625,33818,48807,72,100,200
SteepestLS_Nodes_Random_start7,TSPA,87593,39135,48458,95,100,200
SteepestLS_Nodes_Random_start8,TSPA,93172,43896,49276,60,100,200
SteepestLS_Nodes_Random_start9,TSPA,92714,44555,48159,65,100,200
SteepestLS_Nodes_Random_start10,TSPA,88440,37660,50780,69,100,200
SteepestLS_Nodes_Random_start11,TSPA,91003,43614,47389,95,100,200
SteepestLS_Nodes_Random_start12,TSPA,88776,38641,50135,66,100,200
SteepestLS_Nodes_Random_start13,TSPA,86865,37504,49361,74,100,200
SteepestLS_Nodes_Random_start14,TSPA,84192,35353,48839,65,100,200
SteepestLS_Nodes_Random_start15,TSPA,91924,42156,49768,66,100,200
SteepestLS_Nodes_Random_start16,TSPA,85289,35148,50141,65,100,200
SteepestLS_Nodes_Random_start17,TSPA,80895,31096,49799,70,100,200
SteepestLS_Nodes_Random_start18,TSPA,84763,36171,48592,64,100,200
SteepestLS_Nodes_Random_start19,TSPA,89243,41016,48227,71,100,200
SteepestLS_Nodes_Random_start20,TSPA,97487,49358,48129,62,100,200
SteepestLS_Nodes_Random_start21,TSPA,87563,37090,50473,76,100,200
SteepestLS_Nodes_Random_start22,TSPA,87544,35325,52219,58,100,200
SteepestLS_Nodes_Random_start23,TSPA,94692,46476,48216,68,100,200
SteepestLS_Nodes_Random_start24,TSPA,92234,43370,48864,61,100,200
SteepestLS_Nodes_Random_start25,TSPA,88503,39015,49488,79,100,200
SteepestLS_Nodes_Random_start26,TSPA,83018,34029,48989,72,100,200
SteepestLS_Nodes_Random_start27,TSPA,86101,36846,49255,76,100,200
SteepestLS_Nodes_Random_start28,TSPA,91218,43960,47258,57,100,200
SteepestLS_Nodes_Random_start29,TSPA,82423,31687,50736,73,100,200
SteepestLS_Nodes_Random_start30,TSPA,88053,38966,49087,57,100,200
SteepestLS_Nodes_Random_start31,TSPA,86059,35890,50169,70,100,200
SteepestLS_Nodes_Random_start32,TSPA,84509,35580,48929,80,100,200
SteepestLS_Nodes_Random_start33,TSPA,93520,41984,51536,76,100,200
SteepestLS_Nodes_Random_start34,TSPA,87146,38193,48953,60,100,200
SteepestLS_Nodes_Random_start35,TSPA,86817,36279,50538,75,100,200
SteepestLS_Nodes_Random_start36,TSPA,89931,38847,51084,87,100,200
SteepestLS_Nodes_Random_start37,TSPA,89170,40727,48443,66,100,200
SteepestLS_Nodes_Random_start38,TSPA,90942,42446,48496,66,100,200
SteepestLS_Nodes_Random_start39,TSPA,87453,38828,48625,73,100,200
SteepestLS_Nodes_Random_start40,TSPA,89338,41196,48142,57,100,200
SteepestLS_Nodes_Random_start41,TSPA,84796,35669,49127,76,100,200
SteepestLS_Nodes_Random_start42,TSPA,88535,39954,48581,64,100,200
SteepestLS_Nodes_Random_start43,TSPA,94244,45837,48407,68,100,200
SteepestLS_Nodes_Random_start44,TSPA,86935,36956,49979,61,100,200
SteepestLS_Nodes_Random_start45,TSPA,91249,42176,49073,66,100,200
SteepestLS_Nodes_Random_start46,TSPA,88029,39821,48208,67,100,200
SteepestLS_Nodes_Random_start47,TSPA,89929,41451,48478,66,100,200
SteepestLS_Nodes_Random_start48,TSPA,85225,35551,49674,69,100,200
SteepestLS_Nodes_Random_start49,TSPA,90000,40034,49966,72,100,200
SteepestLS_Nodes_Random_start50,TSPA,88025,37679,50346,71,100,200
SteepestLS_Nodes_Random_start51,TSPA,85845,37537,48308,75,100,200
SteepestLS_Nodes_Random_start52,TSPA,90505,42171,48334,68,100,200
SteepestLS_Nodes_Random_start53,TSPA,89407,40328,49079,62,100,200
SteepestLS_Nodes_Random_start54,TSPA,86435,38362,48073,65,100,200
SteepestLS_Nodes_Random_start55,TSPA,85493,34168,51325,72,100,200
SteepestLS_Nodes_Random_start56,TSPA,86486,36273,50213,67,100,200
SteepestLS_Nodes_Random_start57,TSPA,87407,37166,50241,63,100,200
SteepestLS_Nodes_Random_start58,TSPA,89358,40372,48986,66,100,200
SteepestLS_Nodes_Random_start59,TSPA,87929,39565,48364,79,100,200
SteepestLS_Nodes_Random_start60,TSPA,89533,40780,48753,69,100,200
SteepestLS_Nodes_Random_start61,TSPA,85294,36111,49183,79,100,200
SteepestLS_Nodes_Random_start62,TSPA,92095,43131,48964,62,100,200
SteepestLS_Nodes_Random_start63,TSPA,85342,35131,50211,66,100,200
SteepestLS_Nodes_Random_start64,TSPA,88055,39349,48706,75,100,200
SteepestLS_Nodes_Random_start65,TSPA,87592,39583,48009,69,100,200
SteepestLS_Nodes_Random_start66,TSPA,87478,39337,48141,68,100,200
SteepestLS_Nodes_Random_start67,TSPA,85392,36647,48745,77,100,200
SteepestLS_Nodes_Random_start68,TSPA,89460,40026,49434,71,100,200
SteepestLS_Nodes_Random_start69,TSPA,87385,36879,50506,61,100,200
SteepestLS_Nodes_Random_start70,TSPA,85876,36806,49070,68,100,200
SteepestLS_Nodes_Random_start71,TSPA,89648,40470,49178,78,100,200
SteepestLS_Nodes_Random_start72,TSPA,94628,44104,50524,70,100,200
SteepestLS_Nodes_Random_start73,TSPA,89748,41815,47933,70,100,200
SteepestLS_Nodes_Random_start74,TSPA,87408,39460,47948,63,100,200
SteepestLS_Nodes_Random_start75,TSPA,85874,37477,48397,65,100,200
SteepestLS_Nodes_Random_start76,TSPA,82575,32990,49585,70,100,200
SteepestLS_Nodes_Random_start77,TSPA,90148,41209,48939,69,100,200
SteepestLS_Nodes_Random_start78,TSPA,89098,39057,50041,66,100,200
SteepestLS_Nodes_Random_start79,TSPA,91486,41941,49545,78,100,200
SteepestLS_Nodes_Random_start80,TSPA,83201,33843,49358,62,100,200
SteepestLS_Nodes_Random_start81,TSPA,89168,41286,47882,68,100,200
SteepestLS_Nodes_Random_start82,TSPA,81374,32381,48993,66,100,200
SteepestLS_Nodes_Random_start83,TSPA,89928,37353,52575,69,100,200
SteepestLS_Nodes_Random_start84,TSPA,88420,37232,51188,73,100,200
SteepestLS_Nodes_Random_start85,TSPA,89741,41591,48150,76,100,200
SteepestLS_Nodes_Random_start86,TSPA,94153,45492,48661,60,100,200
SteepestLS_Nodes_Random_start87,TSPA,88774,39351,49423,56,100,200
SteepestLS_Nodes_Random_start88,TSPA,88505,38643,49862,76,100,200
SteepestLS_Nodes_Random_start89,TSPA,83671,35623,48048,71,100,200
SteepestLS_Nodes_Random_start90,TSPA,86194,36036,50158,79,100,200
SteepestLS_Nodes_Random_start91,TSPA,87907,39616,48291,64,100,200
SteepestLS_Nodes_Random_start92,TSPA,83599,33837,49762,71,100,200
SteepestLS_Nodes_Random_start93,TSPA,89638,37767,51871,66,100,200
SteepestLS_Nodes_Random_start94,TSPA,91844,42927,48917,57,100,200
SteepestLS_Nodes_Random_start95,TSPA,87709,39094,48615,77,100,200
SteepestLS_Nodes_Random_start96,TSPA,90679,42102,48577,70,100,200
SteepestLS_Nodes_Random_start97,TSPA,87225,38886,48339,82,100,200
SteepestLS_Nodes_Random_start98,TSPA,82416,33049,49367,64,100,200
SteepestLS_Nodes_Random_start99,TSPA,87896,38753,49143,64,100,200
SteepestLS_Nodes_Random_start100,TSPA,87924,40017,47907,63,100,200
SteepestLS_Nodes_Random_start101,TSPA,85663,36924,48739,75,100,200
SteepestLS_Nodes_Random_start102,TSPA,83510,34214,49296,68,100,200
SteepestLS_Nodes_Random_start103,TSPA,95640,45788,49852,63,100,200
SteepestLS_Nodes_Random_start104,TSPA,90914,41239,49675,61,100,200
SteepestLS_Nodes_Random_start105,TSPA,92023,43289,48734,70,100,200
SteepestLS_Nodes_Random_start106,TSPA,92212,42661,49551,54,100,200
SteepestLS_Nodes_Random_start107,TSPA,86446,36553,49893,77,100,200
SteepestLS_Nodes_Random_start108,TSPA,91188,41618,49570,72,100,200
SteepestLS_Nodes_Random_start109,TSPA,83829,34714,49115,68,100,200
SteepestLS_Nodes_Random_start110,TSPA,84326,35127,49199,71,100,200
SteepestLS_Nodes_Random_start111,TSPA,91749,44128,47621,63,100,200
SteepestLS_Nodes_Random_start112,TSPA,89125,39964,49161,68,100,200
SteepestLS_Nodes_Random_start113,TSPA,91055,42189,48866,69,100,200
SteepestLS_Nodes_Random_start114,TSPA,89480,40567,48913,65,100,200
SteepestLS_Nodes_Random_start115,TSPA,88354,38876,49478,65,100,200
SteepestLS_Nodes_Random_start116,TSPA,88968,39258,49710,67,100,200
SteepestLS_Nodes_Random_start117,TSPA,84123,35637,48486,70,100,200
SteepestLS_Nodes_Random_start118,TSPA,87271,35404,51867,60,100,200
SteepestLS_Nodes_Random_start119,TSPA,91207,42227,48980,61,100,200
SteepestLS_Nodes_Random_start120,TSPA,89836,39898,49938,61,100,200
SteepestLS_Nodes_Random_start121,TSPA,90018,39672,50346,67,100,200
SteepestLS_Nodes_Random_start122,TSPA,87036,36411,50625,60,100,200
SteepestLS_Nodes_Random_start123,TSPA,83356,32270,51086,75,100,200
SteepestLS_Nodes_Random_start124,TSPA,89659,39150,50509,68,100,200
SteepestLS_Nodes_Random_start125,TSPA,86463,37075,49388,55,100,200
SteepestLS_Nodes_Random_start126,TSPA,91678,42662,49016,71,100,200
SteepestLS_Nodes_Random_start127,TSPA,89996,39986,50010,72,100,200
SteepestLS_Nodes_Random_start128,TSPA,91310,40760,50550,64,100,200
SteepestLS_Nodes_Random_start129,TSPA,84437,35205,49232,79,100,200
SteepestLS_Nodes_Random_start130,TSPA,84734,35216,49518,77,100,200
SteepestLS_Nodes_Random_start131,TSPA,85918,37074,48844,76,100,200
SteepestLS_Nodes_Random_start132,TSPA,84150,35559,48591,68,100,200
SteepestLS_Nodes_Random_start133,TSPA,84381,35504,48877,73,100,200
SteepestLS_Nodes_Random_start134,TSPA,83592,34570,49022,76,100,200
SteepestLS_Nodes_Random_start135,TSPA,92185,42205,49980,58,100,200
SteepestLS_Nodes_Random_start136,TSPA,88391,38772,49619,78,100,200
SteepestLS_Nodes_Random_start137,TSPA,86181,36171,50010,68,100,200
SteepestLS_Nodes_Random_start138,TSPA,91781,41265,50516,63,100,200
SteepestLS_Nodes_Random_start139,TSPA,87576,37911,49665,73,100,200
SteepestLS_Nodes_Random_start140,TSPA,85213,35482,49731,80,100,200
SteepestLS_Nodes_Random_start141,TSPA,89410,39570,49840,65,100,200
SteepestLS_Nodes_Random_start142,TSPA,87312,35683,51629,69,100,200
SteepestLS_Nodes_Random_start143,TSPA,83989,35957,48032,72,100,200
SteepestLS_Nodes_Random_start144,TSPA,91534,42350,49184,64,100,200
SteepestLS_Nodes_Random_start145,TSPA,88942,37148,51794,69,100,200
SteepestLS_Nodes_Random_start146,TSPA,89693,37904,51789,68,100,200
SteepestLS_Nodes_Random_start147,TSPA,87413,37652,49761,66,100,200
SteepestLS_Nodes_Random_start148,TSPA,90822,40857,49965,78,100,200
SteepestLS_Nodes_Random_start149,TSPA,90674,41310,49364,65,100,200
SteepestLS_Nodes_Random_start150,TSPA,91184,41643,49541,59,100,200
SteepestLS_Nodes_Random_start151,TSPA,92647,44286,48361,67,100,200
SteepestLS_Nodes_Random_start152,TSPA,88100,40136,47964,59,100,200
SteepestLS_Nodes_Random_start153,TSPA,85178,35642,49536,71,100,200
SteepestLS_Nodes_Random_start154,TSPA,87048,37569,49479,59,100,200
SteepestLS_Nodes_Random_start155,TSPA,89938,40402,49536,68,100,200
SteepestLS_Nodes_Random_start156,TSPA,87160,36678,50482,62,100,200
SteepestLS_Nodes_Random_start157,TSPA,86714,37149,49565,76,100,200
SteepestLS_Nodes_Random_start158,TSPA,86862,38462,48400,78,100,200
SteepestLS_Nodes_Random_start159,TSPA,86357,37373,48984,66,100,200
SteepestLS_Nodes_Random_start160,TSPA,92203,42478,49725,78,100,200
SteepestLS_Nodes_Random_start161,TSPA,90451,42406,48045,77,100,200
SteepestLS_Nodes_Random_start162,TSPA,86088,37369,48719,60,100,200
SteepestLS_Nodes_Random_start163,TSPA,89639,36856,52783,62,100,200
SteepestLS_Nodes_Random_start164,TSPA,83160,34794,48366,77,100,200
SteepestLS_Nodes_Random_start165,TSPA,87358,39089,48269,83,100,200
SteepestLS_Nodes_Random_start166,TSPA,89800,42409,47391,66,100,200
SteepestLS_Nodes_Random_start167,TSPA,90374,41226,49148,75,100,200
SteepestLS_Nodes_Random_start168,TSPA,92380,44525,47855,69,100,200
SteepestLS_Nodes_Random_start169,TSPA,90248,41513,48735,67,100,200
SteepestLS_Nodes_Random_start170,TSPA,91640,43202,48438,65,100,200
SteepestLS_Nodes_Random_start171,TSPA,92990,43887,49103,67,100,200
SteepestLS_Nodes_Random_start172,TSPA,90217,41129,49088,65,100,200
SteepestLS_Nodes_Random_start173,TSPA,94116,40782,53334,65,100,200
SteepestLS_Nodes_Random_start174,TSPA,83246,34412,48834,78,100,200
SteepestLS_Nodes_Random_start175,TSPA,91991,43580,48411,74,100,200
SteepestLS_Nodes_Random_start176,TSPA,84257,34416,49841,69,100,200
SteepestLS_Nodes_Random_start177,TSPA,84378,36141,48237,62,100,200
SteepestLS_Nodes_Random_start178,TSPA,80976,30922,50054,72,100,200
SteepestLS_Nodes_Random_start179,TSPA,81105,32811,48294,72,100,200
SteepestLS_Nodes_Random_start180,TSPA,91379,41198,50181,69,100,200
SteepestLS_Nodes_Random_start181,TSPA,88207,37643,50564,68,100,200
SteepestLS_Nodes_Random_start182,TSPA,91326,41797,49529,69,100,200
SteepestLS_Nodes_Random_start183,TSPA,87635,40025,47610,67,100,200
SteepestLS_Nodes_Random_start184,TSPA,92179,43223,48956,57,100,200
SteepestLS_Nodes_Random_start185,TSPA,82519,33439,49080,74,100,200
SteepestLS_Nodes_Random_start186,TSPA,88789,37915,50874,62,100,200
SteepestLS_Nodes_Random_start187,TSPA,84266,35050,49216,62,100,200
SteepestLS_Nodes_Random_start188,TSPA,87072,38409,48663,69,100,200
SteepestLS_Nodes_Random_start189,TSPA,86065,36539,49526,58,100,200
SteepestLS_Nodes_Random_start190,TSPA,87977,37484,50493,76,100,200
SteepestLS_Nodes_Random_start191,TSPA,94707,46642,48065,70,100,200
SteepestLS_Nodes_Random_start192,TSPA,84732,36819,47913,63,100,200
SteepestLS_Nodes_Random_start193,TSPA,82842,33504,49338,60,100,200
SteepestLS_Nodes_Random_start194,TSPA,93287,43142,50145,66,100,200
SteepestLS_Nodes_Random_start195,TSPA,91533,42500,49033,67,100,200
SteepestLS_Nodes_Random_start196,TSPA,88500,38392,50108,70,100,200
SteepestLS_Nodes_Random_start197,TSPA,88050,40031,48019,69,100,200
SteepestLS_Nodes_Random_start198,TSPA,92515,44081,48434,67,100,200
SteepestLS_Nodes_Random_start199,TSPA,89640,41099,48541,69,100,200
SteepestLS_Nodes_NearestNeighborAny2Regret_w1_1_start0,TSPA,70217,22721,47496,17,100,200
SteepestLS_Nodes_NearestNeighborAny2Regret_w1_1_start1,TSPA,70641,22384,48257,26,100,200
SteepestLS_Nodes_NearestNeighborAny2Regret_w1_1_start2,TSPA,70641,22384,48257,17,100,200
SteepestLS_Nodes_NearestNeighborAny2Regret_w1_1_start3,TSPA,73588,25402,48186,19,100,200
SteepestLS_Nodes_NearestNeighborAny2Regret_w1_1_start4,TSPA,70152,22156,47996,15,100,200
SteepestLS_Nodes_NearestNeighborAny2Regret_w1_1_start5,TSPA,70641,22384,48257,16,100,200
SteepestLS_Nodes_NearestNeighborAny2Regret_w1_1_start6,TSPA,70940,22302,48638,16,100,200
SteepestLS_Nodes_NearestNeighborAny2Regret_w1_1_start7,TSPA,72160,24452,47708,17,100,200
SteepestLS_Nodes_NearestNeighborAny2Regret_w1_1_start8,TSPA,72910,24602,48308,6,100,200
SteepestLS_Nodes_NearestNeighborAny2Regret_w1_1_start9,TSPA,73719,25751,47968,5,100,200
SteepestLS_Nodes_NearestNeighborAny2Regret_w1_1_start10,TSPA,72411,24239,48172,6,100,200
SteepestLS_Nodes_NearestNeighborAny2Regret_w1_1_start11,TSPA,70690,22535,48155,5,100,200
SteepestLS_Nodes_NearestNeighborAny2Regret_w1_1_start12,TSPA,72183,23576,48607,4,100,200
SteepestLS_Nodes_NearestNeighborAny2Regret_w1_1_start13,TSPA,73968,25737,48231,5,100,200
SteepestLS_Nodes_NearestNeighborAny2Regret_w1_1_start14,TSPA,73616,25430,48186,6,100,200
SteepestLS_Nodes_NearestNeighborAny2Regret_w1_1_start15,TSPA,70217,22721,47496,4,100,200
SteepestLS_Nodes_NearestNeighborAny2Regret_w1_1_start16,TSPA,74657,26280,48377,4,100,200
SteepestLS_Nodes_NearestNeighborAny2Regret_w1_1_start17,TSPA,70892,22203,48689,4,100,200
SteepestLS_Nodes_NearestNeighborAny2Regret_w1_1_start18,TSPA,70641,22384,48257,4,100,200
SteepestLS_Nodes_NearestNeighborAny2Regret_w1_1_start19,TSPA,70602,22157,48445,5,100,200
SteepestLS_Nodes_NearestNeighborAny2Regret_w1_1_start20,TSPA,71929,23364,48565,4,100,200
SteepestLS_Nodes_NearestNeighborAny2Regret_w1_1_start21,TSPA,73403,24965,48438,5,100,200
SteepestLS_Nodes_NearestNeighborAny2Regret_w1_1_start22,TSPA,72149,24079,48070,4,100,200
SteepestLS_Nodes_NearestNeighborAny2Regret_w1_1_start23,TSPA,72854,24477,48377,3,100,200
SteepestLS_Nodes_NearestNeighborAny2Regret_w1_1_start24,TSPA,70300,22156,48144,4,100,200
SteepestLS_Nodes_NearestNeighborAny2Regret_w1_1_start25,TSPA,70641,22384,48257,4,100,200
SteepestLS_Nodes_NearestNeighborAny2Regret_w1_1_start26,TSPA,70570,21993,48577,4,100,200
SteepestLS_Nodes_NearestNeighborAny2Regret_w1_1_start27,TSPA,72834,24362,48472,8,100,200
SteepestLS_Nodes_NearestNeighborAny2Regret_w1_1_start28,TSPA,70325,22296,48029,3,100,200
SteepestLS_Nodes_NearestNeighborAny2Regret_w1_1_start29,TSPA,71417,23022,48395,7,100,200
SteepestLS_Nodes_NearestNeighborAny2Regret_w1_1_start30,TSPA,71782,23746,48036,7,100,200
SteepestLS_Nodes_NearestNeighborAny2Regret_w1_1_start31,TSPA,73868,25598,48270,4,100,200
SteepestLS_Nodes_NearestNeighborAny2Regret_w1_1_start32,TSPA,73616,25430,48186,7,100,200
SteepestLS_Nodes_NearestNeighborAny2Regret_w1_1_start33,TSPA,72773,24590,48183,5,100,200
SteepestLS_Nodes_NearestNeighborAny2Regret_w1_1_start34,TSPA,73249,25283,47966,5,100,200
SteepestLS_Nodes_NearestNeighborAny2Regret_w1_1_start35,TSPA,69801,21778,48023,4,100,200
SteepestLS_Nodes_NearestNeighborAny2Regret_w1_1_start36,TSPA,72537,23691,48846,3,100,200
SteepestLS_Nodes_NearestNeighborAny2Regret_w1_1_start37,TSPA,72773,24590,48183,5,100,200
SteepestLS_Nodes_NearestNeighborAny2Regret_w1_1_start38,TSPA,73968,25737,48231,4,100,200
SteepestLS_Nodes_NearestNeighborAny2Regret_w1_1_start39,TSPA,72081,23968,48113,5,100,200
SteepestLS_Nodes_NearestNeighborAny2Regret_w1_1_start40,TSPA,72930,25077,47853,5,100,200
SteepestLS_Nodes_NearestNeighborAny2Regret_w1_1_start41,TSPA,71878,24169,47709,3,100,200
SteepestLS_Nodes_NearestNeighborAny2Regret_w1_1_start42,TSPA,70641,22384,48257,5,100,200
SteepestLS_Nodes_NearestNeighborAny2Regret_w1_1_start43,TSPA,74023,25928,48095,3,100,200
SteepestLS_Nodes_NearestNeighborAny2Regret_w1_1_start44,TSPA,70641,22384,48257,4,100,200
SteepestLS_Nodes_NearestNeighborAny2Regret_w1_1_start45,TSPA,71907,23517,48390,6,100,200
SteepestLS_Nodes_NearestNeighborAny2Regret_w1_1_start46,TSPA,70217,22721,47496,4,100,200
SteepestLS_Nodes_NearestNeighborAny2Regret_w1_1_start47,TSPA,74185,25878,48307,6,100,200
SteepestLS_Nodes_NearestNeighborAny2Regret_w1_1_start48,TSPA,72343,22957,49386,5,100,200
SteepestLS_Nodes_NearestNeighborAny2Regret_w1_1_start49,TSPA,70217,22721,47496,4,100,200
SteepestLS_Nodes_NearestNeighborAny2Regret_w1_1_start50,TSPA,70586,21897,48689,5,100,200
SteepestLS_Nodes_NearestNeighborAny2Regret_w1_1_start51,TSPA,71939,24343,47596,3,100,200
SteepestLS_Nodes_NearestNeighborAny2Regret_w1_1_start52,TSPA,73978,25462,48516,4,100,200
SteepestLS_Nodes_NearestNeighborAny2Regret_w1_1_start53,TSPA,70641,22384,48257,4,100,200
SteepestLS_Nodes_NearestNeighborAny2Regret_w1_1_start54,TSPA,70152,22156,47996,3,100,200
SteepestLS_Nodes_NearestNeighborAny2Regret_w1_1_start55,TSPA,73978,25462,48516,4,100,200
SteepestLS_Nodes_NearestNeighborAny2Regret_w1_1_start56,TSPA,73605,25228,48377,3,100,200
SteepestLS_Nodes_NearestNeighborAny2Regret_w1_1_start57,TSPA,75405,27135,48270,4,100,200
SteepestLS_Nodes_NearestNeighborAny2Regret_w1_1_start58,TSPA,73690,24802,48888,4,100,200
SteepestLS_Nodes_NearestNeighborAny2Regret_w1_1_start59,TSPA,72095,24025,48070,4,100,200
SteepestLS_Nodes_NearestNeighborAny2Regret_w1_1_start60,TSPA,70666,21771,48895,4,100,200
SteepestLS_Nodes_NearestNeighborAny2Regret_w1_1_start61,TSPA,70410,22621,47789,4,100,200
SteepestLS_Nodes_NearestNeighborAny2Regret_w1_1_start62,TSPA,73359,25727,47632,6,100,200
SteepestLS_Nodes_NearestNeighborAny2Regret_w1_1_start63,TSPA,72854,24477,48377,4,100,200
SteepestLS_Nodes_NearestNeighborAny2Regret_w1_1_start64,TSPA,70924,22719,48205,4,100,200
SteepestLS_Nodes_NearestNeighborAny2Regret_w1_1_start65,TSPA,72095,24025,48070,3,100,200
SteepestLS_Nodes_NearestNeighborAny2Regret_w1_1_start66,TSPA,73313,24555,48758,4,100,200
SteepestLS_Nodes_NearestNeighborAny2Regret_w1_1_start67,TSPA,70478,22371,48107,5,100,200
SteepestLS_Nodes_NearestNeighborAny2Regret_w1_1_start68,TSPA,72006,23883,48123,4,100,200
SteepestLS_Nodes_NearestNeighborAny2Regret_w1_1_start69,TSPA,71360,23158,48202,8,100,200
SteepestLS_Nodes_NearestNeighborAny2Regret_w1_1_start70,TSPA,70641,22384,48257,4,100,200
SteepestLS_Nodes_NearestNeighborAny2Regret_w1_1_start71,TSPA,72834,24362,48472,7,100,200
SteepestLS_Nodes_NearestNeighborAny2Regret_w1_1_start72,TSPA,74716,26043,48673,4,100,200
SteepestLS_Nodes_NearestNeighborAny2Regret_w1_1_start73,TSPA,70643,22652,47991,7,100,200
SteepestLS_Nodes_NearestNeighborAny2Regret_w1_1_start74,TSPA,72372,23150,49222,4,100,200
SteepestLS_Nodes_NearestNeighborAny2Regret_w1_1_start75,TSPA,70809,22232,48577,4,100,200
SteepestLS_Nodes_NearestNeighborAny2Regret_w1_1_start76,TSPA,73074,24620,48454,4,100,200
SteepestLS_Nodes_NearestNeighborAny2Regret_w1_1_start77,TSPA,74185,25878,48307,4,100,200
SteepestLS_Nodes_NearestNeighborAny2Regret_w1_1_start78,TSPA,70641,22384,48257,4,100,200
SteepestLS_Nodes_NearestNeighborAny2Regret_w1_1_start79,TSPA,72854,24477,48377,3,100,200
SteepestLS_Nodes_NearestNeighborAny2Regret_w1_1_start80,TSPA,72854,24477,48377,4,100,200
SteepestLS_Nodes_NearestNeighborAny2Regret_w1_1_start81,TSPA,74035,25672,48363,4,100,200
SteepestLS_Nodes_NearestNeighborAny2Regret_w1_1_start82,TSPA,69968,21839,48129,6,100,200
SteepestLS_Nodes_NearestNeighborAny2Regret_w1_1_start83,TSPA,71099,22894,48205,5,100,200
SteepestLS_Nodes_NearestNeighborAny2Regret_w1_1_start84,TSPA,70393,22391,48002,4,100,200
SteepestLS_Nodes_NearestNeighborAny2Regret_w1_1_start85,TSPA,73968,25737,48231,5,100,200
SteepestLS_Nodes_NearestNeighborAny2Regret_w1_1_start86,TSPA,70809,22232,48577,3,100,200
SteepestLS_Nodes_NearestNeighborAny2Regret_w1_1_start87,TSPA,72152,23484,48668,4,100,200
SteepestLS_Nodes_NearestNeighborAny2Regret_w1_1_start88,TSPA,75440,26142,49298,4,100,200
SteepestLS_Nodes_NearestNeighborAny2Regret_w1_1_start89,TSPA,72854,24477,48377,3,100,200
SteepestLS_Nodes_NearestNeighborAny2Regret_w1_1_start90,TSPA,72930,25077,47853,5,100,200
SteepestLS_Nodes_NearestNeighborAny2Regret_w1_1_start91,TSPA,73707,25548,48159,7,100,200
SteepestLS_Nodes_NearestNeighborAny2Regret_w1_1_start92,TSPA,75405,27135,48270,4,100,200
SteepestLS_Nodes_NearestNeighborAny2Regret_w1_1_start93,TSPA,72006,23883,48123,4,100,200
SteepestLS_Nodes_NearestNeighborAny2Regret_w1_1_start94,TSPA,71862,23825,48037,4,100,200
SteepestLS_Nodes_NearestNeighborAny2Regret_w1_1_start95,TSPA,72063,23678,48385,7,100,200
SteepestLS_Nodes_NearestNeighborAny2Regret_w1_1_start96,TSPA,71746,23251,48495,6,100,200
SteepestLS_Nodes_NearestNeighborAny2Regret_w1_1_start97,TSPA,70641,22384,48257,4,100,200
SteepestLS_Nodes_NearestNeighborAny2Regret_w1_1_start98,TSPA,70881,22380,48501,4,100,200
SteepestLS_Nodes_NearestNeighborAny2Regret_w1_1_start99,TSPA,70690,22113,48577,6,100,200
SteepestLS_Nodes_NearestNeighborAny2Regret_w1_1_start100,TSPA,70570,21993,48577,4,100,200
SteepestLS_Nodes_NearestNeighborAny2Regret_w1_1_start101,TSPA,70641,22384,48257,4,100,200
SteepestLS_Nodes_NearestNeighborAny2Regret_w1_1_start102,TSPA,73395,25763,47632,6,100,200
SteepestLS_Nodes_NearestNeighborAny2Regret_w1_1_start103,TSPA,71617,23587,48030,5,100,200
SteepestLS_Nodes_NearestNeighborAny2Regret_w1_1_start104,TSPA,72534,23814,48720,6,100,200
SteepestLS_Nodes_NearestNeighborAny2Regret_w1_1_start105,TSPA,74185,25878,48307,4,100,200
SteepestLS_Nodes_NearestNeighborAny2Regret_w1_1_start106,TSPA,73359,25727,47632,6,100,200
SteepestLS_Nodes_NearestNeighborAny2Regret_w1_1_start107,TSPA,72786,24212,48574,9,100,200
SteepestLS_Nodes_NearestNeighborAny2Regret_w1_1_start108,TSPA,71563,23431,48132,3,100,200
SteepestLS_Nodes_NearestNeighborAny2Regret_w1_1_start109,TSPA,74619,25904,48715,4,100,200
SteepestLS_Nodes_NearestNeighborAny2Regret_w1_1_start110,TSPA,69909,22134,47775,5,100,200
SteepestLS_Nodes_NearestNeighborAny2Regret_w1_1_start111,TSPA,71214,22508,48706,4,100,200
SteepestLS_Nodes_NearestNeighborAny2Regret_w1_1_start112,TSPA,70393,22391,48002,4,100,200
SteepestLS_Nodes_NearestNeighborAny2Regret_w1_1_start113,TSPA,73605,25228,48377,3,100,200
SteepestLS_Nodes_NearestNeighborAny2Regret_w1_1_start114,TSPA,70217,22721,47496,4,100,200
SteepestLS_Nodes_NearestNeighborAny2Regret_w1_1_start115,TSPA,71878,24169,47709,4,100,200
SteepestLS_Nodes_NearestNeighborAny2Regret_w1_1_start116,TSPA,72149,24079,48070,4,100,200
SteepestLS_Nodes_NearestNeighborAny2Regret_w1_1_start117,TSPA,70217,22721,47496,4,100,200
SteepestLS_Nodes_NearestNeighborAny2Regret_w1_1_start118,TSPA,74201,26233,47968,4,100,200
SteepestLS_Nodes_NearestNeighborAny2Regret_w1_1_start119,TSPA,72976,24998,47978,5,100,200
SteepestLS_Nodes_NearestNeighborAny2Regret_w1_1_start120,TSPA,70641,22384,48257,4,100,200
SteepestLS_Nodes_NearestNeighborAny2Regret_w1_1_start121,TSPA,70570,21993,48577,4,100,200
SteepestLS_Nodes_NearestNeighborAny2Regret_w1_1_start122,TSPA,73156,24558,48598,3,100,200
SteepestLS_Nodes_NearestNeighborAny2Regret_w1_1_start123,TSPA,70641,22384,48257,4,100,200
SteepestLS_Nodes_NearestNeighborAny2Regret_w1_1_start124,TSPA,71669,23854,47815,4,100,200
SteepestLS_Nodes_NearestNeighborAny2Regret_w1_1_start125,TSPA,71232,21733,49499,4,100,200
SteepestLS_Nodes_NearestNeighborAny2Regret_w1_1_start126,TSPA,70451,21915,48536,5,100,200
SteepestLS_Nodes_NearestNeighborAny2Regret_w1_1_start127,TSPA,70641,22384,48257,4,100,200
SteepestLS_Nodes_NearestNeighborAny2Regret_w1_1_start128,TSPA,71602,23193,48409,6,100,200
SteepestLS_Nodes_NearestNeighborAny2Regret_w1_1_start129,TSPA,71356,23156,48200,4,100,200
SteepestLS_Nodes_NearestNeighborAny2Regret_w1_1_start130,TSPA,72154,23522,48632,6,100,200
SteepestLS_Nodes_NearestNeighborAny2Regret_w1_1_start131,TSPA,71538,23215,48323,5,100,200
SteepestLS_Nodes_NearestNeighborAny2Regret_w1_1_start132,TSPA,70643,22652,47991,6,100,200
SteepestLS_Nodes_NearestNeighborAny2Regret_w1_1_start133,TSPA,71878,24169,47709,4,100,200
SteepestLS_Nodes_NearestNeighborAny2Regret_w1_1_start134,TSPA,70641,22384,48257,4,100,200
SteepestLS_Nodes_NearestNeighborAny2Regret_w1_1_start135,TSPA,70641,22384,48257,4,100,200
SteepestLS_Nodes_NearestNeighborAny2Regret_w1_1_start136,TSPA,73201,24624,48577,4,100,200
SteepestLS_Nodes_NearestNeighborAny2Regret_w1_1_start137,TSPA,72854,24477,48377,3,100,200
SteepestLS_Nodes_NearestNeighborAny2Regret_w1_1_start138,TSPA,73616,25430,48186,6,100,200
SteepestLS_Nodes_NearestNeighborAny2Regret_w1_1_start139,TSPA,71878,24169,47709,4,100,200
SteepestLS_Nodes_NearestNeighborAny2Regret_w1_1_start140,TSPA,72006,23883,48123,4,100,200
SteepestLS_Nodes_NearestNeighborAny2Regret_w1_1_start141,TSPA,72112,23447,48665,4,100,200
SteepestLS_Nodes_NearestNeighborAny2Regret_w1_1_start142,TSPA,70746,22118,48628,5,100,200
SteepestLS_Nodes_NearestNeighborAny2Regret_w1_1_start143,TSPA,70217,22721,47496,4,100,200
SteepestLS_Nodes_NearestNeighborAny2Regret_w1_1_start144,TSPA,70217,22721,47496,4,100,200
SteepestLS_Nodes_NearestNeighborAny2Regret_w1_1_start145,TSPA,70641,22384,48257,4,100,200
SteepestLS_Nodes_NearestNeighborAny2Regret_w1_1_start146,TSPA,71617,23587,48030,4,100,200
SteepestLS_Nodes_NearestNeighborAny2Regret_w1_1_start147,TSPA,72411,24239,48172,7,100,200
SteepestLS_Nodes_NearestNeighborAny2Regret_w1_1_start148,TSPA,72149,24079,48070,4,100,200
SteepestLS_Nodes_NearestNeighborAny2Regret_w1_1_start149,TSPA,70764,22233,48531,4,100,200
SteepestLS_Nodes_NearestNeighborAny2Regret_w1_1_start150,TSPA,73031,24525,48506,5,100,200
SteepestLS_Nodes_NearestNeighborAny2Regret_w1_1_start151,TSPA,70979,23058,47921,6,100,200
SteepestLS_Nodes_NearestNeighborAny2Regret_w1_1_start152,TSPA,71668,23498,48170,4,100,200
SteepestLS_Nodes_NearestNeighborAny2Regret_w1_1_start153,TSPA,70499,22692,47807,4,100,200
SteepestLS_Nodes_NearestNeighborAny2Regret_w1_1_start154,TSPA,70641,22384,48257,5,100,200
SteepestLS_Nodes_NearestNeighborAny2Regret_w1_1_start155,TSPA,73968,25446,48522,5,100,200
SteepestLS_Nodes_NearestNeighborAny2Regret_w1_1_start156,TSPA,71029,22267,48762,7,100,200
SteepestLS_Nodes_NearestNeighborAny2Regret_w1_1_start157,TSPA,74313,25622,48691,4,100,200
SteepestLS_Nodes_NearestNeighborAny2Regret_w1_1_start158,TSPA,70616,21917,48699,4,100,200
SteepestLS_Nodes_NearestNeighborAny2Regret_w1_1_start159,TSPA,72149,24079,48070,4,100,200
SteepestLS_Nodes_NearestNeighborAny2Regret_w1_1_start160,TSPA,73249,25283,47966,4,100,200
SteepestLS_Nodes_NearestNeighborAny2Regret_w1_1_start161,TSPA,71307,23386,47921,6,100,200
SteepestLS_Nodes_NearestNeighborAny2Regret_w1_1_start162,TSPA,70979,23058,47921,5,100,200
SteepestLS_Nodes_NearestNeighborAny2Regret_w1_1_start163,TSPA,71878,24169,47709,4,100,200
SteepestLS_Nodes_NearestNeighborAny2Regret_w1_1_start164,TSPA,73291,25108,48183,5,100,200
SteepestLS_Nodes_NearestNeighborAny2Regret_w1_1_start165,TSPA,72930,25077,47853,4,100,200
SteepestLS_Nodes_NearestNeighborAny2Regret_w1_1_start166,TSPA,73891,26105,47786,6,100,200
SteepestLS_Nodes_NearestNeighborAny2Regret_w1_1_start167,TSPA,72176,24014,48162,4,100,200
SteepestLS_Nodes_NearestNeighborAny2Regret_w1_1_start168,TSPA,71190,23442,47748,4,100,200
SteepestLS_Nodes_NearestNeighborAny2Regret_w1_1_start169,TSPA,73510,25393,48117,7,100,200
SteepestLS_Nodes_NearestNeighborAny2Regret_w1_1_start170,TSPA,70492,22622,47870,4,100,200
SteepestLS_Nodes_NearestNeighborAny2Regret_w1_1_start171,TSPA,74657,26280,48377,4,100,200
SteepestLS_Nodes_NearestNeighborAny2Regret_w1_1_start172,TSPA,72901,24703,48198,4,100,200
SteepestLS_Nodes_NearestNeighborAny2Regret_w1_1_start173,TSPA,70940,22302,48638,4,100,200
SteepestLS_Nodes_NearestNeighborAny2Regret_w1_1_start174,TSPA,73600,25573,48027,7,100,200
SteepestLS_Nodes_NearestNeighborAny2Regret_w1_1_start175,TSPA,74657,26280,48377,4,100,200
SteepestLS_Nodes_NearestNeighborAny2Regret_w1_1_start176,TSPA,72854,24477,48377,3,100,200
SteepestLS_Nodes_NearestNeighborAny2Regret_w1_1_start177,TSPA,71848,23932,47916,5,100,200
SteepestLS_Nodes_NearestNeighborAny2Regret_w1_1_start178,TSPA,73359,25727,47632,6,100,200
SteepestLS_Nodes_NearestNeighborAny2Regret_w1_1_start179,TSPA,74655,26278,48377,4,100,200
SteepestLS_Nodes_NearestNeighborAny2Regret_w1_1_start180,TSPA,70641,22384,48257,4,100,200
SteepestLS_Nodes_NearestNeighborAny2Regret_w1_1_start181,TSPA,73676,26044,47632,7,100,200
SteepestLS_Nodes_NearestNeighborAny2Regret_w1_1_start182,TSPA,73201,24624,48577,4,100,200
SteepestLS_Nodes_NearestNeighborAny2Regret_w1_1_start183,TSPA,70217,22721,47496,4,100,200
SteepestLS_Nodes_NearestNeighborAny2Regret_w1_1_start184,TSPA,70595,22590,48005,4,100,200
SteepestLS_Nodes_NearestNeighborAny2Regret_w1_1_start185,TSPA,72930,25077,47853,4,100,200
SteepestLS_Nodes_NearestNeighborAny2Regret_w1_1_start186,TSPA,70235,22443,47792,4,100,200
SteepestLS_Nodes_NearestNeighborAny2Regret_w1_1_start187,TSPA,74451,25963,48488,5,100,200
SteepestLS_Nodes_NearestNeighborAny2Regret_w1_1_start188,TSPA,71185,21756,49429,5,100,200
SteepestLS_Nodes_NearestNeighborAny2Regret_w1_1_start189,TSPA,70602,22157,48445,4,100,200
SteepestLS_Nodes_NearestNeighborAny2Regret_w1_1_start190,TSPA,70102,22308,47794,3,100,200
SteepestLS_Nodes_NearestNeighborAny2Regret_w1_1_start191,TSPA,72044,23677,48367,5,100,200
SteepestLS_Nodes_NearestNeighborAny2Regret_w1_1_start192,TSPA,71901,23763,48138,5,100,200
SteepestLS_Nodes_NearestNeighborAny2Regret_w1_1_start193,TSPA,71878,24169,47709,4,100,200
SteepestLS_Nodes_NearestNeighborAny2Regret_w1_1_start194,TSPA,71099,22276,48823,3,100,200
SteepestLS_Nodes_NearestNeighborAny2Regret_w1_1_start195,TSPA,71412,22784,48628,4,100,200
SteepestLS_Nodes_NearestNeighborAny2Regret_w1_1_start196,TSPA,71190,23442,47748,4,100,200
SteepestLS_Nodes_NearestNeighborAny2Regret_w1_1_start197,TSPA,73377,25539,47838,5,100,200
SteepestLS_Nodes_NearestNeighborAny2Regret_w1_1_start198,TSPA,72040,23925,48115,4,100,200
SteepestLS_Nodes_NearestNeighborAny2Regret_w1_1_start199,TSPA,70914,22124,48790,3,100,200
SteepestLS_Edges_Random_start0,TSPA,72827,22900,49927,69,100,200
SteepestLS_Edges_Random_start1,TSPA,75299,21831,53468,58,100,200
SteepestLS_Edges_Random_start2,TSPA,73976,23920,50056,56,100,200
SteepestLS_Edges_Random_start3,TSPA,73420,25215,48205,65,100,200
SteepestLS_Edges_Random_start4,TSPA,73586,23400,50186,60,100,200
SteepestLS_Edges_Random_start5,TSPA,74285,22708,51577,57,100,200
SteepestLS_Edges_Random_start6,TSPA,75027,23288,51739,58,100,200
SteepestLS_Edges_Random_start7,TSPA,73412,23237,50175,63,100,200
SteepestLS_Edges_Random_start8,TSPA,74570,23253,51317,58,100,200
SteepestLS_Edges_Random_start9,TSPA,73044,24126,48918,62,100,200
SteepestLS_Edges_Random_start10,TSPA,75112,24761,50351,58,100,200
SteepestLS_Edges_Random_start11,TSPA,74321,24987,49334,62,100,200
SteepestLS_Edges_Random_start12,TSPA,73682,23659,50023,62,100,200
SteepestLS_Edges_Random_start13,TSPA,74198,24499,49699,59,100,200
SteepestLS_Edges_Random_start14,TSPA,74630,23805,50825,57,100,200
SteepestLS_Edges_Random_start15,TSPA,73327,22073,51254,68,100,200
SteepestLS_Edges_Random_start16,TSPA,71868,23183,48685,80,100,200
SteepestLS_Edges_Random_start17,TSPA,72139,21965,50174,78,100,200
SteepestLS_Edges_Random_start18,TSPA,72088,23081,49007,66,100,200
SteepestLS_Edges_Random_start19,TSPA,72909,22957,49952,56,100,200
SteepestLS_Edges_Random_start20,TSPA,72342,22380,49962,60,100,200
SteepestLS_Edges_Random_start21,TSPA,73606,23463,50143,57,100,200
SteepestLS_Edges_Random_start22,TSPA,76515,23653,52862,64,100,200
SteepestLS_Edges_Random_start23,TSPA,73665,23233,50432,56,100,200
SteepestLS_Edges_Random_start24,TSPA,74375,23722,50653,57,100,200
SteepestLS_Edges_Random_start25,TSPA,73609,23898,49711,55,100,200
SteepestLS_Edges_Random_start26,TSPA,73765,23331,50434,58,100,200
SteepestLS_Edges_Random_start27,TSPA,74696,23993,50703,62,100,200
SteepestLS_Edges_Random_start28,TSPA,74723,24018,50705,59,100,200
SteepestLS_Edges_Random_start29,TSPA,72449,23484,48965,62,100,200
SteepestLS_Edges_Random_start30,TSPA,78846,24697,54149,51,100,200
SteepestLS_Edges_Random_start31,TSPA,73409,23449,49960,58,100,200
SteepestLS_Edges_Random_start32,TSPA,72749,22667,50082,55,100,200
SteepestLS_Edges_Random_start33,TSPA,74389,25270,49119,59,100,200
SteepestLS_Edges_Random_start34,TSPA,72850,22999,49851,63,100,200
SteepestLS_Edges_Random_start35,TSPA,75553,23239,52314,59,100,200
SteepestLS_Edges_Random_start36,TSPA,73138,22816,50322,61,100,200
SteepestLS_Edges_Random_start37,TSPA,73567,24114,49453,59,100,200
SteepestLS_Edges_Random_start38,TSPA,72683,22902,49781,60,100,200
SteepestLS_Edges_Random_start39,TSPA,73137,24448,48689,60,100,200
SteepestLS_Edges_Random_start40,TSPA,75286,22367,52919,63,100,200
SteepestLS_Edges_Random_start41,TSPA,72844,21691,51153,57,100,200
SteepestLS_Edges_Random_start42,TSPA,72835,24300,48535,56,100,200
SteepestLS_Edges_Random_start43,TSPA,74180,22452,51728,58,100,200
SteepestLS_Edges_Random_start44,TSPA,73489,23256,50233,61,100,200
SteepestLS_Edges_Random_start45,TSPA,75604,22986,52618,57,100,200
SteepestLS_Edges_Random_start46,TSPA,74494,22845,51649,62,100,200
SteepestLS_Edges_Random_start47,TSPA,74725,23921,50804,55,100,200
SteepestLS_Edges_Random_start48,TSPA,73314,24320,48994,61,100,200
SteepestLS_Edges_Random_start49,TSPA,77000,23227,53773,58,100,200
SteepestLS_Edges_Random_start50,TSPA,74018,24005,50013,60,100,200
SteepestLS_Edges_Random_start51,TSPA,75751,23995,51756,63,100,200
SteepestLS_Edges_Random_start52,TSPA,73657,23541,50116,57,100,200
SteepestLS_Edges_Random_start53,TSPA,75340,23926,51414,59,100,200
SteepestLS_Edges_Random_start54,TSPA,74078,23503,50575,56,100,200
SteepestLS_Edges_Random_start55,TSPA,73778,24528,49250,61,100,200
SteepestLS_Edges_Random_start56,TSPA,77253,25092,52161,53,100,200
SteepestLS_Edges_Random_start57,TSPA,75481,24159,51322,56,100,200
SteepestLS_Edges_Random_start58,TSPA,73480,23796,49684,59,100,200
SteepestLS_Edges_Random_start59,TSPA,74602,23008,51594,59,100,200
SteepestLS_Edges_Random_start60,TSPA,74156,23307,50849,54,100,200
SteepestLS_Edges_Random_start61,TSPA,75385,24014,51371,60,100,200
SteepestLS_Edges_Random_start62,TSPA,74158,24129,50029,59,100,200
SteepestLS_Edges_Random_start63,TSPA,74676,23851,50825,60,100,200
SteepestLS_Edges_Random_start64,TSPA,74892,23490,51402,56,100,200
SteepestLS_Edges_Random_start65,TSPA,72223,22336,49887,59,100,200
SteepestLS_Edges_Random_start66,TSPA,74002,23220,50782,56,100,200
SteepestLS_Edges_Random_start67,TSPA,73223,22681,50542,63,100,200
SteepestLS_Edges_Random_start68,TSPA,74564,24271,50293,60,100,200
SteepestLS_Edges_Random_start69,TSPA,74038,22136,51902,57,100,200
SteepestLS_Edges_Random_start70,TSPA,73635,23821,49814,61,100,200
SteepestLS_Edges_Random_start71,TSPA,73129,24756,48373,55,100,200
SteepestLS_Edges_Random_start72,TSPA,73288,23681,49607,60,100,200
SteepestLS_Edges_Random_start73,TSPA,73057,24068,48989,55,100,200
SteepestLS_Edges_Random_start74,TSPA,74025,24517,49508,63,100,200
SteepestLS_Edges_Random_start75,TSPA,74354,24175,50179,59,100,200
SteepestLS_Edges_Random_start76,TSPA,72158,22347,49811,56,100,200
SteepestLS_Edges_Random_start77,TSPA,73727,24411,49316,54,100,200
SteepestLS_Edges_Random_start78,TSPA,74099,23302,50797,62,100,200
SteepestLS_Edges_Random_start79,TSPA,74040,22797,51243,56,100,200
SteepestLS_Edges_Random_start80,TSPA,74300,23577,50723,54,100,200
SteepestLS_Edges_Random_start81,TSPA,74315,24065,50250,54,100,200
SteepestLS_Edges_Random_start82,TSPA,75169,23273,51896,59,100,200
SteepestLS_Edges_Random_start83,TSPA,74762,23697,51065,57,100,200
SteepestLS_Edges_Random_start84,TSPA,73978,23938,50040,61,100,200
SteepestLS_Edges_Random_start85,TSPA,74179,23770,50409,61,100,200
SteepestLS_Edges_Random_start86,TSPA,74430,24798,49632,60,100,200
SteepestLS_Edges_Random_start87,TSPA,74413,24198,50215,62,100,200
SteepestLS_Edges_Random_start88,TSPA,72587,23265,49322,62,100,200
SteepestLS_Edges_Random_start89,TSPA,75556,24748,50808,64,100,200
SteepestLS_Edges_Random_start90,TSPA,73826,23216,50610,64,100,200
SteepestLS_Edges_Random_start91,TSPA,73088,23358,49730,62,100,200
SteepestLS_Edges_Random_start92,TSPA,74733,23653,51080,63,100,200
SteepestLS_Edges_Random_start93,TSPA,75909,22466,53443,57,100,200
SteepestLS_Edges_Random_start94,TSPA,71873,21894,49979,60,100,200
SteepestLS_Edges_Random_start95,TSPA,73569,23129,50440,52,100,200
SteepestLS_Edges_Random_start96,TSPA,73592,24283,49309,61,100,200
SteepestLS_Edges_Random_start97,TSPA,72566,24079,48487,59,100,200
SteepestLS_Edges_Random_start98,TSPA,72927,23156,49771,57,100,200
SteepestLS_Edges_Random_start99,TSPA,73815,25006,48809,59,100,200
SteepestLS_Edges_Random_start100,TSPA,73250,22332,50918,64,100,200
SteepestLS_Edges_Random_start101,TSPA,71961,23476,48485,61,100,200
SteepestLS_Edges_Random_start102,TSPA,73593,22496,51097,56,100,200
SteepestLS_Edges_Random_start103,TSPA,75277,23493,51784,56,100,200
SteepestLS_Edges_Random_start104,TSPA,74496,23191,51305,58,100,200
SteepestLS_Edges_Random_start105,TSPA,74177,22312,51865,59,100,200
SteepestLS_Edges_Random_start106,TSPA,75505,24166,51339,56,100,200
SteepestLS_Edges_Random_start107,TSPA,73063,23642,49421,55,100,200
SteepestLS_Edges_Random_start108,TSPA,73938,22296,51642,62,100,200
SteepestLS_Edges_Random_start109,TSPA,72037,22535,49502,64,100,200
SteepestLS_Edges_Random_start110,TSPA,75225,23044,52181,58,100,200
SteepestLS_Edges_Random_start111,TSPA,73052,24175,48877,57,100,200
SteepestLS_Edges_Random_start112,TSPA,72975,22337,50638,58,100,200
SteepestLS_Edges_Random_start113,TSPA,73833,23635,50198,59,100,200
SteepestLS_Edges_Random_start114,TSPA,73017,22699,50318,57,100,200
SteepestLS_Edges_Random_start115,TSPA,72274,23028,49246,62,100,200
SteepestLS_Edges_Random_start116,TSPA,74739,23676,51063,60,100,200
SteepestLS_Edges_Random_start117,TSPA,72179,22319,49860,60,100,200
SteepestLS_Edges_Random_start118,TSPA,72365,22028,50337,58,100,200
SteepestLS_Edges_Random_start119,TSPA,74132,23292,50840,60,100,200
SteepestLS_Edges_Random_start120,TSPA,74139,23095,51044,60,100,200
SteepestLS_Edges_Random_start121,TSPA,72715,23245,49470,62,100,200
SteepestLS_Edges_Random_start122,TSPA,75536,23487,52049,56,100,200
SteepestLS_Edges_Random_start123,TSPA,75341,22517,52824,55,100,200
SteepestLS_Edges_Random_start124,TSPA,73472,23891,49581,58,100,200
SteepestLS_Edges_Random_start125,TSPA,72874,23465,49409,56,100,200
SteepestLS_Edges_Random_start126,TSPA,74496,25028,49468,56,100,200
SteepestLS_Edges_Random_start127,TSPA,72643,23925,48718,56,100,200
SteepestLS_Edges_Random_start128,TSPA,74966,22989,51977,62,100,200
SteepestLS_Edges_Random_start129,TSPA,74289,23582,50707,59,100,200
SteepestLS_Edges_Random_start130,TSPA,73306,23466,49840,58,100,200
SteepestLS_Edges_Random_start131,TSPA,73384,23970,49414,62,100,200
SteepestLS_Edges_Random_start132,TSPA,76100,23402,52698,60,100,200
SteepestLS_Edges_Random_start133,TSPA,72879,23613,49266,59,100,200
SteepestLS_Edges_Random_start134,TSPA,76544,24208,52336,56,100,200
SteepestLS_Edges_Random_start135,TSPA,74027,24081,49946,56,100,200
SteepestLS_Edges_Random_start136,TSPA,71576,22393,49183,63,100,200
SteepestLS_Edges_Random_start137,TSPA,74583,23429,51154,63,100,200
SteepestLS_Edges_Random_start138,TSPA,77055,23051,54004,56,100,200
SteepestLS_Edges_Random_start139,TSPA,73407,22877,50530,55,100,200
SteepestLS_Edges_Random_start140,TSPA,71737,22804,48933,57,100,200
SteepestLS_Edges_Random_start141,TSPA,72745,23501,49244,65,100,200
SteepestLS_Edges_Random_start142,TSPA,72042,23309,48733,58,100,200
SteepestLS_Edges_Random_start143,TSPA,73399,22688,50711,54,100,200
SteepestLS_Edges_Random_start144,TSPA,73919,23896,50023,59,100,200
SteepestLS_Edges_Random_start145,TSPA,72629,23402,49227,64,100,200
SteepestLS_Edges_Random_start146,TSPA,73327,23688,49639,58,100,200
SteepestLS_Edges_Random_start147,TSPA,75272,24429,50843,58,100,200
SteepestLS_Edges_Random_start148,TSPA,72828,23750,49078,62,100,200
SteepestLS_Edges_Random_start149,TSPA,72735,23330,49405,64,100,200
SteepestLS_Edges_Random_start150,TSPA,73766,23638,50128,56,100,200
SteepestLS_Edges_Random_start151,TSPA,74446,23802,50644,56,100,200
SteepestLS_Edges_Random_start152,TSPA,73125,23195,49930,54,100,200
SteepestLS_Edges_Random_start153,TSPA,74259,23747,50512,57,100,200
SteepestLS_Edges_Random_start154,TSPA,73741,23927,49814,63,100,200
SteepestLS_Edges_Random_start155,TSPA,74251,23470,50781,60,100,200
SteepestLS_Edges_Random_start156,TSPA,73495,23827,49668,64,100,200
SteepestLS_Edges_Random_start157,TSPA,76464,23759,52705,59,100,200
SteepestLS_Edges_Random_start158,TSPA,74337,23371,50966,52,100,200
SteepestLS_Edges_Random_start159,TSPA,75591,23399,52192,54,100,200
SteepestLS_Edges_Random_start160,TSPA,73679,22533,51146,62,100,200
SteepestLS_Edges_Random_start161,TSPA,74040,23584,50456,60,100,200
SteepestLS_Edges_Random_start162,TSPA,72232,24076,48156,55,100,200
SteepestLS_Edges_Random_start163,TSPA,74125,24082,50043,58,100,200
SteepestLS_Edges_Random_start164,TSPA,72837,23527,49310,59,100,200
SteepestLS_Edges_Random_start165,TSPA,73561,23843,49718,57,100,200
SteepestLS_Edges_Random_start166,TSPA,73961,23034,50927,56,100,200
SteepestLS_Edges_Random_start167,TSPA,73789,23934,49855,58,100,200
SteepestLS_Edges_Random_start168,TSPA,75984,23274,52710,59,100,200
SteepestLS_Edges_Random_start169,TSPA,72965,22951,50014,60,100,200
SteepestLS_Edges_Random_start170,TSPA,74362,23129,51233,59,100,200
SteepestLS_Edges_Random_start171,TSPA,73619,23128,50491,60,100,200
SteepestLS_Edges_Random_start172,TSPA,72510,22882,49628,68,100,200
SteepestLS_Edges_Random_start173,TSPA,72800,23265,49535,54,100,200
SteepestLS_Edges_Random_start174,TSPA,74784,24336,50448,64,100,200
SteepestLS_Edges_Random_start175,TSPA,73721,23155,50566,59,100,200
SteepestLS_Edges_Random_start176,TSPA,72443,21682,50761,58,100,200
SteepestLS_Edges_Random_start177,TSPA,72245,22796,49449,60,100,200
SteepestLS_Edges_Random_start178,TSPA,72955,23148,49807,60,100,200
SteepestLS_Edges_Random_start179,TSPA,71773,23048,48725,62,100,200
SteepestLS_Edges_Random_start180,TSPA,72314,23714,48600,58,100,200
SteepestLS_Edges_Random_start181,TSPA,73317,24237,49080,60,100,200
SteepestLS_Edges_Random_start182,TSPA,73849,23964,49885,62,100,200
SteepestLS_Edges_Random_start183,TSPA,72820,22997,49823,61,100,200
SteepestLS_Edges_Random_start184,TSPA,72063,23133,48930,58,100,200
SteepestLS_Edges_Random_start185,TSPA,73357,24157,49200,61,100,200
SteepestLS_Edges_Random_start186,TSPA,75002,23739,51263,63,100,200
SteepestLS_Edges_Random_start187,TSPA,74404,23514,50890,55,100,200
SteepestLS_Edges_Random_start188,TSPA,74712,24495,50217,56,100,200
SteepestLS_Edges_Random_start189,TSPA,75938,23861,52077,60,100,200
SteepestLS_Edges_Random_start190,TSPA,72674,24050,48624,63,100,200
SteepestLS_Edges_Random_start191,TSPA,73560,22787,50773,58,100,200
SteepestLS_Edges_Random_start192,TSPA,71992,23261,48731,60,100,200
SteepestLS_Edges_Random_start193,TSPA,72997,24904,48093,59,100,200
SteepestLS_Edges_Random_start194,TSPA,74856,22972,51884,61,100,200
SteepestLS_Edges_Random_start195,TSPA,72601,23490,49111,56,100,200
SteepestLS_Edges_Random_start196,TSPA,73821,23055,50766,61,100,200
SteepestLS_Edges_Random_start197,TSPA,73223,23713,49510,58,100,200
SteepestLS_Edges_Random_start198,TSPA,72737,23136,49601,61,100,200
SteepestLS_Edges_Random_start199,TSPA,73997,24587,49410,57,100,200
SteepestLS_Edges_NearestNeighborAny2Regret_w1_1_start0,TSPA,69540,22044,47496,5,100,200
SteepestLS_Edges_NearestNeighborAny2Regret_w1_1_start1,TSPA,70641,22384,48257,4,100,200
SteepestLS_Edges_NearestNeighborAny2Regret_w1_1_start2,TSPA,70641,22384,48257,4,100,200
SteepestLS_Edges_NearestNeighborAny2Regret_w1_1_start3,TSPA,70281,22095,48186,9,100,200
SteepestLS_Edges_NearestNeighborAny2Regret_w1_1_start4,TSPA,70152,22156,47996,3,100,200
SteepestLS_Edges_NearestNeighborAny2Regret_w1_1_start5,TSPA,70641,22384,48257,4,100,200
SteepestLS_Edges_NearestNeighborAny2Regret_w1_1_start6,TSPA,70940,22302,48638,4,100,200
SteepestLS_Edges_NearestNeighborAny2Regret_w1_1_start7,TSPA,71118,23410,47708,7,100,200
SteepestLS_Edges_NearestNeighborAny2Regret_w1_1_start8,TSPA,71522,23506,48016,7,100,200
SteepestLS_Edges_NearestNeighborAny2Regret_w1_1_start9,TSPA,70200,22232,47968,11,100,200
SteepestLS_Edges_NearestNeighborAny2Regret_w1_1_start10,TSPA,71080,22806,48274,8,100,200
SteepestLS_Edges_NearestNeighborAny2Regret_w1_1_start11,TSPA,70690,22535,48155,4,100,200
SteepestLS_Edges_NearestNeighborAny2Regret_w1_1_start12,TSPA,71144,22537,48607,6,100,200
SteepestLS_Edges_NearestNeighborAny2Regret_w1_1_start13,TSPA,70567,22336,48231,9,100,200
SteepestLS_Edges_NearestNeighborAny2Regret_w1_1_start14,TSPA,70309,22123,48186,10,100,200
SteepestLS_Edges_NearestNeighborAny2Regret_w1_1_start15,TSPA,69540,22044,47496,5,100,200
SteepestLS_Edges_NearestNeighborAny2Regret_w1_1_start16,TSPA,70858,22481,48377,8,100,200
SteepestLS_Edges_NearestNeighborAny2Regret_w1_1_start17,TSPA,70892,22203,48689,4,100,200
SteepestLS_Edges_NearestNeighborAny2Regret_w1_1_start18,TSPA,70641,22384,48257,5,100,200
SteepestLS_Edges_NearestNeighborAny2Regret_w1_1_start19,TSPA,70503,22058,48445,4,100,200
SteepestLS_Edges_NearestNeighborAny2Regret_w1_1_start20,TSPA,71802,23237,48565,5,100,200
SteepestLS_Edges_NearestNeighborAny2Regret_w1_1_start21,TSPA,71136,22698,48438,10,100,200
SteepestLS_Edges_NearestNeighborAny2Regret_w1_1_start22,TSPA,70296,22226,48070,7,100,200
SteepestLS_Edges_NearestNeighborAny2Regret_w1_1_start23,TSPA,70858,22481,48377,6,100,200
SteepestLS_Edges_NearestNeighborAny2Regret_w1_1_start24,TSPA,70300,22156,48144,4,100,200
SteepestLS_Edges_NearestNeighborAny2Regret_w1_1_start25,TSPA,70641,22384,48257,4,100,200
SteepestLS_Edges_NearestNeighborAny2Regret_w1_1_start26,TSPA,70570,21993,48577,4,100,200
SteepestLS_Edges_NearestNeighborAny2Regret_w1_1_start27,TSPA,72546,23724,48822,7,100,200
SteepestLS_Edges_NearestNeighborAny2Regret_w1_1_start28,TSPA,69885,21856,48029,5,100,200
SteepestLS_Edges_NearestNeighborAny2Regret_w1_1_start29,TSPA,71301,22906,48395,8,100,200
SteepestLS_Edges_NearestNeighborAny2Regret_w1_1_start30,TSPA,71162,23182,47980,8,100,200
SteepestLS_Edges_NearestNeighborAny2Regret_w1_1_start31,TSPA,70393,22123,48270,10,100,200
SteepestLS_Edges_NearestNeighborAny2Regret_w1_1_start32,TSPA,70309,22123,48186,10,100,200
SteepestLS_Edges_NearestNeighborAny2Regret_w1_1_start33,TSPA,70670,22487,48183,10,100,200
SteepestLS_Edges_NearestNeighborAny2Regret_w1_1_start34,TSPA,70961,22995,47966,8,100,200
SteepestLS_Edges_NearestNeighborAny2Regret_w1_1_start35,TSPA,69801,21778,48023,4,100,200
SteepestLS_Edges_NearestNeighborAny2Regret_w1_1_start36,TSPA,71467,22621,48846,5,100,200
SteepestLS_Edges_NearestNeighborAny2Regret_w1_1_start37,TSPA,70670,22487,48183,11,100,200
SteepestLS_Edges_NearestNeighborAny2Regret_w1_1_start38,TSPA,70567,22336,48231,9,100,200
SteepestLS_Edges_NearestNeighborAny2Regret_w1_1_start39,TSPA,70502,22389,48113,6,100,200
SteepestLS_Edges_NearestNeighborAny2Regret_w1_1_start40,TSPA,70394,22541,47853,10,100,200
SteepestLS_Edges_NearestNeighborAny2Regret_w1_1_start41,TSPA,70839,23130,47709,5,100,200
SteepestLS_Edges_NearestNeighborAny2Regret_w1_1_start42,TSPA,70641,22384,48257,4,100,200
SteepestLS_Edges_NearestNeighborAny2Regret_w1_1_start43,TSPA,70891,22796,48095,7,100,200
SteepestLS_Edges_NearestNeighborAny2Regret_w1_1_start44,TSPA,70641,22384,48257,5,100,200
SteepestLS_Edges_NearestNeighborAny2Regret_w1_1_start45,TSPA,71273,22883,48390,7,100,200
SteepestLS_Edges_NearestNeighborAny2Regret_w1_1_start46,TSPA,69540,22044,47496,5,100,200
SteepestLS_Edges_NearestNeighborAny2Regret_w1_1_start47,TSPA,71053,22746,48307,6,100,200
SteepestLS_Edges_NearestNeighborAny2Regret_w1_1_start48,TSPA,71870,22484,49386,7,100,200
SteepestLS_Edges_NearestNeighborAny2Regret_w1_1_start49,TSPA,69540,22044,47496,5,100,200
SteepestLS_Edges_NearestNeighborAny2Regret_w1_1_start50,TSPA,70586,21897,48689,5,100,200
SteepestLS_Edges_NearestNeighborAny2Regret_w1_1_start51,TSPA,71222,23626,47596,5,100,200
SteepestLS_Edges_NearestNeighborAny2Regret_w1_1_start52,TSPA,70859,22343,48516,8,100,200
SteepestLS_Edges_NearestNeighborAny2Regret_w1_1_start53,TSPA,70641,22384,48257,5,100,200
SteepestLS_Edges_NearestNeighborAny2Regret_w1_1_start54,TSPA,70152,22156,47996,3,100,200
SteepestLS_Edges_NearestNeighborAny2Regret_w1_1_start55,TSPA,70859,22343,48516,8,100,200
SteepestLS_Edges_NearestNeighborAny2Regret_w1_1_start56,TSPA,70858,22481,48377,6,100,200
SteepestLS_Edges_NearestNeighborAny2Regret_w1_1_start57,TSPA,71872,23602,48270,7,100,200
SteepestLS_Edges_NearestNeighborAny2Regret_w1_1_start58,TSPA,71021,22211,48810,6,100,200
SteepestLS_Edges_NearestNeighborAny2Regret_w1_1_start59,TSPA,70253,22183,48070,7,100,200
SteepestLS_Edges_NearestNeighborAny2Regret_w1_1_start60,TSPA,70550,21655,48895,6,100,200
SteepestLS_Edges_NearestNeighborAny2Regret_w1_1_start61,TSPA,69733,21944,47789,5,100,200
SteepestLS_Edges_NearestNeighborAny2Regret_w1_1_start62,TSPA,70052,22420,47632,10,100,200
SteepestLS_Edges_NearestNeighborAny2Regret_w1_1_start63,TSPA,70858,22481,48377,6,100,200
SteepestLS_Edges_NearestNeighborAny2Regret_w1_1_start64,TSPA,70247,22042,48205,5,100,200
SteepestLS_Edges_NearestNeighborAny2Regret_w1_1_start65,TSPA,70253,22183,48070,7,100,200
SteepestLS_Edges_NearestNeighborAny2Regret_w1_1_start66,TSPA,71101,22343,48758,8,100,200
SteepestLS_Edges_NearestNeighborAny2Regret_w1_1_start67,TSPA,70478,22371,48107,4,100,200
SteepestLS_Edges_NearestNeighborAny2Regret_w1_1_start68,TSPA,70936,22813,48123,6,100,200
SteepestLS_Edges_NearestNeighborAny2Regret_w1_1_start69,TSPA,70797,22595,48202,8,100,200
SteepestLS_Edges_NearestNeighborAny2Regret_w1_1_start70,TSPA,70641,22384,48257,5,100,200
SteepestLS_Edges_NearestNeighborAny2Regret_w1_1_start71,TSPA,72546,23724,48822,7,100,200
SteepestLS_Edges_NearestNeighborAny2Regret_w1_1_start72,TSPA,70931,22258,48673,7,100,200
SteepestLS_Edges_NearestNeighborAny2Regret_w1_1_start73,TSPA,69966,21975,47991,7,100,200
SteepestLS_Edges_NearestNeighborAny2Regret_w1_1_start74,TSPA,71333,22111,49222,6,100,200
SteepestLS_Edges_NearestNeighborAny2Regret_w1_1_start75,TSPA,70809,22232,48577,3,100,200
SteepestLS_Edges_NearestNeighborAny2Regret_w1_1_start76,TSPA,71078,22624,48454,7,100,200
SteepestLS_Edges_NearestNeighborAny2Regret_w1_1_start77,TSPA,71053,22746,48307,8,100,200
SteepestLS_Edges_NearestNeighborAny2Regret_w1_1_start78,TSPA,70641,22384,48257,4,100,200
SteepestLS_Edges_NearestNeighborAny2Regret_w1_1_start79,TSPA,70858,22481,48377,6,100,200
SteepestLS_Edges_NearestNeighborAny2Regret_w1_1_start80,TSPA,70858,22481,48377,7,100,200
SteepestLS_Edges_NearestNeighborAny2Regret_w1_1_start81,TSPA,70758,22395,48363,9,100,200
SteepestLS_Edges_NearestNeighborAny2Regret_w1_1_start82,TSPA,69968,21839,48129,7,100,200
SteepestLS_Edges_NearestNeighborAny2Regret_w1_1_start83,TSPA,70422,22217,48205,6,100,200
SteepestLS_Edges_NearestNeighborAny2Regret_w1_1_start84,TSPA,70393,22391,48002,4,100,200
SteepestLS_Edges_NearestNeighborAny2Regret_w1_1_start85,TSPA,70567,22336,48231,10,100,200
SteepestLS_Edges_NearestNeighborAny2Regret_w1_1_start86,TSPA,70809,22232,48577,4,100,200
SteepestLS_Edges_NearestNeighborAny2Regret_w1_1_start87,TSPA,71562,22894,48668,5,100,200
SteepestLS_Edges_NearestNeighborAny2Regret_w1_1_start88,TSPA,71641,22343,49298,8,100,200
SteepestLS_Edges_NearestNeighborAny2Regret_w1_1_start89,TSPA,70858,22481,48377,7,100,200
SteepestLS_Edges_NearestNeighborAny2Regret_w1_1_start90,TSPA,70394,22541,47853,10,100,200
SteepestLS_Edges_NearestNeighborAny2Regret_w1_1_start91,TSPA,70578,22419,48159,11,100,200
SteepestLS_Edges_NearestNeighborAny2Regret_w1_1_start92,TSPA,71872,23602,48270,7,100,200
SteepestLS_Edges_NearestNeighborAny2Regret_w1_1_start93,TSPA,70936,22813,48123,6,100,200
SteepestLS_Edges_NearestNeighborAny2Regret_w1_1_start94,TSPA,71272,23235,48037,5,100,200
SteepestLS_Edges_NearestNeighborAny2Regret_w1_1_start95,TSPA,72018,23501,48517,8,100,200
SteepestLS_Edges_NearestNeighborAny2Regret_w1_1_start96,TSPA,71288,22496,48792,7,100,200
SteepestLS_Edges_NearestNeighborAny2Regret_w1_1_start97,TSPA,70641,22384,48257,4,100,200
SteepestLS_Edges_NearestNeighborAny2Regret_w1_1_start98,TSPA,70881,22380,48501,4,100,200
SteepestLS_Edges_NearestNeighborAny2Regret_w1_1_start99,TSPA,70690,22113,48577,5,100,200
SteepestLS_Edges_NearestNeighborAny2Regret_w1_1_start100,TSPA,70570,21993,48577,5,100,200
SteepestLS_Edges_NearestNeighborAny2Regret_w1_1_start101,TSPA,70641,22384,48257,4,100,200
SteepestLS_Edges_NearestNeighborAny2Regret_w1_1_start102,TSPA,70088,22456,47632,10,100,200
SteepestLS_Edges_NearestNeighborAny2Regret_w1_1_start103,TSPA,71490,23460,48030,5,100,200
SteepestLS_Edges_NearestNeighborAny2Regret_w1_1_start104,TSPA,71313,22593,48720,8,100,200
SteepestLS_Edges_NearestNeighborAny2Regret_w1_1_start105,TSPA,71053,22746,48307,7,100,200
SteepestLS_Edges_NearestNeighborAny2Regret_w1_1_start106,TSPA,70052,22420,47632,10,100,200
SteepestLS_Edges_NearestNeighborAny2Regret_w1_1_start107,TSPA,72520,23508,49012,7,100,200
SteepestLS_Edges_NearestNeighborAny2Regret_w1_1_start108,TSPA,71436,23304,48132,4,100,200
SteepestLS_Edges_NearestNeighborAny2Regret_w1_1_start109,TSPA,70711,21996,48715,8,100,200
SteepestLS_Edges_NearestNeighborAny2Regret_w1_1_start110,TSPA,69702,21927,47775,5,100,200
SteepestLS_Edges_NearestNeighborAny2Regret_w1_1_start111,TSPA,71214,22508,48706,4,100,200
SteepestLS_Edges_NearestNeighborAny2Regret_w1_1_start112,TSPA,70393,22391,48002,4,100,200
SteepestLS_Edges_NearestNeighborAny2Regret_w1_1_start113,TSPA,70858,22481,48377,7,100,200
SteepestLS_Edges_NearestNeighborAny2Regret_w1_1_start114,TSPA,69540,22044,47496,4,100,200
SteepestLS_Edges_NearestNeighborAny2Regret_w1_1_start115,TSPA,70839,23130,47709,5,100,200
SteepestLS_Edges_NearestNeighborAny2Regret_w1_1_start116,TSPA,70296,22226,48070,7,100,200
SteepestLS_Edges_NearestNeighborAny2Regret_w1_1_start117,TSPA,69540,22044,47496,5,100,200
SteepestLS_Edges_NearestNeighborAny2Regret_w1_1_start118,TSPA,70293,22325,47968,8,100,200
SteepestLS_Edges_NearestNeighborAny2Regret_w1_1_start119,TSPA,70488,22510,47978,10,100,200
SteepestLS_Edges_NearestNeighborAny2Regret_w1_1_start120,TSPA,70641,22384,48257,3,100,200
SteepestLS_Edges_NearestNeighborAny2Regret_w1_1_start121,TSPA,70570,21993,48577,4,100,200
SteepestLS_Edges_NearestNeighborAny2Regret_w1_1_start122,TSPA,70869,22492,48377,8,100,200
SteepestLS_Edges_NearestNeighborAny2Regret_w1_1_start123,TSPA,70641,22384,48257,4,100,200
SteepestLS_Edges_NearestNeighborAny2Regret_w1_1_start124,TSPA,71137,23322,47815,5,100,200
SteepestLS_Edges_NearestNeighborAny2Regret_w1_1_start125,TSPA,71232,21733,49499,4,100,200
SteepestLS_Edges_NearestNeighborAny2Regret_w1_1_start126,TSPA,70451,21915,48536,5,100,200
SteepestLS_Edges_NearestNeighborAny2Regret_w1_1_start127,TSPA,70641,22384,48257,4,100,200
SteepestLS_Edges_NearestNeighborAny2Regret_w1_1_start128,TSPA,71343,22934,48409,5,100,200
SteepestLS_Edges_NearestNeighborAny2Regret_w1_1_start129,TSPA,70549,22349,48200,5,100,200
SteepestLS_Edges_NearestNeighborAny2Regret_w1_1_start130,TSPA,71115,22483,48632,7,100,200
SteepestLS_Edges_NearestNeighborAny2Regret_w1_1_start131,TSPA,71113,22898,48215,5,100,200
SteepestLS_Edges_NearestNeighborAny2Regret_w1_1_start132,TSPA,69966,21975,47991,8,100,200
SteepestLS_Edges_NearestNeighborAny2Regret_w1_1_start133,TSPA,70839,23130,47709,5,100,200
SteepestLS_Edges_NearestNeighborAny2Regret_w1_1_start134,TSPA,70641,22384,48257,6,100,200
SteepestLS_Edges_NearestNeighborAny2Regret_w1_1_start135,TSPA,70641,22384,48257,4,100,200
SteepestLS_Edges_NearestNeighborAny2Regret_w1_1_start136,TSPA,70698,22121,48577,9,100,200
SteepestLS_Edges_NearestNeighborAny2Regret_w1_1_start137,TSPA,70858,22481,48377,6,100,200
SteepestLS_Edges_NearestNeighborAny2Regret_w1_1_start138,TSPA,70309,22123,48186,9,100,200
SteepestLS_Edges_NearestNeighborAny2Regret_w1_1_start139,TSPA,70839,23130,47709,5,100,200
SteepestLS_Edges_NearestNeighborAny2Regret_w1_1_start140,TSPA,70936,22813,48123,6,100,200
SteepestLS_Edges_NearestNeighborAny2Regret_w1_1_start141,TSPA,71470,22805,48665,5,100,200
SteepestLS_Edges_NearestNeighborAny2Regret_w1_1_start142,TSPA,70746,22118,48628,4,100,200
SteepestLS_Edges_NearestNeighborAny2Regret_w1_1_start143,TSPA,69540,22044,47496,5,100,200
SteepestLS_Edges_NearestNeighborAny2Regret_w1_1_start144,TSPA,69540,22044,47496,5,100,200
SteepestLS_Edges_NearestNeighborAny2Regret_w1_1_start145,TSPA,70641,22384,48257,4,100,200
SteepestLS_Edges_NearestNeighborAny2Regret_w1_1_start146,TSPA,71490,23460,48030,5,100,200
SteepestLS_Edges_NearestNeighborAny2Regret_w1_1_start147,TSPA,71080,22806,48274,8,100,200
SteepestLS_Edges_NearestNeighborAny2Regret_w1_1_start148,TSPA,70296,22226,48070,7,100,200
SteepestLS_Edges_NearestNeighborAny2Regret_w1_1_start149,TSPA,70764,22233,48531,3,100,200
SteepestLS_Edges_NearestNeighborAny2Regret_w1_1_start150,TSPA,71035,22529,48506,7,100,200
SteepestLS_Edges_NearestNeighborAny2Regret_w1_1_start151,TSPA,70863,22942,47921,6,100,200
SteepestLS_Edges_NearestNeighborAny2Regret_w1_1_start152,TSPA,71078,22908,48170,5,100,200
SteepestLS_Edges_NearestNeighborAny2Regret_w1_1_start153,TSPA,69822,22015,47807,5,100,200
SteepestLS_Edges_NearestNeighborAny2Regret_w1_1_start154,TSPA,70641,22384,48257,4,100,200
SteepestLS_Edges_NearestNeighborAny2Regret_w1_1_start155,TSPA,70449,21927,48522,10,100,200
SteepestLS_Edges_NearestNeighborAny2Regret_w1_1_start156,TSPA,70913,22151,48762,7,100,200
SteepestLS_Edges_NearestNeighborAny2Regret_w1_1_start157,TSPA,71443,22752,48691,8,100,200
SteepestLS_Edges_NearestNeighborAny2Regret_w1_1_start158,TSPA,70616,21917,48699,3,100,200
SteepestLS_Edges_NearestNeighborAny2Regret_w1_1_start159,TSPA,70296,22226,48070,7,100,200
SteepestLS_Edges_NearestNeighborAny2Regret_w1_1_start160,TSPA,70961,22995,47966,8,100,200
SteepestLS_Edges_NearestNeighborAny2Regret_w1_1_start161,TSPA,71191,23270,47921,6,100,200
SteepestLS_Edges_NearestNeighborAny2Regret_w1_1_start162,TSPA,70863,22942,47921,6,100,200
SteepestLS_Edges_NearestNeighborAny2Regret_w1_1_start163,TSPA,70839,23130,47709,6,100,200
SteepestLS_Edges_NearestNeighborAny2Regret_w1_1_start164,TSPA,70622,22517,48105,7,100,200
SteepestLS_Edges_NearestNeighborAny2Regret_w1_1_start165,TSPA,70394,22541,47853,12,100,200
SteepestLS_Edges_NearestNeighborAny2Regret_w1_1_start166,TSPA,70569,22783,47786,8,100,200
SteepestLS_Edges_NearestNeighborAny2Regret_w1_1_start167,TSPA,71648,23486,48162,6,100,200
SteepestLS_Edges_NearestNeighborAny2Regret_w1_1_start168,TSPA,69874,22126,47748,6,100,200
SteepestLS_Edges_NearestNeighborAny2Regret_w1_1_start169,TSPA,70203,22086,48117,10,100,200
SteepestLS_Edges_NearestNeighborAny2Regret_w1_1_start170,TSPA,69815,21945,47870,5,100,200
SteepestLS_Edges_NearestNeighborAny2Regret_w1_1_start171,TSPA,70858,22481,48377,7,100,200
SteepestLS_Edges_NearestNeighborAny2Regret_w1_1_start172,TSPA,71249,23049,48200,6,100,200
SteepestLS_Edges_NearestNeighborAny2Regret_w1_1_start173,TSPA,70940,22302,48638,5,100,200
SteepestLS_Edges_NearestNeighborAny2Regret_w1_1_start174,TSPA,70293,22266,48027,10,100,200
SteepestLS_Edges_NearestNeighborAny2Regret_w1_1_start175,TSPA,70858,22481,48377,8,100,200
SteepestLS_Edges_NearestNeighborAny2Regret_w1_1_start176,TSPA,70858,22481,48377,6,100,200
SteepestLS_Edges_NearestNeighborAny2Regret_w1_1_start177,TSPA,70956,22993,47963,7,100,200
SteepestLS_Edges_NearestNeighborAny2Regret_w1_1_start178,TSPA,70052,22420,47632,9,100,200
SteepestLS_Edges_NearestNeighborAny2Regret_w1_1_start179,TSPA,71136,22759,48377,8,100,200
SteepestLS_Edges_NearestNeighborAny2Regret_w1_1_start180,TSPA,70641,22384,48257,4,100,200
SteepestLS_Edges_NearestNeighborAny2Regret_w1_1_start181,TSPA,70369,22737,47632,10,100,200
SteepestLS_Edges_NearestNeighborAny2Regret_w1_1_start182,TSPA,70698,22121,48577,9,100,200
SteepestLS_Edges_NearestNeighborAny2Regret_w1_1_start183,TSPA,69540,22044,47496,5,100,200
SteepestLS_Edges_NearestNeighborAny2Regret_w1_1_start184,TSPA,70595,22590,48005,3,100,200
SteepestLS_Edges_NearestNeighborAny2Regret_w1_1_start185,TSPA,71360,23507,47853,9,100,200
SteepestLS_Edges_NearestNeighborAny2Regret_w1_1_start186,TSPA,69558,21766,47792,4,100,200
SteepestLS_Edges_NearestNeighborAny2Regret_w1_1_start187,TSPA,70784,22296,48488,10,100,200
SteepestLS_Edges_NearestNeighborAny2Regret_w1_1_start188,TSPA,71185,21756,49429,5,100,200
SteepestLS_Edges_NearestNeighborAny2Regret_w1_1_start189,TSPA,70503,22058,48445,5,100,200
SteepestLS_Edges_NearestNeighborAny2Regret_w1_1_start190,TSPA,70102,22308,47794,3,100,200
SteepestLS_Edges_NearestNeighborAny2Regret_w1_1_start191,TSPA,70886,22519,48367,6,100,200
SteepestLS_Edges_NearestNeighborAny2Regret_w1_1_start192,TSPA,71243,23105,48138,9,100,200
SteepestLS_Edges_NearestNeighborAny2Regret_w1_1_start193,TSPA,70839,23130,47709,5,100,200
SteepestLS_Edges_NearestNeighborAny2Regret_w1_1_start194,TSPA,71099,22276,48823,3,100,200
SteepestLS_Edges_NearestNeighborAny2Regret_w1_1_start195,TSPA,70916,22288,48628,6,100,200
SteepestLS_Edges_NearestNeighborAny2Regret_w1_1_start196,TSPA,69874,22126,47748,5,100,200
SteepestLS_Edges_NearestNeighborAny2Regret_w1_1_start197,TSPA,70537,22699,47838,11,100,200
SteepestLS_Edges_NearestNeighborAny2Regret_w1_1_start198,TSPA,70839,23130,47709,5,100,200
SteepestLS_Edges_NearestNeighborAny2Regret_w1_1_start199,TSPA,70914,22124,48790,3,100,200
GreedyLS_Nodes_Random_start0,TSPA,86012,36559,49453,199,100,200
GreedyLS_Nodes_Random_start1,TSPA,89783,41481,48302,200,100,200
GreedyLS_Nodes_Random_start2,TSPA,88174,38984,49190,193,100,200
GreedyLS_Nodes_Random_start3,TSPA,84607,34509,50098,216,100,200
GreedyLS_Nodes_Random_start4,TSPA,85236,35235,50001,195,100,200
GreedyLS_Nodes_Random_start5,TSPA,90883,38996,51887,182,100,200
GreedyLS_Nodes_Random_start6,TSPA,84472,36410,48062,219,100,200
GreedyLS_Nodes_Random_start7,TSPA,84692,35349,49343,202,100,200
GreedyLS_Nodes_Random_start8,TSPA,87915,38640,49275,206,100,200
GreedyLS_Nodes_Random_start9,TSPA,85301,36420,48881,212,100,200
GreedyLS_Nodes_Random_start10,TSPA,85241,37019,48222,231,100,200
GreedyLS_Nodes_Random_start11,TSPA,90525,40446,50079,181,100,200
GreedyLS_Nodes_Random_start12,TSPA,83766,34629,49137,198,100,200
GreedyLS_Nodes_Random_start13,TSPA,84983,35268,49715,204,100,200
GreedyLS_Nodes_Random_start14,TSPA,88095,37454,50641,206,100,200
GreedyLS_Nodes_Random_start15,TSPA,89104,38923,50181,235,100,200
GreedyLS_Nodes_Random_start16,TSPA,91265,41173,50092,181,100,200
GreedyLS_Nodes_Random_start17,TSPA,80812,32642,48170,211,100,200
GreedyLS_Nodes_Random_start18,TSPA,84901,35254,49647,198,100,200
GreedyLS_Nodes_Random_start19,TSPA,94131,44190,49941,214,100,200
GreedyLS_Nodes_Random_start20,TSPA,82738,33449,49289,237,100,200
GreedyLS_Nodes_Random_start21,TSPA,82891,33614,49277,211,100,200
GreedyLS_Nodes_Random_start22,TSPA,82158,33655,48503,205,100,200
GreedyLS_Nodes_Random_start23,TSPA,86713,37945,48768,206,100,200
GreedyLS_Nodes_Random_start24,TSPA,88138,39696,48442,192,100,200
GreedyLS_Nodes_Random_start25,TSPA,84082,35751,48331,200,100,200
GreedyLS_Nodes_Random_start26,TSPA,86991,37658,49333,205,100,200
GreedyLS_Nodes_Random_start27,TSPA,82269,33180,49089,202,100,200
GreedyLS_Nodes_Random_start28,TSPA,91165,42948,48217,206,100,200
GreedyLS_Nodes_Random_start29,TSPA,82732,34183,48549,248,100,200
GreedyLS_Nodes_Random_start30,TSPA,89405,40535,48870,199,100,200
GreedyLS_Nodes_Random_start31,TSPA,93389,44554,48835,214,100,200
GreedyLS_Nodes_Random_start32,TSPA,82839,34714,48125,219,100,200
GreedyLS_Nodes_Random_start33,TSPA,84277,35459,48818,209,100,200
GreedyLS_Nodes_Random_start34,TSPA,85734,36970,48764,212,100,200
GreedyLS_Nodes_Random_start35,TSPA,84031,32592,51439,215,100,200
GreedyLS_Nodes_Random_start36,TSPA,83823,35356,48467,192,100,200
GreedyLS_Nodes_Random_start37,TSPA,85498,34552,50946,217,100,200
GreedyLS_Nodes_Random_start38,TSPA,85934,36352,49582,210,100,200
GreedyLS_Nodes_Random_start39,TSPA,88648,39744,48904,213,100,200
GreedyLS_Nodes_Random_start40,TSPA,86439,38242,48197,231,100,200
GreedyLS_Nodes_Random_start41,TSPA,85160,36391,48769,220,100,200
GreedyLS_Nodes_Random_start42,TSPA,90212,40714,49498,213,100,200
GreedyLS_Nodes_Random_start43,TSPA,89046,35558,53488,181,100,200
GreedyLS_Nodes_Random_start44,TSPA,88358,39064,49294,206,100,200
GreedyLS_Nodes_Random_start45,TSPA,86115,38063,48052,206,100,200
GreedyLS_Nodes_Random_start46,TSPA,83856,34978,48878,213,100,200
GreedyLS_Nodes_Random_start47,TSPA,83375,32997,50378,208,100,200
GreedyLS_Nodes_Random_start48,TSPA,81277,31409,49868,235,100,200
GreedyLS_Nodes_Random_start49,TSPA,85264,37109,48155,200,100,200
GreedyLS_Nodes_Random_start50,TSPA,86505,37551,48954,219,100,200
GreedyLS_Nodes_Random_start51,TSPA,88340,37739,50601,219,100,200
GreedyLS_Nodes_Random_start52,TSPA,89157,40070,49087,205,100,200
GreedyLS_Nodes_Random_start53,TSPA,83675,34254,49421,192,100,200
GreedyLS_Nodes_Random_start54,TSPA,86834,36524,50310,206,100,200
GreedyLS_Nodes_Random_start55,TSPA,88873,39203,49670,209,100,200
GreedyLS_Nodes_Random_start56,TSPA,85982,34964,51018,221,100,200
GreedyLS_Nodes_Random_start57,TSPA,85587,35373,50214,210,100,200
GreedyLS_Nodes_Random_start58,TSPA,83953,34259,49694,248,100,200
GreedyLS_Nodes_Random_start59,TSPA,90120,41690,48430,202,100,200
GreedyLS_Nodes_Random_start60,TSPA,87864,38732,49132,217,100,200
GreedyLS_Nodes_Random_start61,TSPA,87643,38900,48743,207,100,200
GreedyLS_Nodes_Random_start62,TSPA,89203,39588,49615,212,100,200
GreedyLS_Nodes_Random_start63,TSPA,84859,35320,49539,200,100,200
GreedyLS_Nodes_Random_start64,TSPA,88782,39799,48983,180,100,200
GreedyLS_Nodes_Random_start65,TSPA,89898,39511,50387,228,100,200
GreedyLS_Nodes_Random_start66,TSPA,84659,35570,49089,212,100,200
GreedyLS_Nodes_Random_start67,TSPA,86340,35827,50513,206,100,200
GreedyLS_Nodes_Random_start68,TSPA,83811,34994,48817,231,100,200
GreedyLS_Nodes_Random_start69,TSPA,84364,33334,51030,208,100,200
GreedyLS_Nodes_Random_start70,TSPA,86679,38194,48485,191,100,200
GreedyLS_Nodes_Random_start71,TSPA,85877,36606,49271,226,100,200
GreedyLS_Nodes_Random_start72,TSPA,88030,37805,50225,196,100,200
GreedyLS_Nodes_Random_start73,TSPA,83369,32072,51297,225,100,200
GreedyLS_Nodes_Random_start74,TSPA,84139,34777,49362,216,100,200
GreedyLS_Nodes_Random_start75,TSPA,87517,37378,50139,181,100,200
GreedyLS_Nodes_Random_start76,TSPA,92829,43564,49265,209,100,200
GreedyLS_Nodes_Random_start77,TSPA,86860,36961,49899,261,100,200
GreedyLS_Nodes_Random_start78,TSPA,85284,37021,48263,215,100,200
GreedyLS_Nodes_Random_start79,TSPA,90217,37648,52569,227,100,200
GreedyLS_Nodes_Random_start80,TSPA,81273,32716,48557,235,100,200
GreedyLS_Nodes_Random_start81,TSPA,87987,38728,49259,198,100,200
GreedyLS_Nodes_Random_start82,TSPA,88221,37664,50557,214,100,200
GreedyLS_Nodes_Random_start83,TSPA,89758,38899,50859,205,100,200
GreedyLS_Nodes_Random_start84,TSPA,86870,35964,50906,207,100,200
GreedyLS_Nodes_Random_start85,TSPA,84969,34190,50779,229,100,200
GreedyLS_Nodes_Random_start86,TSPA,87602,36710,50892,199,100,200
GreedyLS_Nodes_Random_start87,TSPA,82783,33425,49358,211,100,200
GreedyLS_Nodes_Random_start88,TSPA,87770,36621,51149,213,100,200
GreedyLS_Nodes_Random_start89,TSPA,82083,32862,49221,206,100,200
GreedyLS_Nodes_Random_start90,TSPA,82205,33158,49047,208,100,200
GreedyLS_Nodes_Random_start91,TSPA,86950,36989,49961,216,100,200
GreedyLS_Nodes_Random_start92,TSPA,84346,33649,50697,215,100,200
GreedyLS_Nodes_Random_start93,TSPA,85366,35629,49737,205,100,200
GreedyLS_Nodes_Random_start94,TSPA,85490,34613,50877,228,100,200
GreedyLS_Nodes_Random_start95,TSPA,87975,38854,49121,215,100,200
GreedyLS_Nodes_Random_start96,TSPA,88834,39812,49022,229,100,200
GreedyLS_Nodes_Random_start97,TSPA,89574,37390,52184,203,100,200
GreedyLS_Nodes_Random_start98,TSPA,85086,36467,48619,215,100,200
GreedyLS_Nodes_Random_start99,TSPA,91055,40723,50332,192,100,200
GreedyLS_Nodes_Random_start100,TSPA,83762,34876,48886,237,100,200
GreedyLS_Nodes_Random_start101,TSPA,84036,33744,50292,202,100,200
GreedyLS_Nodes_Random_start102,TSPA,89529,38904,50625,196,100,200
GreedyLS_Nodes_Random_start103,TSPA,84500,34765,49735,204,100,200
GreedyLS_Nodes_Random_start104,TSPA,87400,38651,48749,196,100,200
GreedyLS_Nodes_Random_start105,TSPA,86229,37198,49031,238,100,200
GreedyLS_Nodes_Random_start106,TSPA,87652,37965,49687,209,100,200
GreedyLS_Nodes_Random_start107,TSPA,85046,35184,49862,196,100,200
GreedyLS_Nodes_Random_start108,TSPA,87305,38849,48456,180,100,200
GreedyLS_Nodes_Random_start109,TSPA,86938,37441,49497,214,100,200
GreedyLS_Nodes_Random_start110,TSPA,91302,39321,51981,192,100,200
GreedyLS_Nodes_Random_start111,TSPA,84789,34902,49887,198,100,200
GreedyLS_Nodes_Random_start112,TSPA,86874,38674,48200,245,100,200
GreedyLS_Nodes_Random_start113,TSPA,89234,38853,50381,181,100,200
GreedyLS_Nodes_Random_start114,TSPA,85797,35733,50064,182,100,200
GreedyLS_Nodes_Random_start115,TSPA,87540,38101,49439,260,100,200
GreedyLS_Nodes_Random_start116,TSPA,85746,35967,49779,193,100,200
GreedyLS_Nodes_Random_start117,TSPA,87553,36659,50894,198,100,200
GreedyLS_Nodes_Random_start118,TSPA,84457,35911,48546,187,100,200
GreedyLS_Nodes_Random_start119,TSPA,88252,37560,50692,173,100,200
GreedyLS_Nodes_Random_start120,TSPA,85359,35560,49799,226,100,200
GreedyLS_Nodes_Random_start121,TSPA,84224,35045,49179,199,100,200
GreedyLS_Nodes_Random_start122,TSPA,87343,37984,49359,202,100,200
GreedyLS_Nodes_Random_start123,TSPA,89423,39456,49967,224,100,200
GreedyLS_Nodes_Random_start124,TSPA,88221,37482,50739,198,100,200
GreedyLS_Nodes_Random_start125,TSPA,85509,35373,50136,217,100,200
GreedyLS_Nodes_Random_start126,TSPA,84051,33933,50118,218,100,200
GreedyLS_Nodes_Random_start127,TSPA,87077,37360,49717,206,100,200
GreedyLS_Nodes_Random_start128,TSPA,83164,34493,48671,225,100,200
GreedyLS_Nodes_Random_start129,TSPA,85712,37115,48597,196,100,200
GreedyLS_Nodes_Random_start130,TSPA,85671,36280,49391,218,100,200
GreedyLS_Nodes_Random_start131,TSPA,83933,34718,49215,209,100,200
GreedyLS_Nodes_Random_start132,TSPA,84868,33718,51150,228,100,200
GreedyLS_Nodes_Random_start133,TSPA,85443,35399,50044,206,100,200
GreedyLS_Nodes_Random_start134,TSPA,85111,36864,48247,206,100,200
GreedyLS_Nodes_Random_start135,TSPA,83120,33790,49330,191,100,200
GreedyLS_Nodes_Random_start136,TSPA,87965,38497,49468,206,100,200
GreedyLS_Nodes_Random_start137,TSPA,85142,36350,48792,197,100,200
GreedyLS_Nodes_Random_start138,TSPA,86361,36570,49791,215,100,200
GreedyLS_Nodes_Random_start139,TSPA,87193,36668,50525,211,100,200
GreedyLS_Nodes_Random_start140,TSPA,83710,34173,49537,233,100,200
GreedyLS_Nodes_Random_start141,TSPA,85338,35507,49831,187,100,200
GreedyLS_Nodes_Random_start142,TSPA,87573,38552,49021,222,100,200
GreedyLS_Nodes_Random_start143,TSPA,87511,37628,49883,188,100,200
GreedyLS_Nodes_Random_start144,TSPA,89000,38376,50624,215,100,200
GreedyLS_Nodes_Random_start145,TSPA,90223,40067,50156,180,100,200
GreedyLS_Nodes_Random_start146,TSPA,88182,38381,49801,198,100,200
GreedyLS_Nodes_Random_start147,TSPA,85242,36517,48725,213,100,200
GreedyLS_Nodes_Random_start148,TSPA,87520,38808,48712,221,100,200
GreedyLS_Nodes_Random_start149,TSPA,85611,36697,48914,225,100,200
GreedyLS_Nodes_Random_start150,TSPA,85856,37295,48561,257,100,200
GreedyLS_Nodes_Random_start151,TSPA,86860,36609,50251,206,100,200
GreedyLS_Nodes_Random_start152,TSPA,87506,38221,49285,221,100,200
GreedyLS_Nodes_Random_start153,TSPA,82153,33814,48339,234,100,200
GreedyLS_Nodes_Random_start154,TSPA,88657,39189,49468,216,100,200
GreedyLS_Nodes_Random_start155,TSPA,94777,45419,49358,213,100,200
GreedyLS_Nodes_Random_start156,TSPA,88316,34630,53686,200,100,200
GreedyLS_Nodes_Random_start157,TSPA,84511,33735,50776,213,100,200
GreedyLS_Nodes_Random_start158,TSPA,90262,40300,49962,175,100,200
GreedyLS_Nodes_Random_start159,TSPA,87751,37879,49872,190,100,200
GreedyLS_Nodes_Random_start160,TSPA,86064,36921,49143,217,100,200
GreedyLS_Nodes_Random_start161,TSPA,85744,36006,49738,226,100,200
GreedyLS_Nodes_Random_start162,TSPA,86893,37398,49495,219,100,200
GreedyLS_Nodes_Random_start163,TSPA,85022,35984,49038,241,100,200
GreedyLS_Nodes_Random_start164,TSPA,82307,30950,51357,246,100,200
GreedyLS_Nodes_Random_start165,TSPA,83079,32236,50843,214,100,200
GreedyLS_Nodes_Random_start166,TSPA,83480,34845,48635,215,100,200
GreedyLS_Nodes_Random_start167,TSPA,88715,38209,50506,224,100,200
GreedyLS_Nodes_Random_start168,TSPA,86527,37577,48950,232,100,200
GreedyLS_Nodes_Random_start169,TSPA,87006,36920,50086,202,100,200
GreedyLS_Nodes_Random_start170,TSPA,88341,39637,48704,192,100,200
GreedyLS_Nodes_Random_start171,TSPA,84394,35360,49034,202,100,200
GreedyLS_Nodes_Random_start172,TSPA,90039,39016,51023,204,100,200
GreedyLS_Nodes_Random_start173,TSPA,88750,37655,51095,224,100,200
GreedyLS_Nodes_Random_start174,TSPA,86001,37814,48187,225,100,200
GreedyLS_Nodes_Random_start175,TSPA,86960,37266,49694,222,100,200
GreedyLS_Nodes_Random_start176,TSPA,91971,41365,50606,200,100,200
GreedyLS_Nodes_Random_start177,TSPA,87964,38473,49491,207,100,200
GreedyLS_Nodes_Random_start178,TSPA,88262,38091,50171,184,100,200
GreedyLS_Nodes_Random_start179,TSPA,85094,36152,48942,216,100,200
GreedyLS_Nodes_Random_start180,TSPA,82643,33464,49179,231,100,200
GreedyLS_Nodes_Random_start181,TSPA,83469,34610,48859,218,100,200
GreedyLS_Nodes_Random_start182,TSPA,86479,34634,51845,215,100,200
GreedyLS_Nodes_Random_start183,TSPA,86905,37885,49020,211,100,200
GreedyLS_Nodes_Random_start184,TSPA,87267,35348,51919,203,100,200
GreedyLS_Nodes_Random_start185,TSPA,82552,32995,49557,218,100,200
GreedyLS_Nodes_Random_start186,TSPA,84630,34398,50232,221,100,200
GreedyLS_Nodes_Random_start187,TSPA,88305,38744,49561,212,100,200
GreedyLS_Nodes_Random_start188,TSPA,85759,36867,48892,228,100,200
GreedyLS_Nodes_Random_start189,TSPA,82486,33020,49466,193,100,200
GreedyLS_Nodes_Random_start190,TSPA,88664,39902,48762,202,100,200
GreedyLS_Nodes_Random_start191,TSPA,84224,34936,49288,203,100,200
GreedyLS_Nodes_Random_start192,TSPA,84002,33875,50127,208,100,200
GreedyLS_Nodes_Random_start193,TSPA,83128,34076,49052,219,100,200
GreedyLS_Nodes_Random_start194,TSPA,89015,38508,50507,181,100,200
GreedyLS_Nodes_Random_start195,TSPA,83284,34835,48449,221,100,200
GreedyLS_Nodes_Random_start196,TSPA,90008,39032,50976,204,100,200
GreedyLS_Nodes_Random_start197,TSPA,87560,38941,48619,227,100,200
GreedyLS_Nodes_Random_start198,TSPA,88819,40310,48509,212,100,200
GreedyLS_Nodes_Random_start199,TSPA,89899,39014,50885,202,100,200
GreedyLS_Nodes_NearestNeighborAny2Regret_w1_1_start0,TSPA,70217,22721,47496,6,100,200
GreedyLS_Nodes_NearestNeighborAny2Regret_w1_1_start1,TSPA,70641,22384,48257,5,100,200
GreedyLS_Nodes_NearestNeighborAny2Regret_w1_1_start2,TSPA,70641,22384,48257,5,100,200
GreedyLS_Nodes_NearestNeighborAny2Regret_w1_1_start3,TSPA,73588,25402,48186,8,100,200
GreedyLS_Nodes_NearestNeighborAny2Regret_w1_1_start4,TSPA,70152,22156,47996,4,100,200
GreedyLS_Nodes_NearestNeighborAny2Regret_w1_1_start5,TSPA,70641,22384,48257,6,100,200
GreedyLS_Nodes_NearestNeighborAny2Regret_w1_1_start6,TSPA,70940,22302,48638,6,100,200
GreedyLS_Nodes_NearestNeighborAny2Regret_w1_1_start7,TSPA,72160,24452,47708,9,100,200
GreedyLS_Nodes_NearestNeighborAny2Regret_w1_1_start8,TSPA,72409,24101,48308,14,100,200
GreedyLS_Nodes_NearestNeighborAny2Regret_w1_1_start9,TSPA,73723,25755,47968,7,100,200
GreedyLS_Nodes_NearestNeighborAny2Regret_w1_1_start10,TSPA,72411,24239,48172,9,100,200
GreedyLS_Nodes_NearestNeighborAny2Regret_w1_1_start11,TSPA,70690,22535,48155,8,100,200
GreedyLS_Nodes_NearestNeighborAny2Regret_w1_1_start12,TSPA,72183,23576,48607,7,100,200
GreedyLS_Nodes_NearestNeighborAny2Regret_w1_1_start13,TSPA,73968,25737,48231,8,100,200
GreedyLS_Nodes_NearestNeighborAny2Regret_w1_1_start14,TSPA,73616,25430,48186,9,100,200
GreedyLS_Nodes_NearestNeighborAny2Regret_w1_1_start15,TSPA,70217,22721,47496,6,100,200
GreedyLS_Nodes_NearestNeighborAny2Regret_w1_1_start16,TSPA,74657,26280,48377,5,100,200
GreedyLS_Nodes_NearestNeighborAny2Regret_w1_1_start17,TSPA,70892,22203,48689,9,100,200
GreedyLS_Nodes_NearestNeighborAny2Regret_w1_1_start18,TSPA,70641,22384,48257,5,100,200
GreedyLS_Nodes_NearestNeighborAny2Regret_w1_1_start19,TSPA,70602,22157,48445,5,100,200
GreedyLS_Nodes_NearestNeighborAny2Regret_w1_1_start20,TSPA,71929,23364,48565,6,100,200
GreedyLS_Nodes_NearestNeighborAny2Regret_w1_1_start21,TSPA,73213,24786,48427,9,100,200
GreedyLS_Nodes_NearestNeighborAny2Regret_w1_1_start22,TSPA,72149,24079,48070,5,100,200
GreedyLS_Nodes_NearestNeighborAny2Regret_w1_1_start23,TSPA,72854,24477,48377,4,100,200
GreedyLS_Nodes_NearestNeighborAny2Regret_w1_1_start24,TSPA,70300,22156,48144,6,100,200
GreedyLS_Nodes_NearestNeighborAny2Regret_w1_1_start25,TSPA,70641,22384,48257,5,100,200
GreedyLS_Nodes_NearestNeighborAny2Regret_w1_1_start26,TSPA,70570,21993,48577,5,100,200
GreedyLS_Nodes_NearestNeighborAny2Regret_w1_1_start27,TSPA,72885,24281,48604,10,100,200
GreedyLS_Nodes_NearestNeighborAny2Regret_w1_1_start28,TSPA,70065,21987,48078,6,100,200
GreedyLS_Nodes_NearestNeighborAny2Regret_w1_1_start29,TSPA,71312,22907,48405,11,100,200
GreedyLS_Nodes_NearestNeighborAny2Regret_w1_1_start30,TSPA,71838,23802,48036,10,100,200
GreedyLS_Nodes_NearestNeighborAny2Regret_w1_1_start31,TSPA,73868,25598,48270,5,100,200
GreedyLS_Nodes_NearestNeighborAny2Regret_w1_1_start32,TSPA,73616,25430,48186,7,100,200
GreedyLS_Nodes_NearestNeighborAny2Regret_w1_1_start33,TSPA,72773,24590,48183,7,100,200
GreedyLS_Nodes_NearestNeighborAny2Regret_w1_1_start34,TSPA,73249,25283,47966,6,100,200
GreedyLS_Nodes_NearestNeighborAny2Regret_w1_1_start35,TSPA,69801,21778,48023,5,100,200
GreedyLS_Nodes_NearestNeighborAny2Regret_w1_1_start36,TSPA,72537,23691,48846,4,100,200
GreedyLS_Nodes_NearestNeighborAny2Regret_w1_1_start37,TSPA,72397,23436,48961,11,100,200
GreedyLS_Nodes_NearestNeighborAny2Regret_w1_1_start38,TSPA,73968,25737,48231,6,100,200
GreedyLS_Nodes_NearestNeighborAny2Regret_w1_1_start39,TSPA,71991,23788,48203,7,100,200
GreedyLS_Nodes_NearestNeighborAny2Regret_w1_1_start40,TSPA,72930,25077,47853,5,100,200
GreedyLS_Nodes_NearestNeighborAny2Regret_w1_1_start41,TSPA,71783,24125,47658,5,100,200
GreedyLS_Nodes_NearestNeighborAny2Regret_w1_1_start42,TSPA,70641,22384,48257,5,100,200
GreedyLS_Nodes_NearestNeighborAny2Regret_w1_1_start43,TSPA,74023,25928,48095,5,100,200
GreedyLS_Nodes_NearestNeighborAny2Regret_w1_1_start44,TSPA,70641,22384,48257,6,100,200
GreedyLS_Nodes_NearestNeighborAny2Regret_w1_1_start45,TSPA,71907,23517,48390,8,100,200
GreedyLS_Nodes_NearestNeighborAny2Regret_w1_1_start46,TSPA,70217,22721,47496,6,100,200
GreedyLS_Nodes_NearestNeighborAny2Regret_w1_1_start47,TSPA,74185,25878,48307,5,100,200
GreedyLS_Nodes_NearestNeighborAny2Regret_w1_1_start48,TSPA,72343,22957,49386,7,100,200
GreedyLS_Nodes_NearestNeighborAny2Regret_w1_1_start49,TSPA,70217,22721,47496,5,100,200
GreedyLS_Nodes_NearestNeighborAny2Regret_w1_1_start50,TSPA,70586,21897,48689,7,100,200
GreedyLS_Nodes_NearestNeighborAny2Regret_w1_1_start51,TSPA,71939,24343,47596,5,100,200
GreedyLS_Nodes_NearestNeighborAny2Regret_w1_1_start52,TSPA,73978,25462,48516,6,100,200
GreedyLS_Nodes_NearestNeighborAny2Regret_w1_1_start53,TSPA,70641,22384,48257,6,100,200
GreedyLS_Nodes_NearestNeighborAny2Regret_w1_1_start54,TSPA,70152,22156,47996,5,100,200
GreedyLS_Nodes_NearestNeighborAny2Regret_w1_1_start55,TSPA,73978,25462,48516,5,100,200
GreedyLS_Nodes_NearestNeighborAny2Regret_w1_1_start56,TSPA,73605,25228,48377,4,100,200
GreedyLS_Nodes_NearestNeighborAny2Regret_w1_1_start57,TSPA,75405,27135,48270,5,100,200
GreedyLS_Nodes_NearestNeighborAny2Regret_w1_1_start58,TSPA,73690,24802,48888,6,100,200
GreedyLS_Nodes_NearestNeighborAny2Regret_w1_1_start59,TSPA,72095,24025,48070,5,100,200
GreedyLS_Nodes_NearestNeighborAny2Regret_w1_1_start60,TSPA,70666,21771,48895,7,100,200
GreedyLS_Nodes_NearestNeighborAny2Regret_w1_1_start61,TSPA,70559,22770,47789,7,100,200
GreedyLS_Nodes_NearestNeighborAny2Regret_w1_1_start62,TSPA,73359,25727,47632,10,100,200
GreedyLS_Nodes_NearestNeighborAny2Regret_w1_1_start63,TSPA,72854,24477,48377,4,100,200
GreedyLS_Nodes_NearestNeighborAny2Regret_w1_1_start64,TSPA,70924,22719,48205,5,100,200
GreedyLS_Nodes_NearestNeighborAny2Regret_w1_1_start65,TSPA,72095,24025,48070,4,100,200
GreedyLS_Nodes_NearestNeighborAny2Regret_w1_1_start66,TSPA,73313,24555,48758,5,100,200
GreedyLS_Nodes_NearestNeighborAny2Regret_w1_1_start67,TSPA,70478,22371,48107,5,100,200
GreedyLS_Nodes_NearestNeighborAny2Regret_w1_1_start68,TSPA,72006,23883,48123,5,100,200
GreedyLS_Nodes_NearestNeighborAny2Regret_w1_1_start69,TSPA,71360,23158,48202,9,100,200
GreedyLS_Nodes_NearestNeighborAny2Regret_w1_1_start70,TSPA,70641,22384,48257,5,100,200
GreedyLS_Nodes_NearestNeighborAny2Regret_w1_1_start71,TSPA,73495,24347,49148,9,100,200
GreedyLS_Nodes_NearestNeighborAny2Regret_w1_1_start72,TSPA,74716,26043,48673,5,100,200
GreedyLS_Nodes_NearestNeighborAny2Regret_w1_1_start73,TSPA,70816,23134,47682,10,100,200
GreedyLS_Nodes_NearestNeighborAny2Regret_w1_1_start74,TSPA,72277,23106,49171,7,100,200
GreedyLS_Nodes_NearestNeighborAny2Regret_w1_1_start75,TSPA,70809,22232,48577,4,100,200
GreedyLS_Nodes_NearestNeighborAny2Regret_w1_1_start76,TSPA,73074,24620,48454,8,100,200
GreedyLS_Nodes_NearestNeighborAny2Regret_w1_1_start77,TSPA,74194,25887,48307,6,100,200
GreedyLS_Nodes_NearestNeighborAny2Regret_w1_1_start78,TSPA,70641,22384,48257,4,100,200
GreedyLS_Nodes_NearestNeighborAny2Regret_w1_1_start79,TSPA,72854,24477,48377,4,100,200
GreedyLS_Nodes_NearestNeighborAny2Regret_w1_1_start80,TSPA,72854,24477,48377,3,100,200
GreedyLS_Nodes_NearestNeighborAny2Regret_w1_1_start81,TSPA,74035,25672,48363,5,100,200
GreedyLS_Nodes_NearestNeighborAny2Regret_w1_1_start82,TSPA,69968,21839,48129,7,100,200
GreedyLS_Nodes_NearestNeighborAny2Regret_w1_1_start83,TSPA,71099,22894,48205,5,100,200
GreedyLS_Nodes_NearestNeighborAny2Regret_w1_1_start84,TSPA,70393,22391,48002,5,100,200
GreedyLS_Nodes_NearestNeighborAny2Regret_w1_1_start85,TSPA,73968,25737,48231,5,100,200
GreedyLS_Nodes_NearestNeighborAny2Regret_w1_1_start86,TSPA,70809,22232,48577,7,100,200
GreedyLS_Nodes_NearestNeighborAny2Regret_w1_1_start87,TSPA,71728,23635,48093,10,100,200
GreedyLS_Nodes_NearestNeighborAny2Regret_w1_1_start88,TSPA,75440,26142,49298,4,100,200
GreedyLS_Nodes_NearestNeighborAny2Regret_w1_1_start89,TSPA,72854,24477,48377,4,100,200
GreedyLS_Nodes_NearestNeighborAny2Regret_w1_1_start90,TSPA,72930,25077,47853,6,100,200
GreedyLS_Nodes_NearestNeighborAny2Regret_w1_1_start91,TSPA,73707,25548,48159,9,100,200
GreedyLS_Nodes_NearestNeighborAny2Regret_w1_1_start92,TSPA,75405,27135,48270,4,100,200
GreedyLS_Nodes_NearestNeighborAny2Regret_w1_1_start93,TSPA,72006,23883,48123,5,100,200
GreedyLS_Nodes_NearestNeighborAny2Regret_w1_1_start94,TSPA,71862,23825,48037,5,100,200
GreedyLS_Nodes_NearestNeighborAny2Regret_w1_1_start95,TSPA,72023,23506,48517,11,100,200
GreedyLS_Nodes_NearestNeighborAny2Regret_w1_1_start96,TSPA,71746,23251,48495,7,100,200
GreedyLS_Nodes_NearestNeighborAny2Regret_w1_1_start97,TSPA,70641,22384,48257,5,100,200
GreedyLS_Nodes_NearestNeighborAny2Regret_w1_1_start98,TSPA,70881,22380,48501,8,100,200
GreedyLS_Nodes_NearestNeighborAny2Regret_w1_1_start99,TSPA,70590,22145,48445,6,100,200
GreedyLS_Nodes_NearestNeighborAny2Regret_w1_1_start100,TSPA,70570,21993,48577,4,100,200
GreedyLS_Nodes_NearestNeighborAny2Regret_w1_1_start101,TSPA,70641,22384,48257,5,100,200
GreedyLS_Nodes_NearestNeighborAny2Regret_w1_1_start102,TSPA,73399,25767,47632,8,100,200
GreedyLS_Nodes_NearestNeighborAny2Regret_w1_1_start103,TSPA,71617,23587,48030,6,100,200
GreedyLS_Nodes_NearestNeighborAny2Regret_w1_1_start104,TSPA,72457,24183,48274,11,100,200
GreedyLS_Nodes_NearestNeighborAny2Regret_w1_1_start105,TSPA,74194,25887,48307,7,100,200
GreedyLS_Nodes_NearestNeighborAny2Regret_w1_1_start106,TSPA,73363,25731,47632,9,100,200
GreedyLS_Nodes_NearestNeighborAny2Regret_w1_1_start107,TSPA,72309,23854,48455,13,100,200
GreedyLS_Nodes_NearestNeighborAny2Regret_w1_1_start108,TSPA,71563,23431,48132,5,100,200
GreedyLS_Nodes_NearestNeighborAny2Regret_w1_1_start109,TSPA,74619,25904,48715,5,100,200
GreedyLS_Nodes_NearestNeighborAny2Regret_w1_1_start110,TSPA,69909,22134,47775,8,100,200
GreedyLS_Nodes_NearestNeighborAny2Regret_w1_1_start111,TSPA,71269,22563,48706,7,100,200
GreedyLS_Nodes_NearestNeighborAny2Regret_w1_1_start112,TSPA,70393,22391,48002,5,100,200
GreedyLS_Nodes_NearestNeighborAny2Regret_w1_1_start113,TSPA,73605,25228,48377,3,100,200
GreedyLS_Nodes_NearestNeighborAny2Regret_w1_1_start114,TSPA,70217,22721,47496,5,100,200
GreedyLS_Nodes_NearestNeighborAny2Regret_w1_1_start115,TSPA,71783,24125,47658,6,100,200
GreedyLS_Nodes_NearestNeighborAny2Regret_w1_1_start116,TSPA,72149,24079,48070,4,100,200
GreedyLS_Nodes_NearestNeighborAny2Regret_w1_1_start117,TSPA,70217,22721,47496,5,100,200
GreedyLS_Nodes_NearestNeighborAny2Regret_w1_1_start118,TSPA,74201,26233,47968,5,100,200
GreedyLS_Nodes_NearestNeighborAny2Regret_w1_1_start119,TSPA,72976,24998,47978,6,100,200
GreedyLS_Nodes_NearestNeighborAny2Regret_w1_1_start120,TSPA,70641,22384,48257,4,100,200
GreedyLS_Nodes_NearestNeighborAny2Regret_w1_1_start121,TSPA,70570,21993,48577,5,100,200
GreedyLS_Nodes_NearestNeighborAny2Regret_w1_1_start122,TSPA,73156,24558,48598,3,100,200
GreedyLS_Nodes_NearestNeighborAny2Regret_w1_1_start123,TSPA,70641,22384,48257,5,100,200
GreedyLS_Nodes_NearestNeighborAny2Regret_w1_1_start124,TSPA,71669,23854,47815,4,100,200
GreedyLS_Nodes_NearestNeighborAny2Regret_w1_1_start125,TSPA,70836,21912,48924,10,100,200
GreedyLS_Nodes_NearestNeighborAny2Regret_w1_1_start126,TSPA,70454,22200,48254,7,100,200
GreedyLS_Nodes_NearestNeighborAny2Regret_w1_1_start127,TSPA,70641,22384,48257,5,100,200
GreedyLS_Nodes_NearestNeighborAny2Regret_w1_1_start128,TSPA,71602,23193,48409,8,100,200
GreedyLS_Nodes_NearestNeighborAny2Regret_w1_1_start129,TSPA,71356,23156,48200,6,100,200
GreedyLS_Nodes_NearestNeighborAny2Regret_w1_1_start130,TSPA,72187,23555,48632,9,100,200
GreedyLS_Nodes_NearestNeighborAny2Regret_w1_1_start131,TSPA,71798,23637,48161,7,100,200
GreedyLS_Nodes_NearestNeighborAny2Regret_w1_1_start132,TSPA,70964,23282,47682,12,100,200
GreedyLS_Nodes_NearestNeighborAny2Regret_w1_1_start133,TSPA,71878,24169,47709,6,100,200
GreedyLS_Nodes_NearestNeighborAny2Regret_w1_1_start134,TSPA,70641,22384,48257,7,100,200
GreedyLS_Nodes_NearestNeighborAny2Regret_w1_1_start135,TSPA,70641,22384,48257,5,100,200
GreedyLS_Nodes_NearestNeighborAny2Regret_w1_1_start136,TSPA,73201,24624,48577,6,100,200
GreedyLS_Nodes_NearestNeighborAny2Regret_w1_1_start137,TSPA,72854,24477,48377,4,100,200
GreedyLS_Nodes_NearestNeighborAny2Regret_w1_1_start138,TSPA,73616,25430,48186,9,100,200
GreedyLS_Nodes_NearestNeighborAny2Regret_w1_1_start139,TSPA,71878,24169,47709,6,100,200
GreedyLS_Nodes_NearestNeighborAny2Regret_w1_1_start140,TSPA,72006,23883,48123,5,100,200
GreedyLS_Nodes_NearestNeighborAny2Regret_w1_1_start141,TSPA,72094,23895,48199,8,100,200
GreedyLS_Nodes_NearestNeighborAny2Regret_w1_1_start142,TSPA,70746,22118,48628,7,100,200
GreedyLS_Nodes_NearestNeighborAny2Regret_w1_1_start143,TSPA,70217,22721,47496,6,100,200
GreedyLS_Nodes_NearestNeighborAny2Regret_w1_1_start144,TSPA,70217,22721,47496,5,100,200
GreedyLS_Nodes_NearestNeighborAny2Regret_w1_1_start145,TSPA,70641,22384,48257,6,100,200
GreedyLS_Nodes_NearestNeighborAny2Regret_w1_1_start146,TSPA,71617,23587,48030,5,100,200
GreedyLS_Nodes_NearestNeighborAny2Regret_w1_1_start147,TSPA,72469,24258,48211,11,100,200
GreedyLS_Nodes_NearestNeighborAny2Regret_w1_1_start148,TSPA,72149,24079,48070,5,100,200
GreedyLS_Nodes_NearestNeighborAny2Regret_w1_1_start149,TSPA,70764,22233,48531,5,100,200
GreedyLS_Nodes_NearestNeighborAny2Regret_w1_1_start150,TSPA,73127,24621,48506,14,100,200
GreedyLS_Nodes_NearestNeighborAny2Regret_w1_1_start151,TSPA,70979,23058,47921,6,100,200
GreedyLS_Nodes_NearestNeighborAny2Regret_w1_1_start152,TSPA,71668,23498,48170,4,100,200
GreedyLS_Nodes_NearestNeighborAny2Regret_w1_1_start153,TSPA,70499,22692,47807,7,100,200
GreedyLS_Nodes_NearestNeighborAny2Regret_w1_1_start154,TSPA,70641,22384,48257,5,100,200
GreedyLS_Nodes_NearestNeighborAny2Regret_w1_1_start155,TSPA,74109,25665,48444,6,100,200
GreedyLS_Nodes_NearestNeighborAny2Regret_w1_1_start156,TSPA,71032,22552,48480,8,100,200
GreedyLS_Nodes_NearestNeighborAny2Regret_w1_1_start157,TSPA,74313,25622,48691,6,100,200
GreedyLS_Nodes_NearestNeighborAny2Regret_w1_1_start158,TSPA,70616,21917,48699,6,100,200
GreedyLS_Nodes_NearestNeighborAny2Regret_w1_1_start159,TSPA,72149,24079,48070,5,100,200
GreedyLS_Nodes_NearestNeighborAny2Regret_w1_1_start160,TSPA,73249,25283,47966,7,100,200
GreedyLS_Nodes_NearestNeighborAny2Regret_w1_1_start161,TSPA,71307,23386,47921,10,100,200
GreedyLS_Nodes_NearestNeighborAny2Regret_w1_1_start162,TSPA,70979,23058,47921,7,100,200
GreedyLS_Nodes_NearestNeighborAny2Regret_w1_1_start163,TSPA,71878,24169,47709,8,100,200
GreedyLS_Nodes_NearestNeighborAny2Regret_w1_1_start164,TSPA,73295,25112,48183,6,100,200
GreedyLS_Nodes_NearestNeighborAny2Regret_w1_1_start165,TSPA,72930,25077,47853,6,100,200
GreedyLS_Nodes_NearestNeighborAny2Regret_w1_1_start166,TSPA,74053,26055,47998,8,100,200
GreedyLS_Nodes_NearestNeighborAny2Regret_w1_1_start167,TSPA,72176,24014,48162,6,100,200
GreedyLS_Nodes_NearestNeighborAny2Regret_w1_1_start168,TSPA,71190,23442,47748,6,100,200
GreedyLS_Nodes_NearestNeighborAny2Regret_w1_1_start169,TSPA,73561,25312,48249,8,100,200
GreedyLS_Nodes_NearestNeighborAny2Regret_w1_1_start170,TSPA,70492,22622,47870,5,100,200
GreedyLS_Nodes_NearestNeighborAny2Regret_w1_1_start171,TSPA,74657,26280,48377,4,100,200
GreedyLS_Nodes_NearestNeighborAny2Regret_w1_1_start172,TSPA,72881,24510,48371,8,100,200
GreedyLS_Nodes_NearestNeighborAny2Regret_w1_1_start173,TSPA,70674,22036,48638,9,100,200
GreedyLS_Nodes_NearestNeighborAny2Regret_w1_1_start174,TSPA,73510,25393,48117,10,100,200
GreedyLS_Nodes_NearestNeighborAny2Regret_w1_1_start175,TSPA,74657,26280,48377,4,100,200
GreedyLS_Nodes_NearestNeighborAny2Regret_w1_1_start176,TSPA,72854,24477,48377,4,100,200
GreedyLS_Nodes_NearestNeighborAny2Regret_w1_1_start177,TSPA,71848,23932,47916,6,100,200
GreedyLS_Nodes_NearestNeighborAny2Regret_w1_1_start178,TSPA,73363,25731,47632,8,100,200
GreedyLS_Nodes_NearestNeighborAny2Regret_w1_1_start179,TSPA,74655,26278,48377,3,100,200
GreedyLS_Nodes_NearestNeighborAny2Regret_w1_1_start180,TSPA,70641,22384,48257,5,100,200
GreedyLS_Nodes_NearestNeighborAny2Regret_w1_1_start181,TSPA,73676,26044,47632,13,100,200
GreedyLS_Nodes_NearestNeighborAny2Regret_w1_1_start182,TSPA,73201,24624,48577,6,100,200
GreedyLS_Nodes_NearestNeighborAny2Regret_w1_1_start183,TSPA,70217,22721,47496,6,100,200
GreedyLS_Nodes_NearestNeighborAny2Regret_w1_1_start184,TSPA,70595,22590,48005,6,100,200
GreedyLS_Nodes_NearestNeighborAny2Regret_w1_1_start185,TSPA,72930,25077,47853,7,100,200
GreedyLS_Nodes_NearestNeighborAny2Regret_w1_1_start186,TSPA,70235,22443,47792,5,100,200
GreedyLS_Nodes_NearestNeighborAny2Regret_w1_1_start187,TSPA,74451,25963,48488,7,100,200
GreedyLS_Nodes_NearestNeighborAny2Regret_w1_1_start188,TSPA,71207,21759,49448,6,100,200
GreedyLS_Nodes_NearestNeighborAny2Regret_w1_1_start189,TSPA,70602,22157,48445,5,100,200
GreedyLS_Nodes_NearestNeighborAny2Regret_w1_1_start190,TSPA,70102,22308,47794,4,100,200
GreedyLS_Nodes_NearestNeighborAny2Regret_w1_1_start191,TSPA,72044,23677,48367,8,100,200
GreedyLS_Nodes_NearestNeighborAny2Regret_w1_1_start192,TSPA,71901,23763,48138,-4,100,200
GreedyLS_Nodes_NearestNeighborAny2Regret_w1_1_start193,TSPA,71783,24125,47658,7,100,200
GreedyLS_Nodes_NearestNeighborAny2Regret_w1_1_start194,TSPA,71099,22276,48823,4,100,200
GreedyLS_Nodes_NearestNeighborAny2Regret_w1_1_start195,TSPA,71412,22784,48628,5,100,200
GreedyLS_Nodes_NearestNeighborAny2Regret_w1_1_start196,TSPA,71190,23442,47748,4,100,200
GreedyLS_Nodes_NearestNeighborAny2Regret_w1_1_start197,TSPA,73226,25388,47838,10,100,200
GreedyLS_Nodes_NearestNeighborAny2Regret_w1_1_start198,TSPA,71878,24169,47709,5,100,200
GreedyLS_Nodes_NearestNeighborAny2Regret_w1_1_start199,TSPA,70914,22124,48790,5,100,200
GreedyLS_Edges_Random_start0,TSPA,74485,24781,49704,230,100,200
GreedyLS_Edges_Random_start1,TSPA,74045,23622,50423,217,100,200
GreedyLS_Edges_Random_start2,TSPA,75419,23246,52173,189,100,200
GreedyLS_Edges_Random_start3,TSPA,74044,23768,50276,225,100,200
GreedyLS_Edges_Random_start4,TSPA,74682,22723,51959,184,100,200
GreedyLS_Edges_Random_start5,TSPA,73809,24629,49180,187,100,200
GreedyLS_Edges_Random_start6,TSPA,73146,21760,51386,200,100,200
GreedyLS_Edges_Random_start7,TSPA,73949,24524,49425,201,100,200
GreedyLS_Edges_Random_start8,TSPA,71809,22521,49288,216,100,200
GreedyLS_Edges_Random_start9,TSPA,72665,23974,48691,203,100,200
GreedyLS_Edges_Random_start10,TSPA,73931,22809,51122,209,100,200
GreedyLS_Edges_Random_start11,TSPA,74199,23810,50389,232,100,200
GreedyLS_Edges_Random_start12,TSPA,73617,24799,48818,203,100,200
GreedyLS_Edges_Random_start13,TSPA,73605,23881,49724,209,100,200
GreedyLS_Edges_Random_start14,TSPA,72200,23309,48891,210,100,200
GreedyLS_Edges_Random_start15,TSPA,73000,23713,49287,205,100,200
GreedyLS_Edges_Random_start16,TSPA,74403,22862,51541,193,100,200
GreedyLS_Edges_Random_start17,TSPA,72969,24192,48777,193,100,200
GreedyLS_Edges_Random_start18,TSPA,73952,23857,50095,203,100,200
GreedyLS_Edges_Random_start19,TSPA,73539,24444,49095,214,100,200
GreedyLS_Edges_Random_start20,TSPA,74803,24321,50482,189,100,200
GreedyLS_Edges_Random_start21,TSPA,73773,24437,49336,206,100,200
GreedyLS_Edges_Random_start22,TSPA,73247,22886,50361,213,100,200
GreedyLS_Edges_Random_start23,TSPA,74923,23901,51022,203,100,200
GreedyLS_Edges_Random_start24,TSPA,72671,23413,49258,221,100,200
GreedyLS_Edges_Random_start25,TSPA,74474,22435,52039,196,100,200
GreedyLS_Edges_Random_start26,TSPA,75185,24159,51026,218,100,200
GreedyLS_Edges_Random_start27,TSPA,72823,23218,49605,197,100,200
GreedyLS_Edges_Random_start28,TSPA,73995,21873,52122,217,100,200
GreedyLS_Edges_Random_start29,TSPA,74201,23711,50490,212,100,200
GreedyLS_Edges_Random_start30,TSPA,73031,23181,49850,186,100,200
GreedyLS_Edges_Random_start31,TSPA,73444,23631,49813,208,100,200
GreedyLS_Edges_Random_start32,TSPA,75043,22989,52054,223,100,200
GreedyLS_Edges_Random_start33,TSPA,74062,23823,50239,199,100,200
GreedyLS_Edges_Random_start34,TSPA,73223,23610,49613,211,100,200
GreedyLS_Edges_Random_start35,TSPA,74485,24495,49990,185,100,200
GreedyLS_Edges_Random_start36,TSPA,74733,22517,52216,191,100,200
GreedyLS_Edges_Random_start37,TSPA,72690,23254,49436,210,100,200
GreedyLS_Edges_Random_start38,TSPA,74416,22338,52078,207,100,200
GreedyLS_Edges_Random_start39,TSPA,72007,22361,49646,218,100,200
GreedyLS_Edges_Random_start40,TSPA,75479,23302,52177,217,100,200
GreedyLS_Edges_Random_start41,TSPA,75448,23360,52088,205,100,200
GreedyLS_Edges_Random_start42,TSPA,75300,23209,52091,197,100,200
GreedyLS_Edges_Random_start43,TSPA,74110,25158,48952,212,100,200
GreedyLS_Edges_Random_start44,TSPA,73458,22943,50515,210,100,200
GreedyLS_Edges_Random_start45,TSPA,74262,24804,49458,188,100,200
GreedyLS_Edges_Random_start46,TSPA,72360,23149,49211,195,100,200
GreedyLS_Edges_Random_start47,TSPA,74369,23231,51138,186,100,200
GreedyLS_Edges_Random_start48,TSPA,74748,24411,50337,186,100,200
GreedyLS_Edges_Random_start49,TSPA,73872,24332,49540,207,100,200
GreedyLS_Edges_Random_start50,TSPA,73336,24303,49033,199,100,200
GreedyLS_Edges_Random_start51,TSPA,72787,23550,49237,213,100,200
GreedyLS_Edges_Random_start52,TSPA,74453,23193,51260,204,100,200
GreedyLS_Edges_Random_start53,TSPA,74338,25122,49216,196,100,200
GreedyLS_Edges_Random_start54,TSPA,75684,23721,51963,214,100,200
GreedyLS_Edges_Random_start55,TSPA,71610,22534,49076,213,100,200
GreedyLS_Edges_Random_start56,TSPA,73339,23201,50138,225,100,200
GreedyLS_Edges_Random_start57,TSPA,75346,24455,50891,194,100,200
GreedyLS_Edges_Random_start58,TSPA,73771,24274,49497,198,100,200
GreedyLS_Edges_Random_start59,TSPA,74479,23543,50936,209,100,200
GreedyLS_Edges_Random_start60,TSPA,74336,23137,51199,197,100,200
GreedyLS_Edges_Random_start61,TSPA,73470,23175,50295,222,100,200
GreedyLS_Edges_Random_start62,TSPA,73462,22992,50470,207,100,200
GreedyLS_Edges_Random_start63,TSPA,73429,24345,49084,230,100,200
GreedyLS_Edges_Random_start64,TSPA,74624,23680,50944,201,100,200
GreedyLS_Edges_Random_start65,TSPA,76883,24304,52579,200,100,200
GreedyLS_Edges_Random_start66,TSPA,74836,23871,50965,190,100,200
GreedyLS_Edges_Random_start67,TSPA,75527,24751,50776,218,100,200
GreedyLS_Edges_Random_start68,TSPA,76177,25237,50940,196,100,200
GreedyLS_Edges_Random_start69,TSPA,73576,24210,49366,204,100,200
GreedyLS_Edges_Random_start70,TSPA,74756,23997,50759,190,100,200
GreedyLS_Edges_Random_start71,TSPA,73448,23826,49622,207,100,200
GreedyLS_Edges_Random_start72,TSPA,73708,23512,50196,205,100,200
GreedyLS_Edges_Random_start73,TSPA,73727,24766,48961,201,100,200
GreedyLS_Edges_Random_start74,TSPA,73873,23016,50857,216,100,200
GreedyLS_Edges_Random_start75,TSPA,73803,23688,50115,225,100,200
GreedyLS_Edges_Random_start76,TSPA,74916,23683,51233,180,100,200
GreedyLS_Edges_Random_start77,TSPA,72582,23132,49450,212,100,200
GreedyLS_Edges_Random_start78,TSPA,73853,24084,49769,215,100,200
GreedyLS_Edges_Random_start79,TSPA,72578,22601,49977,185,100,200
GreedyLS_Edges_Random_start80,TSPA,73994,24503,49491,208,100,200
GreedyLS_Edges_Random_start81,TSPA,74264,24185,50079,207,100,200
GreedyLS_Edges_Random_start82,TSPA,74702,25307,49395,201,100,200
GreedyLS_Edges_Random_start83,TSPA,72640,23257,49383,203,100,200
GreedyLS_Edges_Random_start84,TSPA,73414,24060,49354,220,100,200
GreedyLS_Edges_Random_start85,TSPA,72741,21703,51038,213,100,200
GreedyLS_Edges_Random_start86,TSPA,72630,22354,50276,228,100,200
GreedyLS_Edges_Random_start87,TSPA,74574,22978,51596,240,100,200
GreedyLS_Edges_Random_start88,TSPA,74587,23509,51078,210,100,200
GreedyLS_Edges_Random_start89,TSPA,72481,23603,48878,222,100,200
GreedyLS_Edges_Random_start90,TSPA,74085,23845,50240,184,100,200
GreedyLS_Edges_Random_start91,TSPA,73416,23129,50287,216,100,200
GreedyLS_Edges_Random_start92,TSPA,73105,24176,48929,218,100,200
GreedyLS_Edges_Random_start93,TSPA,75703,24616,51087,200,100,200
GreedyLS_Edges_Random_start94,TSPA,74504,23594,50910,200,100,200
GreedyLS_Edges_Random_start95,TSPA,74462,23717,50745,212,100,200
GreedyLS_Edges_Random_start96,TSPA,72168,23992,48176,204,100,200
GreedyLS_Edges_Random_start97,TSPA,73671,23680,49991,184,100,200
GreedyLS_Edges_Random_start98,TSPA,73614,23003,50611,218,100,200
GreedyLS_Edges_Random_start99,TSPA,74009,23749,50260,185,100,200
GreedyLS_Edges_Random_start100,TSPA,74278,23257,51021,208,100,200
GreedyLS_Edges_Random_start101,TSPA,73859,24457,49402,201,100,200
GreedyLS_Edges_Random_start102,TSPA,75378,24058,51320,209,100,200
GreedyLS_Edges_Random_start103,TSPA,74620,25210,49410,214,100,200
GreedyLS_Edges_Random_start104,TSPA,73151,22789,50362,188,100,200
GreedyLS_Edges_Random_start105,TSPA,73844,24678,49166,199,100,200
GreedyLS_Edges_Random_start106,TSPA,75558,23849,51709,196,100,200
GreedyLS_Edges_Random_start107,TSPA,72936,22940,49996,203,100,200
GreedyLS_Edges_Random_start108,TSPA,74398,25159,49239,220,100,200
GreedyLS_Edges_Random_start109,TSPA,73268,23566,49702,192,100,200
GreedyLS_Edges_Random_start110,TSPA,73857,24124,49733,207,100,200
GreedyLS_Edges_Random_start111,TSPA,74008,22766,51242,224,100,200
GreedyLS_Edges_Random_start112,TSPA,72566,22809,49757,216,100,200
GreedyLS_Edges_Random_start113,TSPA,71664,22211,49453,227,100,200
GreedyLS_Edges_Random_start114,TSPA,73966,24079,49887,223,100,200
GreedyLS_Edges_Random_start115,TSPA,74811,23926,50885,199,100,200
GreedyLS_Edges_Random_start116,TSPA,73574,23876,49698,225,100,200
GreedyLS_Edges_Random_start117,TSPA,73360,24383,48977,218,100,200
GreedyLS_Edges_Random_start118,TSPA,74813,23596,51217,204,100,200
GreedyLS_Edges_Random_start119,TSPA,73829,23833,49996,221,100,200
GreedyLS_Edges_Random_start120,TSPA,74593,25008,49585,199,100,200
GreedyLS_Edges_Random_start121,TSPA,73069,22741,50328,222,100,200
GreedyLS_Edges_Random_start122,TSPA,73340,23953,49387,195,100,200
GreedyLS_Edges_Random_start123,TSPA,74117,23557,50560,197,100,200
GreedyLS_Edges_Random_start124,TSPA,76352,24175,52177,208,100,200
GreedyLS_Edges_Random_start125,TSPA,74218,23295,50923,213,100,200
GreedyLS_Edges_Random_start126,TSPA,72600,23502,49098,186,100,200
GreedyLS_Edges_Random_start127,TSPA,72820,23777,49043,202,100,200
GreedyLS_Edges_Random_start128,TSPA,71712,22893,48819,254,100,200
GreedyLS_Edges_Random_start129,TSPA,71805,22394,49411,203,100,200
GreedyLS_Edges_Random_start130,TSPA,75397,25005,50392,206,100,200
GreedyLS_Edges_Random_start131,TSPA,75001,25475,49526,213,100,200
GreedyLS_Edges_Random_start132,TSPA,74936,23552,51384,210,100,200
GreedyLS_Edges_Random_start133,TSPA,75013,23069,51944,209,100,200
GreedyLS_Edges_Random_start134,TSPA,74841,24091,50750,203,100,200
GreedyLS_Edges_Random_start135,TSPA,75397,25530,49867,199,100,200
GreedyLS_Edges_Random_start136,TSPA,75193,23653,51540,193,100,200
GreedyLS_Edges_Random_start137,TSPA,74365,23805,50560,212,100,200
GreedyLS_Edges_Random_start138,TSPA,74338,24593,49745,223,100,200
GreedyLS_Edges_Random_start139,TSPA,73004,22692,50312,202,100,200
GreedyLS_Edges_Random_start140,TSPA,73840,23421,50419,197,100,200
GreedyLS_Edges_Random_start141,TSPA,72836,23361,49475,216,100,200
GreedyLS_Edges_Random_start142,TSPA,71936,23057,48879,224,100,200
GreedyLS_Edges_Random_start143,TSPA,73614,23510,50104,217,100,200
GreedyLS_Edges_Random_start144,TSPA,73302,24379,48923,183,100,200
GreedyLS_Edges_Random_start145,TSPA,72665,22779,49886,206,100,200
GreedyLS_Edges_Random_start146,TSPA,75572,24047,51525,196,100,200
GreedyLS_Edges_Random_start147,TSPA,73146,23503,49643,205,100,200
GreedyLS_Edges_Random_start148,TSPA,73127,24006,49121,195,100,200
GreedyLS_Edges_Random_start149,TSPA,73274,24083,49191,209,100,200
GreedyLS_Edges_Random_start150,TSPA,73470,24230,49240,206,100,200
GreedyLS_Edges_Random_start151,TSPA,74114,24239,49875,183,100,200
GreedyLS_Edges_Random_start152,TSPA,72987,22689,50298,202,100,200
GreedyLS_Edges_Random_start153,TSPA,75464,25647,49817,182,100,200
GreedyLS_Edges_Random_start154,TSPA,73409,24162,49247,204,100,200
GreedyLS_Edges_Random_start155,TSPA,75492,25465,50027,185,100,200
GreedyLS_Edges_Random_start156,TSPA,74512,25182,49330,193,100,200
GreedyLS_Edges_Random_start157,TSPA,73220,24279,48941,212,100,200
GreedyLS_Edges_Random_start158,TSPA,72435,23950,48485,204,100,200
GreedyLS_Edges_Random_start159,TSPA,73976,24050,49926,215,100,200
GreedyLS_Edges_Random_start160,TSPA,72990,24123,48867,208,100,200
GreedyLS_Edges_Random_start161,TSPA,74392,23339,51053,216,100,200
GreedyLS_Edges_Random_start162,TSPA,72610,23855,48755,185,100,200
GreedyLS_Edges_Random_start163,TSPA,72830,23964,48866,219,100,200
GreedyLS_Edges_Random_start164,TSPA,73236,23524,49712,211,100,200
GreedyLS_Edges_Random_start165,TSPA,72645,23049,49596,204,100,200
GreedyLS_Edges_Random_start166,TSPA,73546,24683,48863,211,100,200
GreedyLS_Edges_Random_start167,TSPA,75241,23147,52094,193,100,200
GreedyLS_Edges_Random_start168,TSPA,73078,23041,50037,209,100,200
GreedyLS_Edges_Random_start169,TSPA,72736,22879,49857,209,100,200
GreedyLS_Edges_Random_start170,TSPA,72368,23289,49079,207,100,200
GreedyLS_Edges_Random_start171,TSPA,73580,23507,50073,212,100,200
GreedyLS_Edges_Random_start172,TSPA,73833,23521,50312,219,100,200
GreedyLS_Edges_Random_start173,TSPA,72859,23019,49840,220,100,200
GreedyLS_Edges_Random_start174,TSPA,75099,24889,50210,196,100,200
GreedyLS_Edges_Random_start175,TSPA,74089,23477,50612,200,100,200
GreedyLS_Edges_Random_start176,TSPA,75031,25283,49748,207,100,200
GreedyLS_Edges_Random_start177,TSPA,72847,23867,48980,195,100,200
GreedyLS_Edges_Random_start178,TSPA,73541,24049,49492,234,100,200
GreedyLS_Edges_Random_start179,TSPA,72824,24090,48734,197,100,200
GreedyLS_Edges_Random_start180,TSPA,74025,24615,49410,210,100,200
GreedyLS_Edges_Random_start181,TSPA,74666,23842,50824,193,100,200
GreedyLS_Edges_Random_start182,TSPA,74541,23741,50800,194,100,200
GreedyLS_Edges_Random_start183,TSPA,74323,23583,50740,203,100,200
GreedyLS_Edges_Random_start184,TSPA,74088,24496,49592,213,100,200
GreedyLS_Edges_Random_start185,TSPA,72810,23495,49315,212,100,200
GreedyLS_Edges_Random_start186,TSPA,74930,25694,49236,205,100,200
GreedyLS_Edges_Random_start187,TSPA,75140,24510,50630,196,100,200
GreedyLS_Edges_Random_start188,TSPA,71444,21995,49449,225,100,200
GreedyLS_Edges_Random_start189,TSPA,73485,22175,51310,215,100,200
GreedyLS_Edges_Random_start190,TSPA,74321,24313,50008,216,100,200
GreedyLS_Edges_Random_start191,TSPA,72673,23246,49427,208,100,200
GreedyLS_Edges_Random_start192,TSPA,72860,23273,49587,216,100,200
GreedyLS_Edges_Random_start193,TSPA,72668,23299,49369,209,100,200
GreedyLS_Edges_Random_start194,TSPA,75149,23124,52025,218,100,200
GreedyLS_Edges_Random_start195,TSPA,76520,26875,49645,210,100,200
GreedyLS_Edges_Random_start196,TSPA,73202,23942,49260,209,100,200
GreedyLS_Edges_Random_start197,TSPA,73655,23631,50024,238,100,200
GreedyLS_Edges_Random_start198,TSPA,74518,24538,49980,196,100,200
GreedyLS_Edges_Random_start199,TSPA,73072,24547,48525,203,100,200
GreedyLS_Edges_NearestNeighborAny2Regret_w1_1_start0,TSPA,69497,22001,47496,11,100,200
GreedyLS_Edges_NearestNeighborAny2Regret_w1_1_start1,TSPA,70641,22384,48257,5,100,200
GreedyLS_Edges_NearestNeighborAny2Regret_w1_1_start2,TSPA,70641,22384,48257,5,100,200
GreedyLS_Edges_NearestNeighborAny2Regret_w1_1_start3,TSPA,71065,22879,48186,15,100,200
GreedyLS_Edges_NearestNeighborAny2Regret_w1_1_start4,TSPA,70152,22156,47996,4,100,200
GreedyLS_Edges_NearestNeighborAny2Regret_w1_1_start5,TSPA,70641,22384,48257,6,100,200
GreedyLS_Edges_NearestNeighborAny2Regret_w1_1_start6,TSPA,70623,22046,48577,11,100,200
GreedyLS_Edges_NearestNeighborAny2Regret_w1_1_start7,TSPA,71501,23793,47708,12,100,200
GreedyLS_Edges_NearestNeighborAny2Regret_w1_1_start8,TSPA,71934,23849,48085,14,100,200
GreedyLS_Edges_NearestNeighborAny2Regret_w1_1_start9,TSPA,71322,22923,48399,16,100,200
GreedyLS_Edges_NearestNeighborAny2Regret_w1_1_start10,TSPA,71339,23065,48274,14,100,200
GreedyLS_Edges_NearestNeighborAny2Regret_w1_1_start11,TSPA,70595,22590,48005,7,100,200
GreedyLS_Edges_NearestNeighborAny2Regret_w1_1_start12,TSPA,71368,22874,48494,9,100,200
GreedyLS_Edges_NearestNeighborAny2Regret_w1_1_start13,TSPA,70870,22351,48519,16,100,200
GreedyLS_Edges_NearestNeighborAny2Regret_w1_1_start14,TSPA,71244,23058,48186,21,100,200
GreedyLS_Edges_NearestNeighborAny2Regret_w1_1_start15,TSPA,69613,22117,47496,8,100,200
GreedyLS_Edges_NearestNeighborAny2Regret_w1_1_start16,TSPA,71286,22004,49282,13,100,200
GreedyLS_Edges_NearestNeighborAny2Regret_w1_1_start17,TSPA,70892,22203,48689,5,100,200
GreedyLS_Edges_NearestNeighborAny2Regret_w1_1_start18,TSPA,70641,22384,48257,6,100,200
GreedyLS_Edges_NearestNeighborAny2Regret_w1_1_start19,TSPA,70703,22126,48577,5,100,200
GreedyLS_Edges_NearestNeighborAny2Regret_w1_1_start20,TSPA,71809,23244,48565,8,100,200
GreedyLS_Edges_NearestNeighborAny2Regret_w1_1_start21,TSPA,70878,22382,48496,16,100,200
GreedyLS_Edges_NearestNeighborAny2Regret_w1_1_start22,TSPA,70939,22869,48070,11,100,200
GreedyLS_Edges_NearestNeighborAny2Regret_w1_1_start23,TSPA,71422,23045,48377,10,100,200
GreedyLS_Edges_NearestNeighborAny2Regret_w1_1_start24,TSPA,70300,22156,48144,5,100,200
GreedyLS_Edges_NearestNeighborAny2Regret_w1_1_start25,TSPA,70641,22384,48257,6,100,200
GreedyLS_Edges_NearestNeighborAny2Regret_w1_1_start26,TSPA,70570,21993,48577,4,100,200
GreedyLS_Edges_NearestNeighborAny2Regret_w1_1_start27,TSPA,71857,23010,48847,18,100,200
GreedyLS_Edges_NearestNeighborAny2Regret_w1_1_start28,TSPA,70121,22092,48029,6,100,200
GreedyLS_Edges_NearestNeighborAny2Regret_w1_1_start29,TSPA,71289,23094,48195,11,100,200
GreedyLS_Edges_NearestNeighborAny2Regret_w1_1_start30,TSPA,71251,23215,48036,10,100,200
GreedyLS_Edges_NearestNeighborAny2Regret_w1_1_start31,TSPA,71344,23001,48343,15,100,200
GreedyLS_Edges_NearestNeighborAny2Regret_w1_1_start32,TSPA,71806,23488,48318,13,100,200
GreedyLS_Edges_NearestNeighborAny2Regret_w1_1_start33,TSPA,71463,22295,49168,13,100,200
GreedyLS_Edges_NearestNeighborAny2Regret_w1_1_start34,TSPA,70947,22981,47966,17,100,200
GreedyLS_Edges_NearestNeighborAny2Regret_w1_1_start35,TSPA,69801,21778,48023,5,100,200
GreedyLS_Edges_NearestNeighborAny2Regret_w1_1_start36,TSPA,71689,22843,48846,8,100,200
GreedyLS_Edges_NearestNeighborAny2Regret_w1_1_start37,TSPA,71792,23663,48129,8,100,200
GreedyLS_Edges_NearestNeighborAny2Regret_w1_1_start38,TSPA,72566,24271,48295,14,100,200
GreedyLS_Edges_NearestNeighborAny2Regret_w1_1_start39,TSPA,70670,22557,48113,11,100,200
GreedyLS_Edges_NearestNeighborAny2Regret_w1_1_start40,TSPA,71749,23896,47853,14,100,200
GreedyLS_Edges_NearestNeighborAny2Regret_w1_1_start41,TSPA,70870,23274,47596,9,100,200
GreedyLS_Edges_NearestNeighborAny2Regret_w1_1_start42,TSPA,70641,22384,48257,5,100,200
GreedyLS_Edges_NearestNeighborAny2Regret_w1_1_start43,TSPA,71598,23471,48127,14,100,200
GreedyLS_Edges_NearestNeighborAny2Regret_w1_1_start44,TSPA,70641,22384,48257,7,100,200
GreedyLS_Edges_NearestNeighborAny2Regret_w1_1_start45,TSPA,71365,22975,48390,12,100,200
GreedyLS_Edges_NearestNeighborAny2Regret_w1_1_start46,TSPA,69497,22001,47496,8,100,200
GreedyLS_Edges_NearestNeighborAny2Regret_w1_1_start47,TSPA,71632,23293,48339,19,100,200
GreedyLS_Edges_NearestNeighborAny2Regret_w1_1_start48,TSPA,72195,22809,49386,9,100,200
GreedyLS_Edges_NearestNeighborAny2Regret_w1_1_start49,TSPA,69540,22044,47496,6,100,200
GreedyLS_Edges_NearestNeighborAny2Regret_w1_1_start50,TSPA,70586,21897,48689,7,100,200
GreedyLS_Edges_NearestNeighborAny2Regret_w1_1_start51,TSPA,71014,23418,47596,13,100,200
GreedyLS_Edges_NearestNeighborAny2Regret_w1_1_start52,TSPA,71976,23711,48265,14,100,200
GreedyLS_Edges_NearestNeighborAny2Regret_w1_1_start53,TSPA,70641,22384,48257,6,100,200
GreedyLS_Edges_NearestNeighborAny2Regret_w1_1_start54,TSPA,70152,22156,47996,4,100,200
GreedyLS_Edges_NearestNeighborAny2Regret_w1_1_start55,TSPA,71940,23472,48468,11,100,200
GreedyLS_Edges_NearestNeighborAny2Regret_w1_1_start56,TSPA,72237,23132,49105,12,100,200
GreedyLS_Edges_NearestNeighborAny2Regret_w1_1_start57,TSPA,72850,24557,48293,13,100,200
GreedyLS_Edges_NearestNeighborAny2Regret_w1_1_start58,TSPA,70907,21733,49174,15,100,200
GreedyLS_Edges_NearestNeighborAny2Regret_w1_1_start59,TSPA,70491,22421,48070,19,100,200
GreedyLS_Edges_NearestNeighborAny2Regret_w1_1_start60,TSPA,70642,21747,48895,9,100,200
GreedyLS_Edges_NearestNeighborAny2Regret_w1_1_start61,TSPA,69733,21944,47789,10,100,200
GreedyLS_Edges_NearestNeighborAny2Regret_w1_1_start62,TSPA,69871,22107,47764,26,100,200
GreedyLS_Edges_NearestNeighborAny2Regret_w1_1_start63,TSPA,70628,22251,48377,18,100,200
GreedyLS_Edges_NearestNeighborAny2Regret_w1_1_start64,TSPA,70303,22098,48205,13,100,200
GreedyLS_Edges_NearestNeighborAny2Regret_w1_1_start65,TSPA,70944,22874,48070,13,100,200
GreedyLS_Edges_NearestNeighborAny2Regret_w1_1_start66,TSPA,71063,22305,48758,14,100,200
GreedyLS_Edges_NearestNeighborAny2Regret_w1_1_start67,TSPA,70478,22371,48107,5,100,200
GreedyLS_Edges_NearestNeighborAny2Regret_w1_1_start68,TSPA,70818,22695,48123,15,100,200
GreedyLS_Edges_NearestNeighborAny2Regret_w1_1_start69,TSPA,71337,23104,48233,10,100,200
GreedyLS_Edges_NearestNeighborAny2Regret_w1_1_start70,TSPA,70641,22384,48257,5,100,200
GreedyLS_Edges_NearestNeighborAny2Regret_w1_1_start71,TSPA,71878,23953,47925,14,100,200
GreedyLS_Edges_NearestNeighborAny2Regret_w1_1_start72,TSPA,71779,23106,48673,18,100,200
GreedyLS_Edges_NearestNeighborAny2Regret_w1_1_start73,TSPA,70026,22035,47991,14,100,200
GreedyLS_Edges_NearestNeighborAny2Regret_w1_1_start74,TSPA,71306,22084,49222,9,100,200
GreedyLS_Edges_NearestNeighborAny2Regret_w1_1_start75,TSPA,70809,22232,48577,5,100,200
GreedyLS_Edges_NearestNeighborAny2Regret_w1_1_start76,TSPA,71201,22747,48454,9,100,200
GreedyLS_Edges_NearestNeighborAny2Regret_w1_1_start77,TSPA,71472,22754,48718,16,100,200
GreedyLS_Edges_NearestNeighborAny2Regret_w1_1_start78,TSPA,70641,22384,48257,4,100,200
GreedyLS_Edges_NearestNeighborAny2Regret_w1_1_start79,TSPA,70584,22207,48377,9,100,200
GreedyLS_Edges_NearestNeighborAny2Regret_w1_1_start80,TSPA,70985,22608,48377,14,100,200
GreedyLS_Edges_NearestNeighborAny2Regret_w1_1_start81,TSPA,72051,23688,48363,17,100,200
GreedyLS_Edges_NearestNeighborAny2Regret_w1_1_start82,TSPA,69972,21843,48129,10,100,200
GreedyLS_Edges_NearestNeighborAny2Regret_w1_1_start83,TSPA,70428,22223,48205,9,100,200
GreedyLS_Edges_NearestNeighborAny2Regret_w1_1_start84,TSPA,70393,22391,48002,5,100,200
GreedyLS_Edges_NearestNeighborAny2Regret_w1_1_start85,TSPA,70735,22543,48192,19,100,200
GreedyLS_Edges_NearestNeighborAny2Regret_w1_1_start86,TSPA,70809,22232,48577,4,100,200
GreedyLS_Edges_NearestNeighborAny2Regret_w1_1_start87,TSPA,71113,22445,48668,10,100,200
GreedyLS_Edges_NearestNeighborAny2Regret_w1_1_start88,TSPA,72027,22298,49729,15,100,200
GreedyLS_Edges_NearestNeighborAny2Regret_w1_1_start89,TSPA,71064,22687,48377,10,100,200
GreedyLS_Edges_NearestNeighborAny2Regret_w1_1_start90,TSPA,72249,24396,47853,14,100,200
GreedyLS_Edges_NearestNeighborAny2Regret_w1_1_start91,TSPA,71709,23550,48159,17,100,200
GreedyLS_Edges_NearestNeighborAny2Regret_w1_1_start92,TSPA,71598,23080,48518,19,100,200
GreedyLS_Edges_NearestNeighborAny2Regret_w1_1_start93,TSPA,70434,22716,47718,13,100,200
GreedyLS_Edges_NearestNeighborAny2Regret_w1_1_start94,TSPA,71030,22993,48037,8,100,200
GreedyLS_Edges_NearestNeighborAny2Regret_w1_1_start95,TSPA,71781,23546,48235,14,100,200
GreedyLS_Edges_NearestNeighborAny2Regret_w1_1_start96,TSPA,71288,22496,48792,9,100,200
GreedyLS_Edges_NearestNeighborAny2Regret_w1_1_start97,TSPA,70641,22384,48257,5,100,200
GreedyLS_Edges_NearestNeighborAny2Regret_w1_1_start98,TSPA,70881,22380,48501,6,100,200
GreedyLS_Edges_NearestNeighborAny2Regret_w1_1_start99,TSPA,70690,22113,48577,9,100,200
GreedyLS_Edges_NearestNeighborAny2Regret_w1_1_start100,TSPA,70570,21993,48577,5,100,200
GreedyLS_Edges_NearestNeighborAny2Regret_w1_1_start101,TSPA,70641,22384,48257,6,100,200
GreedyLS_Edges_NearestNeighborAny2Regret_w1_1_start102,TSPA,70048,22416,47632,19,100,200
GreedyLS_Edges_NearestNeighborAny2Regret_w1_1_start103,TSPA,71490,23460,48030,7,100,200
GreedyLS_Edges_NearestNeighborAny2Regret_w1_1_start104,TSPA,71534,22652,48882,12,100,200
GreedyLS_Edges_NearestNeighborAny2Regret_w1_1_start105,TSPA,71381,23076,48305,19,100,200
GreedyLS_Edges_NearestNeighborAny2Regret_w1_1_start106,TSPA,70242,22610,47632,19,100,200
GreedyLS_Edges_NearestNeighborAny2Regret_w1_1_start107,TSPA,72569,23557,49012,10,100,200
GreedyLS_Edges_NearestNeighborAny2Regret_w1_1_start108,TSPA,71448,23316,48132,5,100,200
GreedyLS_Edges_NearestNeighborAny2Regret_w1_1_start109,TSPA,71084,22754,48330,22,100,200
GreedyLS_Edges_NearestNeighborAny2Regret_w1_1_start110,TSPA,69702,21927,47775,9,100,200
GreedyLS_Edges_NearestNeighborAny2Regret_w1_1_start111,TSPA,71269,22563,48706,6,100,200
GreedyLS_Edges_NearestNeighborAny2Regret_w1_1_start112,TSPA,70393,22391,48002,4,100,200
GreedyLS_Edges_NearestNeighborAny2Regret_w1_1_start113,TSPA,71287,22912,48375,13,100,200
GreedyLS_Edges_NearestNeighborAny2Regret_w1_1_start114,TSPA,69497,22001,47496,10,100,200
GreedyLS_Edges_NearestNeighborAny2Regret_w1_1_start115,TSPA,70929,23147,47782,10,100,200
GreedyLS_Edges_NearestNeighborAny2Regret_w1_1_start116,TSPA,71072,23004,48068,9,100,200
GreedyLS_Edges_NearestNeighborAny2Regret_w1_1_start117,TSPA,69497,22001,47496,9,100,200
GreedyLS_Edges_NearestNeighborAny2Regret_w1_1_start118,TSPA,71340,23372,47968,19,100,200
GreedyLS_Edges_NearestNeighborAny2Regret_w1_1_start119,TSPA,71677,23451,48226,15,100,200
GreedyLS_Edges_NearestNeighborAny2Regret_w1_1_start120,TSPA,70641,22384,48257,5,100,200
GreedyLS_Edges_NearestNeighborAny2Regret_w1_1_start121,TSPA,70570,21993,48577,5,100,200
GreedyLS_Edges_NearestNeighborAny2Regret_w1_1_start122,TSPA,71562,22716,48846,10,100,200
GreedyLS_Edges_NearestNeighborAny2Regret_w1_1_start123,TSPA,70641,22384,48257,5,100,200
GreedyLS_Edges_NearestNeighborAny2Regret_w1_1_start124,TSPA,71137,23322,47815,7,100,200
GreedyLS_Edges_NearestNeighborAny2Regret_w1_1_start125,TSPA,71232,21733,49499,6,100,200
GreedyLS_Edges_NearestNeighborAny2Regret_w1_1_start126,TSPA,70451,21915,48536,6,100,200
GreedyLS_Edges_NearestNeighborAny2Regret_w1_1_start127,TSPA,70641,22384,48257,5,100,200
GreedyLS_Edges_NearestNeighborAny2Regret_w1_1_start128,TSPA,71387,22978,48409,11,100,200
GreedyLS_Edges_NearestNeighborAny2Regret_w1_1_start129,TSPA,70756,22556,48200,7,100,200
GreedyLS_Edges_NearestNeighborAny2Regret_w1_1_start130,TSPA,71601,22969,48632,8,100,200
GreedyLS_Edges_NearestNeighborAny2Regret_w1_1_start131,TSPA,70986,22825,48161,11,100,200
GreedyLS_Edges_NearestNeighborAny2Regret_w1_1_start132,TSPA,69970,21979,47991,11,100,200
GreedyLS_Edges_NearestNeighborAny2Regret_w1_1_start133,TSPA,71058,23400,47658,8,100,200
GreedyLS_Edges_NearestNeighborAny2Regret_w1_1_start134,TSPA,70641,22384,48257,6,100,200
GreedyLS_Edges_NearestNeighborAny2Regret_w1_1_start135,TSPA,70641,22384,48257,5,100,200
GreedyLS_Edges_NearestNeighborAny2Regret_w1_1_start136,TSPA,71837,23260,48577,8,100,200
GreedyLS_Edges_NearestNeighborAny2Regret_w1_1_start137,TSPA,70642,22265,48377,11,100,200
GreedyLS_Edges_NearestNeighborAny2Regret_w1_1_start138,TSPA,70599,22281,48318,18,100,200
GreedyLS_Edges_NearestNeighborAny2Regret_w1_1_start139,TSPA,70962,23253,47709,10,100,200
GreedyLS_Edges_NearestNeighborAny2Regret_w1_1_start140,TSPA,71228,22643,48585,9,100,200
GreedyLS_Edges_NearestNeighborAny2Regret_w1_1_start141,TSPA,71008,22319,48689,9,100,200
GreedyLS_Edges_NearestNeighborAny2Regret_w1_1_start142,TSPA,70914,22124,48790,7,100,200
GreedyLS_Edges_NearestNeighborAny2Regret_w1_1_start143,TSPA,69540,22044,47496,8,100,200
GreedyLS_Edges_NearestNeighborAny2Regret_w1_1_start144,TSPA,69497,22001,47496,10,100,200
GreedyLS_Edges_NearestNeighborAny2Regret_w1_1_start145,TSPA,70641,22384,48257,6,100,200
GreedyLS_Edges_NearestNeighborAny2Regret_w1_1_start146,TSPA,71490,23460,48030,7,100,200
GreedyLS_Edges_NearestNeighborAny2Regret_w1_1_start147,TSPA,71433,22795,48638,14,100,200
GreedyLS_Edges_NearestNeighborAny2Regret_w1_1_start148,TSPA,70882,22812,48070,11,100,200
GreedyLS_Edges_NearestNeighborAny2Regret_w1_1_start149,TSPA,70764,22233,48531,5,100,200
GreedyLS_Edges_NearestNeighborAny2Regret_w1_1_start150,TSPA,71073,22246,48827,24,100,200
GreedyLS_Edges_NearestNeighborAny2Regret_w1_1_start151,TSPA,70863,22942,47921,8,100,200
GreedyLS_Edges_NearestNeighborAny2Regret_w1_1_start152,TSPA,70898,22728,48170,7,100,200
GreedyLS_Edges_NearestNeighborAny2Regret_w1_1_start153,TSPA,69779,21972,47807,11,100,200
GreedyLS_Edges_NearestNeighborAny2Regret_w1_1_start154,TSPA,70641,22384,48257,6,100,200
GreedyLS_Edges_NearestNeighborAny2Regret_w1_1_start155,TSPA,71105,22661,48444,19,100,200
GreedyLS_Edges_NearestNeighborAny2Regret_w1_1_start156,TSPA,70913,22151,48762,10,100,200
GreedyLS_Edges_NearestNeighborAny2Regret_w1_1_start157,TSPA,71261,22376,48885,16,100,200
GreedyLS_Edges_NearestNeighborAny2Regret_w1_1_start158,TSPA,70616,21917,48699,5,100,200
GreedyLS_Edges_NearestNeighborAny2Regret_w1_1_start159,TSPA,71559,23489,48070,9,100,200
GreedyLS_Edges_NearestNeighborAny2Regret_w1_1_start160,TSPA,71543,23577,47966,12,100,200
GreedyLS_Edges_NearestNeighborAny2Regret_w1_1_start161,TSPA,71191,23270,47921,9,100,200
GreedyLS_Edges_NearestNeighborAny2Regret_w1_1_start162,TSPA,70955,23034,47921,9,100,200
GreedyLS_Edges_NearestNeighborAny2Regret_w1_1_start163,TSPA,70616,23020,47596,12,100,200
GreedyLS_Edges_NearestNeighborAny2Regret_w1_1_start164,TSPA,70722,22617,48105,17,100,200
GreedyLS_Edges_NearestNeighborAny2Regret_w1_1_start165,TSPA,71640,23787,47853,18,100,200
GreedyLS_Edges_NearestNeighborAny2Regret_w1_1_start166,TSPA,71079,23034,48045,19,100,200
GreedyLS_Edges_NearestNeighborAny2Regret_w1_1_start167,TSPA,71673,23511,48162,10,100,200
GreedyLS_Edges_NearestNeighborAny2Regret_w1_1_start168,TSPA,70017,22095,47922,10,100,200
GreedyLS_Edges_NearestNeighborAny2Regret_w1_1_start169,TSPA,70786,22537,48249,15,100,200
GreedyLS_Edges_NearestNeighborAny2Regret_w1_1_start170,TSPA,69772,21902,47870,12,100,200
GreedyLS_Edges_NearestNeighborAny2Regret_w1_1_start171,TSPA,71691,23316,48375,14,100,200
GreedyLS_Edges_NearestNeighborAny2Regret_w1_1_start172,TSPA,71466,23268,48198,12,100,200
GreedyLS_Edges_NearestNeighborAny2Regret_w1_1_start173,TSPA,70674,22036,48638,9,100,200
GreedyLS_Edges_NearestNeighborAny2Regret_w1_1_start174,TSPA,70553,22095,48458,20,100,200
GreedyLS_Edges_NearestNeighborAny2Regret_w1_1_start175,TSPA,71534,23253,48281,14,100,200
GreedyLS_Edges_NearestNeighborAny2Regret_w1_1_start176,TSPA,71180,22555,48625,10,100,200
GreedyLS_Edges_NearestNeighborAny2Regret_w1_1_start177,TSPA,70866,22786,48080,16,100,200
GreedyLS_Edges_NearestNeighborAny2Regret_w1_1_start178,TSPA,70428,22233,48195,25,100,200
GreedyLS_Edges_NearestNeighborAny2Regret_w1_1_start179,TSPA,71303,22495,48808,20,100,200
GreedyLS_Edges_NearestNeighborAny2Regret_w1_1_start180,TSPA,70641,22384,48257,6,100,200
GreedyLS_Edges_NearestNeighborAny2Regret_w1_1_start181,TSPA,70814,22818,47996,19,100,200
GreedyLS_Edges_NearestNeighborAny2Regret_w1_1_start182,TSPA,71221,22776,48445,16,100,200
GreedyLS_Edges_NearestNeighborAny2Regret_w1_1_start183,TSPA,69618,22122,47496,10,100,200
GreedyLS_Edges_NearestNeighborAny2Regret_w1_1_start184,TSPA,70595,22590,48005,5,100,200
GreedyLS_Edges_NearestNeighborAny2Regret_w1_1_start185,TSPA,71766,23913,47853,13,100,200
GreedyLS_Edges_NearestNeighborAny2Regret_w1_1_start186,TSPA,69515,21723,47792,9,100,200
GreedyLS_Edges_NearestNeighborAny2Regret_w1_1_start187,TSPA,71827,23091,48736,20,100,200
GreedyLS_Edges_NearestNeighborAny2Regret_w1_1_start188,TSPA,71185,21756,49429,6,100,200
GreedyLS_Edges_NearestNeighborAny2Regret_w1_1_start189,TSPA,70497,22052,48445,7,100,200
GreedyLS_Edges_NearestNeighborAny2Regret_w1_1_start190,TSPA,70102,22308,47794,3,100,200
GreedyLS_Edges_NearestNeighborAny2Regret_w1_1_start191,TSPA,70710,22456,48254,11,100,200
GreedyLS_Edges_NearestNeighborAny2Regret_w1_1_start192,TSPA,71208,23126,48082,9,100,200
GreedyLS_Edges_NearestNeighborAny2Regret_w1_1_start193,TSPA,71347,23196,48151,11,100,200
GreedyLS_Edges_NearestNeighborAny2Regret_w1_1_start194,TSPA,71099,22276,48823,4,100,200
GreedyLS_Edges_NearestNeighborAny2Regret_w1_1_start195,TSPA,70513,21885,48628,9,100,200
GreedyLS_Edges_NearestNeighborAny2Regret_w1_1_start196,TSPA,70313,22149,48164,10,100,200
GreedyLS_Edges_NearestNeighborAny2Regret_w1_1_start197,TSPA,71045,22703,48342,18,100,200
GreedyLS_Edges_NearestNeighborAny2Regret_w1_1_start198,TSPA,70744,23098,47646,14,100,200
GreedyLS_Edges_NearestNeighborAny2Regret_w1_1_start199,TSPA,70914,22124,48790,4,100,200
