algorithm,instance,objective_value,path_length,node_costs,computation_time_ms,selected_nodes,total_nodes
SteepestLS_Nodes_Random_start0,TSPB,57565,30623,26942,108,100,200
SteepestLS_Nodes_Random_start1,TSPB,64095,39086,25009,73,100,200
SteepestLS_Nodes_Random_start2,TSPB,62188,35881,26307,67,100,200
SteepestLS_Nodes_Random_start3,TSPB,61653,37199,24454,79,100,200
SteepestLS_Nodes_Random_start4,TSPB,65587,40984,24603,80,100,200
SteepestLS_Nodes_Random_start5,TSPB,63609,38653,24956,76,100,200
SteepestLS_Nodes_Random_start6,TSPB,60878,34889,25989,92,100,200
SteepestLS_Nodes_Random_start7,TSPB,58237,32529,25708,74,100,200
SteepestLS_Nodes_Random_start8,TSPB,60140,35121,25019,80,100,200
SteepestLS_Nodes_Random_start9,TSPB,64151,39377,24774,77,100,200
SteepestLS_Nodes_Random_start10,TSPB,54346,28441,25905,65,100,200
SteepestLS_Nodes_Random_start11,TSPB,64073,37727,26346,70,100,200
SteepestLS_Nodes_Random_start12,TSPB,67575,42584,24991,71,100,200
SteepestLS_Nodes_Random_start13,TSPB,63473,38222,25251,73,100,200
SteepestLS_Nodes_Random_start14,TSPB,63005,38343,24662,59,100,200
SteepestLS_Nodes_Random_start15,TSPB,61546,37545,24001,66,100,200
SteepestLS_Nodes_Random_start16,TSPB,68117,40682,27435,69,100,200
SteepestLS_Nodes_Random_start17,TSPB,59414,34228,25186,70,100,200
SteepestLS_Nodes_Random_start18,TSPB,65929,40972,24957,66,100,200
SteepestLS_Nodes_Random_start19,TSPB,67550,40792,26758,71,100,200
SteepestLS_Nodes_Random_start20,TSPB,59200,34387,24813,69,100,200
SteepestLS_Nodes_Random_start21,TSPB,62975,38048,24927,66,100,200
SteepestLS_Nodes_Random_start22,TSPB,65180,38460,26720,73,100,200
SteepestLS_Nodes_Random_start23,TSPB,60622,34929,25693,77,100,200
SteepestLS_Nodes_Random_start24,TSPB,62146,35542,26604,71,100,200
SteepestLS_Nodes_Random_start25,TSPB,59679,34222,25457,80,100,200
SteepestLS_Nodes_Random_start26,TSPB,64473,39883,24590,66,100,200
SteepestLS_Nodes_Random_start27,TSPB,65064,39599,25465,88,100,200
SteepestLS_Nodes_Random_start28,TSPB,62901,36283,26618,65,100,200
SteepestLS_Nodes_Random_start29,TSPB,60688,35266,25422,74,100,200
SteepestLS_Nodes_Random_start30,TSPB,66713,41852,24861,75,100,200
SteepestLS_Nodes_Random_start31,TSPB,64966,39544,25422,69,100,200
SteepestLS_Nodes_Random_start32,TSPB,65410,40754,24656,83,100,200
SteepestLS_Nodes_Random_start33,TSPB,61208,35271,25937,68,100,200
SteepestLS_Nodes_Random_start34,TSPB,66215,40730,25485,78,100,200
SteepestLS_Nodes_Random_start35,TSPB,66236,40720,25516,70,100,200
SteepestLS_Nodes_Random_start36,TSPB,65376,39110,26266,77,100,200
SteepestLS_Nodes_Random_start37,TSPB,58804,32032,26772,63,100,200
SteepestLS_Nodes_Random_start38,TSPB,59191,34671,24520,65,100,200
SteepestLS_Nodes_Random_start39,TSPB,63015,37365,25650,63,100,200
SteepestLS_Nodes_Random_start40,TSPB,64273,37226,27047,73,100,200
SteepestLS_Nodes_Random_start41,TSPB,63345,37780,25565,65,100,200
SteepestLS_Nodes_Random_start42,TSPB,60132,35712,24420,72,100,200
SteepestLS_Nodes_Random_start43,TSPB,64396,38705,25691,71,100,200
SteepestLS_Nodes_Random_start44,TSPB,58551,33157,25394,71,100,200
SteepestLS_Nodes_Random_start45,TSPB,61365,35272,26093,73,100,200
SteepestLS_Nodes_Random_start46,TSPB,63788,36747,27041,68,100,200
SteepestLS_Nodes_Random_start47,TSPB,60080,31550,28530,70,100,200
SteepestLS_Nodes_Random_start48,TSPB,64074,38631,25443,63,100,200
SteepestLS_Nodes_Random_start49,TSPB,64088,37918,26170,64,100,200
SteepestLS_Nodes_Random_start50,TSPB,66409,40837,25572,69,100,200
SteepestLS_Nodes_Random_start51,TSPB,67912,43386,24526,66,100,200
SteepestLS_Nodes_Random_start52,TSPB,58053,33431,24622,79,100,200
SteepestLS_Nodes_Random_start53,TSPB,59489,33770,25719,72,100,200
SteepestLS_Nodes_Random_start54,TSPB,58171,30729,27442,87,100,200
SteepestLS_Nodes_Random_start55,TSPB,57887,33572,24315,78,100,200
SteepestLS_Nodes_Random_start56,TSPB,60068,34768,25300,87,100,200
SteepestLS_Nodes_Random_start57,TSPB,63133,37378,25755,82,100,200
SteepestLS_Nodes_Random_start58,TSPB,66995,41094,25901,65,100,200
SteepestLS_Nodes_Random_start59,TSPB,58997,33563,25434,74,100,200
SteepestLS_Nodes_Random_start60,TSPB,60368,34087,26281,71,100,200
SteepestLS_Nodes_Random_start61,TSPB,65301,37266,28035,69,100,200
SteepestLS_Nodes_Random_start62,TSPB,61485,34168,27317,70,100,200
SteepestLS_Nodes_Random_start63,TSPB,64115,38956,25159,68,100,200
SteepestLS_Nodes_Random_start64,TSPB,69272,43616,25656,64,100,200
SteepestLS_Nodes_Random_start65,TSPB,64712,39539,25173,73,100,200
SteepestLS_Nodes_Random_start66,TSPB,66245,40464,25781,59,100,200
SteepestLS_Nodes_Random_start67,TSPB,60254,34501,25753,67,100,200
SteepestLS_Nodes_Random_start68,TSPB,66015,40403,25612,71,100,200
SteepestLS_Nodes_Random_start69,TSPB,60842,35876,24966,60,100,200
SteepestLS_Nodes_Random_start70,TSPB,59607,33203,26404,77,100,200
SteepestLS_Nodes_Random_start71,TSPB,65275,39823,25452,68,100,200
SteepestLS_Nodes_Random_start72,TSPB,62240,37580,24660,65,100,200
SteepestLS_Nodes_Random_start73,TSPB,63714,37944,25770,63,100,200
SteepestLS_Nodes_Random_start74,TSPB,61629,34711,26918,78,100,200
SteepestLS_Nodes_Random_start75,TSPB,61619,36313,25306,73,100,200
SteepestLS_Nodes_Random_start76,TSPB,72060,48147,23913,69,100,200
SteepestLS_Nodes_Random_start77,TSPB,61936,35915,26021,64,100,200
SteepestLS_Nodes_Random_start78,TSPB,66538,39408,27130,67,100,200
SteepestLS_Nodes_Random_start79,TSPB,66843,39608,27235,69,100,200
SteepestLS_Nodes_Random_start80,TSPB,61630,36143,25487,68,100,200
SteepestLS_Nodes_Random_start81,TSPB,59795,33785,26010,60,100,200
SteepestLS_Nodes_Random_start82,TSPB,62981,38540,24441,76,100,200
SteepestLS_Nodes_Random_start83,TSPB,63163,37957,25206,69,100,200
SteepestLS_Nodes_Random_start84,TSPB,60614,34617,25997,72,100,200
SteepestLS_Nodes_Random_start85,TSPB,61264,37068,24196,74,100,200
SteepestLS_Nodes_Random_start86,TSPB,63159,36477,26682,53,100,200
SteepestLS_Nodes_Random_start87,TSPB,68079,40898,27181,61,100,200
SteepestLS_Nodes_Random_start88,TSPB,59428,34024,25404,71,100,200
SteepestLS_Nodes_Random_start89,TSPB,60652,33556,27096,58,100,200
SteepestLS_Nodes_Random_start90,TSPB,59976,35491,24485,63,100,200
SteepestLS_Nodes_Random_start91,TSPB,63408,36228,27180,74,100,200
SteepestLS_Nodes_Random_start92,TSPB,63875,38965,24910,79,100,200
SteepestLS_Nodes_Random_start93,TSPB,57881,32741,25140,65,100,200
SteepestLS_Nodes_Random_start94,TSPB,66364,38057,28307,64,100,200
SteepestLS_Nodes_Random_start95,TSPB,58882,33467,25415,70,100,200
SteepestLS_Nodes_Random_start96,TSPB,60430,35026,25404,65,100,200
SteepestLS_Nodes_Random_start97,TSPB,62156,36748,25408,69,100,200
SteepestLS_Nodes_Random_start98,TSPB,68151,42794,25357,59,100,200
SteepestLS_Nodes_Random_start99,TSPB,63894,36493,27401,77,100,200
SteepestLS_Nodes_Random_start100,TSPB,59504,34124,25380,61,100,200
SteepestLS_Nodes_Random_start101,TSPB,69021,43347,25674,59,100,200
SteepestLS_Nodes_Random_start102,TSPB,63797,39077,24720,62,100,200
SteepestLS_Nodes_Random_start103,TSPB,60585,35912,24673,65,100,200
SteepestLS_Nodes_Random_start104,TSPB,62209,36586,25623,62,100,200
SteepestLS_Nodes_Random_start105,TSPB,62385,36316,26069,68,100,200
SteepestLS_Nodes_Random_start106,TSPB,65804,39561,26243,58,100,200
SteepestLS_Nodes_Random_start107,TSPB,63696,35349,28347,63,100,200
SteepestLS_Nodes_Random_start108,TSPB,65214,40211,25003,76,100,200
SteepestLS_Nodes_Random_start109,TSPB,60798,34781,26017,70,100,200
SteepestLS_Nodes_Random_start110,TSPB,58301,32539,25762,69,100,200
SteepestLS_Nodes_Random_start111,TSPB,62568,38170,24398,74,100,200
SteepestLS_Nodes_Random_start112,TSPB,62592,36532,26060,63,100,200
SteepestLS_Nodes_Random_start113,TSPB,61111,34139,26972,62,100,200
SteepestLS_Nodes_Random_start114,TSPB,65459,41551,23908,63,100,200
SteepestLS_Nodes_Random_start115,TSPB,65057,36863,28194,69,100,200
SteepestLS_Nodes_Random_start116,TSPB,60789,35454,25335,65,100,200
SteepestLS_Nodes_Random_start117,TSPB,62928,36244,26684,69,100,200
SteepestLS_Nodes_Random_start118,TSPB,59719,33453,26266,70,100,200
SteepestLS_Nodes_Random_start119,TSPB,59970,35164,24806,75,100,200
SteepestLS_Nodes_Random_start120,TSPB,57844,33474,24370,77,100,200
SteepestLS_Nodes_Random_start121,TSPB,63915,37533,26382,70,100,200
SteepestLS_Nodes_Random_start122,TSPB,63135,37611,25524,69,100,200
SteepestLS_Nodes_Random_start123,TSPB,59581,33742,25839,91,100,200
SteepestLS_Nodes_Random_start124,TSPB,64122,37640,26482,78,100,200
SteepestLS_Nodes_Random_start125,TSPB,62443,37926,24517,67,100,200
SteepestLS_Nodes_Random_start126,TSPB,71072,43122,27950,58,100,200
SteepestLS_Nodes_Random_start127,TSPB,62326,34982,27344,60,100,200
SteepestLS_Nodes_Random_start128,TSPB,63762,38731,25031,59,100,200
SteepestLS_Nodes_Random_start129,TSPB,61785,35635,26150,73,100,200
SteepestLS_Nodes_Random_start130,TSPB,68219,42778,25441,73,100,200
SteepestLS_Nodes_Random_start131,TSPB,67611,41573,26038,61,100,200
SteepestLS_Nodes_Random_start132,TSPB,62884,36176,26708,64,100,200
SteepestLS_Nodes_Random_start133,TSPB,64281,38426,25855,64,100,200
SteepestLS_Nodes_Random_start134,TSPB,69651,42722,26929,64,100,200
SteepestLS_Nodes_Random_start135,TSPB,67536,41573,25963,73,100,200
SteepestLS_Nodes_Random_start136,TSPB,65040,39036,26004,68,100,200
SteepestLS_Nodes_Random_start137,TSPB,58259,33496,24763,69,100,200
SteepestLS_Nodes_Random_start138,TSPB,70572,44347,26225,60,100,200
SteepestLS_Nodes_Random_start139,TSPB,62530,37075,25455,68,100,200
SteepestLS_Nodes_Random_start140,TSPB,62678,34461,28217,82,100,200
SteepestLS_Nodes_Random_start141,TSPB,61265,34787,26478,82,100,200
SteepestLS_Nodes_Random_start142,TSPB,61399,35811,25588,67,100,200
SteepestLS_Nodes_Random_start143,TSPB,64449,38610,25839,71,100,200
SteepestLS_Nodes_Random_start144,TSPB,63052,38827,24225,72,100,200
SteepestLS_Nodes_Random_start145,TSPB,61937,36925,25012,72,100,200
SteepestLS_Nodes_Random_start146,TSPB,65170,38590,26580,69,100,200
SteepestLS_Nodes_Random_start147,TSPB,63098,37539,25559,70,100,200
SteepestLS_Nodes_Random_start148,TSPB,61433,35097,26336,69,100,200
SteepestLS_Nodes_Random_start149,TSPB,68468,42925,25543,62,100,200
SteepestLS_Nodes_Random_start150,TSPB,60007,34745,25262,72,100,200
SteepestLS_Nodes_Random_start151,TSPB,65103,38883,26220,64,100,200
SteepestLS_Nodes_Random_start152,TSPB,64023,36391,27632,61,100,200
SteepestLS_Nodes_Random_start153,TSPB,57090,33173,23917,64,100,200
SteepestLS_Nodes_Random_start154,TSPB,65001,39400,25601,62,100,200
SteepestLS_Nodes_Random_start155,TSPB,65596,40108,25488,64,100,200
SteepestLS_Nodes_Random_start156,TSPB,63896,38772,25124,73,100,200
SteepestLS_Nodes_Random_start157,TSPB,60401,35518,24883,75,100,200
SteepestLS_Nodes_Random_start158,TSPB,64736,39074,25662,74,100,200
SteepestLS_Nodes_Random_start159,TSPB,60634,33280,27354,62,100,200
SteepestLS_Nodes_Random_start160,TSPB,58651,33153,25498,76,100,200
SteepestLS_Nodes_Random_start161,TSPB,65485,39990,25495,61,100,200
SteepestLS_Nodes_Random_start162,TSPB,60552,35115,25437,75,100,200
SteepestLS_Nodes_Random_start163,TSPB,60157,33947,26210,83,100,200
SteepestLS_Nodes_Random_start164,TSPB,64076,37171,26905,67,100,200
SteepestLS_Nodes_Random_start165,TSPB,66882,38299,28583,71,100,200
SteepestLS_Nodes_Random_start166,TSPB,56942,30467,26475,81,100,200
SteepestLS_Nodes_Random_start167,TSPB,62576,37095,25481,63,100,200
SteepestLS_Nodes_Random_start168,TSPB,66606,39861,26745,80,100,200
SteepestLS_Nodes_Random_start169,TSPB,63815,38332,25483,53,100,200
SteepestLS_Nodes_Random_start170,TSPB,62195,37713,24482,68,100,200
SteepestLS_Nodes_Random_start171,TSPB,68387,43081,25306,66,100,200
SteepestLS_Nodes_Random_start172,TSPB,61863,35353,26510,67,100,200
SteepestLS_Nodes_Random_start173,TSPB,62260,36162,26098,74,100,200
SteepestLS_Nodes_Random_start174,TSPB,58688,33056,25632,66,100,200
SteepestLS_Nodes_Random_start175,TSPB,61525,35759,25766,73,100,200
SteepestLS_Nodes_Random_start176,TSPB,63011,38160,24851,74,100,200
SteepestLS_Nodes_Random_start177,TSPB,61189,35763,25426,69,100,200
SteepestLS_Nodes_Random_start178,TSPB,59552,34370,25182,74,100,200
SteepestLS_Nodes_Random_start179,TSPB,60477,35052,25425,70,100,200
SteepestLS_Nodes_Random_start180,TSPB,60083,33838,26245,68,100,200
SteepestLS_Nodes_Random_start181,TSPB,61009,36581,24428,70,100,200
SteepestLS_Nodes_Random_start182,TSPB,65220,38484,26736,68,100,200
SteepestLS_Nodes_Random_start183,TSPB,60391,35678,24713,74,100,200
SteepestLS_Nodes_Random_start184,TSPB,61143,34722,26421,68,100,200
SteepestLS_Nodes_Random_start185,TSPB,64240,37959,26281,65,100,200
SteepestLS_Nodes_Random_start186,TSPB,60056,33960,26096,77,100,200
SteepestLS_Nodes_Random_start187,TSPB,64094,38358,25736,62,100,200
SteepestLS_Nodes_Random_start188,TSPB,63904,37044,26860,69,100,200
SteepestLS_Nodes_Random_start189,TSPB,65543,40423,25120,65,100,200
SteepestLS_Nodes_Random_start190,TSPB,57836,31888,25948,65,100,200
SteepestLS_Nodes_Random_start191,TSPB,59151,34615,24536,78,100,200
SteepestLS_Nodes_Random_start192,TSPB,66294,39115,27179,56,100,200
SteepestLS_Nodes_Random_start193,TSPB,57759,31388,26371,73,100,200
SteepestLS_Nodes_Random_start194,TSPB,63794,38363,25431,62,100,200
SteepestLS_Nodes_Random_start195,TSPB,66520,40420,26100,65,100,200
SteepestLS_Nodes_Random_start196,TSPB,64364,38272,26092,64,100,200
SteepestLS_Nodes_Random_start197,TSPB,65365,39667,25698,68,100,200
SteepestLS_Nodes_Random_start198,TSPB,65097,37573,27524,68,100,200
SteepestLS_Nodes_Random_start199,TSPB,59582,33422,26160,64,100,200
SteepestLS_Nodes_GreedyCycle_start0,TSPB,56836,23938,32898,36,100,200
SteepestLS_Nodes_GreedyCycle_start1,TSPB,55987,23229,32758,34,100,200
SteepestLS_Nodes_GreedyCycle_start2,TSPB,51162,23263,27899,34,100,200
SteepestLS_Nodes_GreedyCycle_start3,TSPB,56405,24113,32292,31,100,200
SteepestLS_Nodes_GreedyCycle_start4,TSPB,55083,26233,28850,31,100,200
SteepestLS_Nodes_GreedyCycle_start5,TSPB,56951,24071,32880,39,100,200
SteepestLS_Nodes_GreedyCycle_start6,TSPB,54178,22912,31266,30,100,200
SteepestLS_Nodes_GreedyCycle_start7,TSPB,49570,24435,25135,32,100,200
SteepestLS_Nodes_GreedyCycle_start8,TSPB,51048,24471,26577,46,100,200
SteepestLS_Nodes_GreedyCycle_start9,TSPB,52632,21101,31531,39,100,200
SteepestLS_Nodes_GreedyCycle_start10,TSPB,53176,22645,30531,30,100,200
SteepestLS_Nodes_GreedyCycle_start11,TSPB,52416,24065,28351,37,100,200
SteepestLS_Nodes_GreedyCycle_start12,TSPB,54965,23397,31568,41,100,200
SteepestLS_Nodes_GreedyCycle_start13,TSPB,53917,24924,28993,28,100,200
SteepestLS_Nodes_GreedyCycle_start14,TSPB,51411,23022,28389,34,100,200
SteepestLS_Nodes_GreedyCycle_start15,TSPB,52196,23303,28893,31,100,200
SteepestLS_Nodes_GreedyCycle_start16,TSPB,54258,25993,28265,32,100,200
SteepestLS_Nodes_GreedyCycle_start17,TSPB,53318,24675,28643,31,100,200
SteepestLS_Nodes_GreedyCycle_start18,TSPB,53067,24569,28498,38,100,200
SteepestLS_Nodes_GreedyCycle_start19,TSPB,60636,24365,36271,34,100,200
SteepestLS_Nodes_GreedyCycle_start20,TSPB,48699,22113,26586,39,100,200
SteepestLS_Nodes_GreedyCycle_start21,TSPB,52968,27777,25191,38,100,200
SteepestLS_Nodes_GreedyCycle_start22,TSPB,49723,22156,27567,554,100,200
SteepestLS_Nodes_GreedyCycle_start23,TSPB,58049,22440,35609,31,100,200
SteepestLS_Nodes_GreedyCycle_start24,TSPB,59884,24655,35229,-2786,100,200
SteepestLS_Nodes_GreedyCycle_start25,TSPB,50418,24682,25736,34,100,200
SteepestLS_Nodes_GreedyCycle_start26,TSPB,55028,23330,31698,33,100,200
SteepestLS_Nodes_GreedyCycle_start27,TSPB,62071,25010,37061,42,100,200
SteepestLS_Nodes_GreedyCycle_start28,TSPB,57584,24609,32975,34,100,200
SteepestLS_Nodes_GreedyCycle_start29,TSPB,55956,25206,30750,35,100,200
SteepestLS_Nodes_GreedyCycle_start30,TSPB,54542,22272,32270,36,100,200
SteepestLS_Nodes_GreedyCycle_start31,TSPB,53700,24889,28811,42,100,200
SteepestLS_Nodes_GreedyCycle_start32,TSPB,51795,25433,26362,34,100,200
SteepestLS_Nodes_GreedyCycle_start33,TSPB,54534,23522,31012,37,100,200
SteepestLS_Nodes_GreedyCycle_start34,TSPB,54809,24058,30751,35,100,200
SteepestLS_Nodes_GreedyCycle_start35,TSPB,54764,23727,31037,38,100,200
SteepestLS_Nodes_GreedyCycle_start36,TSPB,54049,26761,27288,31,100,200
SteepestLS_Nodes_GreedyCycle_start37,TSPB,61604,23062,38542,39,100,200
SteepestLS_Nodes_GreedyCycle_start38,TSPB,51330,25292,26038,43,100,200
SteepestLS_Nodes_GreedyCycle_start39,TSPB,56535,26806,29729,37,100,200
SteepestLS_Nodes_GreedyCycle_start40,TSPB,58198,24965,33233,33,100,200
SteepestLS_Nodes_GreedyCycle_start41,TSPB,54743,23057,31686,40,100,200
SteepestLS_Nodes_GreedyCycle_start42,TSPB,50701,25428,25273,42,100,200
SteepestLS_Nodes_GreedyCycle_start43,TSPB,51879,24436,27443,33,100,200
SteepestLS_Nodes_GreedyCycle_start44,TSPB,54534,22606,31928,39,100,200
SteepestLS_Nodes_GreedyCycle_start45,TSPB,50436,24598,25838,32,100,200
SteepestLS_Nodes_GreedyCycle_start46,TSPB,54103,24504,29599,32,100,200
SteepestLS_Nodes_GreedyCycle_start47,TSPB,50809,23115,27694,43,100,200
SteepestLS_Nodes_GreedyCycle_start48,TSPB,54734,23468,31266,41,100,200
SteepestLS_Nodes_GreedyCycle_start49,TSPB,55443,23135,32308,34,100,200
SteepestLS_Nodes_GreedyCycle_start50,TSPB,51411,23022,28389,35,100,200
SteepestLS_Nodes_GreedyCycle_start51,TSPB,58970,25570,33400,38,100,200
SteepestLS_Nodes_GreedyCycle_start52,TSPB,56754,25324,31430,36,100,200
SteepestLS_Nodes_GreedyCycle_start53,TSPB,51183,23451,27732,35,100,200
SteepestLS_Nodes_GreedyCycle_start54,TSPB,53700,24889,28811,38,100,200
SteepestLS_Nodes_GreedyCycle_start55,TSPB,53067,24569,28498,37,100,200
SteepestLS_Nodes_GreedyCycle_start56,TSPB,54492,27618,26874,30,100,200
SteepestLS_Nodes_GreedyCycle_start57,TSPB,55442,23537,31905,32,100,200
SteepestLS_Nodes_GreedyCycle_start58,TSPB,54693,25824,28869,32,100,200
SteepestLS_Nodes_GreedyCycle_start59,TSPB,55405,22393,33012,37,100,200
SteepestLS_Nodes_GreedyCycle_start60,TSPB,58161,22709,35452,32,100,200
SteepestLS_Nodes_GreedyCycle_start61,TSPB,55709,24935,30774,31,100,200
SteepestLS_Nodes_GreedyCycle_start62,TSPB,53309,24515,28794,38,100,200
SteepestLS_Nodes_GreedyCycle_start63,TSPB,52450,22805,29645,33,100,200
SteepestLS_Nodes_GreedyCycle_start64,TSPB,54891,23604,31287,40,100,200
SteepestLS_Nodes_GreedyCycle_start65,TSPB,54055,23785,30270,33,100,200
SteepestLS_Nodes_GreedyCycle_start66,TSPB,54983,24175,30808,46,100,200
SteepestLS_Nodes_GreedyCycle_start67,TSPB,62375,24529,37846,40,100,200
SteepestLS_Nodes_GreedyCycle_start68,TSPB,57583,26053,31530,35,100,200
SteepestLS_Nodes_GreedyCycle_start69,TSPB,55042,25018,30024,33,100,200
SteepestLS_Nodes_GreedyCycle_start70,TSPB,54306,23991,30315,37,100,200
SteepestLS_Nodes_GreedyCycle_start71,TSPB,60380,25497,34883,41,100,200
SteepestLS_Nodes_GreedyCycle_start72,TSPB,57397,21355,36042,35,100,200
SteepestLS_Nodes_GreedyCycle_start73,TSPB,58893,23039,35854,38,100,200
SteepestLS_Nodes_GreedyCycle_start74,TSPB,52187,24118,28069,36,100,200
SteepestLS_Nodes_GreedyCycle_start75,TSPB,54720,25031,29689,32,100,200
SteepestLS_Nodes_GreedyCycle_start76,TSPB,53260,24185,29075,40,100,200
SteepestLS_Nodes_GreedyCycle_start77,TSPB,55041,27233,27808,36,100,200
SteepestLS_Nodes_GreedyCycle_start78,TSPB,55602,24644,30958,34,100,200
SteepestLS_Nodes_GreedyCycle_start79,TSPB,55544,26560,28984,40,100,200
SteepestLS_Nodes_GreedyCycle_start80,TSPB,57416,26483,30933,30,100,200
SteepestLS_Nodes_GreedyCycle_start81,TSPB,53716,23834,29882,36,100,200
SteepestLS_Nodes_GreedyCycle_start82,TSPB,62417,24681,37736,35,100,200
SteepestLS_Nodes_GreedyCycle_start83,TSPB,54616,21847,32769,33,100,200
SteepestLS_Nodes_GreedyCycle_start84,TSPB,53109,23627,29482,32,100,200
SteepestLS_Nodes_GreedyCycle_start85,TSPB,56486,21821,34665,38,100,200
SteepestLS_Nodes_GreedyCycle_start86,TSPB,55874,24194,31680,34,100,200
SteepestLS_Nodes_GreedyCycle_start87,TSPB,55395,26511,28884,31,100,200
SteepestLS_Nodes_GreedyCycle_start88,TSPB,56497,25268,31229,36,100,200
SteepestLS_Nodes_GreedyCycle_start89,TSPB,56382,25379,31003,37,100,200
SteepestLS_Nodes_GreedyCycle_start90,TSPB,63581,24523,39058,33,100,200
SteepestLS_Nodes_GreedyCycle_start91,TSPB,54049,26761,27288,31,100,200
SteepestLS_Nodes_GreedyCycle_start92,TSPB,52748,24238,28510,30,100,200
SteepestLS_Nodes_GreedyCycle_start93,TSPB,54036,23586,30450,36,100,200
SteepestLS_Nodes_GreedyCycle_start94,TSPB,51989,24141,27848,31,100,200
SteepestLS_Nodes_GreedyCycle_start95,TSPB,55425,24433,30992,32,100,200
SteepestLS_Nodes_GreedyCycle_start96,TSPB,53333,24700,28633,35,100,200
SteepestLS_Nodes_GreedyCycle_start97,TSPB,55041,27233,27808,36,100,200
SteepestLS_Nodes_GreedyCycle_start98,TSPB,56940,26861,30079,33,100,200
SteepestLS_Nodes_GreedyCycle_start99,TSPB,52509,21306,31203,32,100,200
SteepestLS_Nodes_GreedyCycle_start100,TSPB,58695,22377,36318,36,100,200
SteepestLS_Nodes_GreedyCycle_start101,TSPB,56467,23169,33298,36,100,200
SteepestLS_Nodes_GreedyCycle_start102,TSPB,53587,24819,28768,32,100,200
SteepestLS_Nodes_GreedyCycle_start103,TSPB,57026,25955,31071,31,100,200
SteepestLS_Nodes_GreedyCycle_start104,TSPB,52733,25892,26841,41,100,200
SteepestLS_Nodes_GreedyCycle_start105,TSPB,49204,21966,27238,29,100,200
SteepestLS_Nodes_GreedyCycle_start106,TSPB,58799,25847,32952,34,100,200
SteepestLS_Nodes_GreedyCycle_start107,TSPB,57871,21283,36588,38,100,200
SteepestLS_Nodes_GreedyCycle_start108,TSPB,57845,26657,31188,31,100,200
SteepestLS_Nodes_GreedyCycle_start109,TSPB,56836,23938,32898,37,100,200
SteepestLS_Nodes_GreedyCycle_start110,TSPB,55321,25110,30211,36,100,200
SteepestLS_Nodes_GreedyCycle_start111,TSPB,57224,25605,31619,37,100,200
SteepestLS_Nodes_GreedyCycle_start112,TSPB,57039,22561,34478,38,100,200
SteepestLS_Nodes_GreedyCycle_start113,TSPB,54073,23205,30868,38,100,200
SteepestLS_Nodes_GreedyCycle_start114,TSPB,53047,22914,30133,33,100,200
SteepestLS_Nodes_GreedyCycle_start115,TSPB,52561,22908,29653,40,100,200
SteepestLS_Nodes_GreedyCycle_start116,TSPB,59693,23066,36627,33,100,200
SteepestLS_Nodes_GreedyCycle_start117,TSPB,51518,24818,26700,36,100,200
SteepestLS_Nodes_GreedyCycle_start118,TSPB,60303,26905,33398,39,100,200
SteepestLS_Nodes_GreedyCycle_start119,TSPB,53534,22404,31130,34,100,200
SteepestLS_Nodes_GreedyCycle_start120,TSPB,62129,24952,37177,35,100,200
SteepestLS_Nodes_GreedyCycle_start121,TSPB,54816,26515,28301,29,100,200
SteepestLS_Nodes_GreedyCycle_start122,TSPB,51756,22998,28758,41,100,200
SteepestLS_Nodes_GreedyCycle_start123,TSPB,49398,23802,25596,38,100,200
SteepestLS_Nodes_GreedyCycle_start124,TSPB,54130,23101,31029,35,100,200
SteepestLS_Nodes_GreedyCycle_start125,TSPB,53449,24433,29016,36,100,200
SteepestLS_Nodes_GreedyCycle_start126,TSPB,54364,25371,28993,31,100,200
SteepestLS_Nodes_GreedyCycle_start127,TSPB,55070,23476,31594,39,100,200
SteepestLS_Nodes_GreedyCycle_start128,TSPB,53660,25008,28652,30,100,200
SteepestLS_Nodes_GreedyCycle_start129,TSPB,54743,22637,32106,37,100,200
SteepestLS_Nodes_GreedyCycle_start130,TSPB,52269,22392,29877,34,100,200
SteepestLS_Nodes_GreedyCycle_start131,TSPB,53967,24334,29633,30,100,200
SteepestLS_Nodes_GreedyCycle_start132,TSPB,53688,22949,30739,27,100,200
SteepestLS_Nodes_GreedyCycle_start133,TSPB,51565,24761,26804,32,100,200
SteepestLS_Nodes_GreedyCycle_start134,TSPB,52508,21579,30929,34,100,200
SteepestLS_Nodes_GreedyCycle_start135,TSPB,51756,22998,28758,39,100,200
SteepestLS_Nodes_GreedyCycle_start136,TSPB,59897,25953,33944,30,100,200
SteepestLS_Nodes_GreedyCycle_start137,TSPB,54334,23564,30770,37,100,200
SteepestLS_Nodes_GreedyCycle_start138,TSPB,54487,24565,29922,38,100,200
SteepestLS_Nodes_GreedyCycle_start139,TSPB,51551,24130,27421,29,100,200
SteepestLS_Nodes_GreedyCycle_start140,TSPB,53506,23927,29579,35,100,200
SteepestLS_Nodes_GreedyCycle_start141,TSPB,57885,27363,30522,39,100,200
SteepestLS_Nodes_GreedyCycle_start142,TSPB,52891,23413,29478,34,100,200
SteepestLS_Nodes_GreedyCycle_start143,TSPB,52903,23346,29557,35,100,200
SteepestLS_Nodes_GreedyCycle_start144,TSPB,54608,23508,31100,30,100,200
SteepestLS_Nodes_GreedyCycle_start145,TSPB,54306,23991,30315,37,100,200
SteepestLS_Nodes_GreedyCycle_start146,TSPB,52416,24838,27578,28,100,200
SteepestLS_Nodes_GreedyCycle_start147,TSPB,61525,22857,38668,31,100,200
SteepestLS_Nodes_GreedyCycle_start148,TSPB,50809,23115,27694,41,100,200
SteepestLS_Nodes_GreedyCycle_start149,TSPB,54853,22741,32112,40,100,200
SteepestLS_Nodes_GreedyCycle_start150,TSPB,58803,27624,31179,27,100,200
SteepestLS_Nodes_GreedyCycle_start151,TSPB,50615,24415,26200,39,100,200
SteepestLS_Nodes_GreedyCycle_start152,TSPB,51189,24298,26891,32,100,200
SteepestLS_Nodes_GreedyCycle_start153,TSPB,55584,24807,30777,35,100,200
SteepestLS_Nodes_GreedyCycle_start154,TSPB,52727,23773,28954,30,100,200
SteepestLS_Nodes_GreedyCycle_start155,TSPB,55190,24047,31143,33,100,200
SteepestLS_Nodes_GreedyCycle_start156,TSPB,51317,25598,25719,39,100,200
SteepestLS_Nodes_GreedyCycle_start157,TSPB,53397,22238,31159,38,100,200
SteepestLS_Nodes_GreedyCycle_start158,TSPB,60224,24460,35764,39,100,200
SteepestLS_Nodes_GreedyCycle_start159,TSPB,54946,24483,30463,29,100,200
SteepestLS_Nodes_GreedyCycle_start160,TSPB,60729,21871,38858,45,100,200
SteepestLS_Nodes_GreedyCycle_start161,TSPB,52655,22197,30458,34,100,200
SteepestLS_Nodes_GreedyCycle_start162,TSPB,51591,24176,27415,35,100,200
SteepestLS_Nodes_GreedyCycle_start163,TSPB,54591,23613,30978,34,100,200
SteepestLS_Nodes_GreedyCycle_start164,TSPB,54197,24724,29473,39,100,200
SteepestLS_Nodes_GreedyCycle_start165,TSPB,54444,24528,29916,42,100,200
SteepestLS_Nodes_GreedyCycle_start166,TSPB,50605,23177,27428,35,100,200
SteepestLS_Nodes_GreedyCycle_start167,TSPB,52952,23537,29415,34,100,200
SteepestLS_Nodes_GreedyCycle_start168,TSPB,52679,22316,30363,34,100,200
SteepestLS_Nodes_GreedyCycle_start169,TSPB,53688,22949,30739,28,100,200
SteepestLS_Nodes_GreedyCycle_start170,TSPB,58075,26986,31089,34,100,200
SteepestLS_Nodes_GreedyCycle_start171,TSPB,52279,20789,31490,37,100,200
SteepestLS_Nodes_GreedyCycle_start172,TSPB,57181,25872,31309,31,100,200
SteepestLS_Nodes_GreedyCycle_start173,TSPB,54579,22917,31662,39,100,200
SteepestLS_Nodes_GreedyCycle_start174,TSPB,53586,21411,32175,33,100,200
SteepestLS_Nodes_GreedyCycle_start175,TSPB,55110,23650,31460,37,100,200
SteepestLS_Nodes_GreedyCycle_start176,TSPB,56291,24631,31660,37,100,200
SteepestLS_Nodes_GreedyCycle_start177,TSPB,53407,23633,29774,36,100,200
SteepestLS_Nodes_GreedyCycle_start178,TSPB,53266,23622,29644,44,100,200
SteepestLS_Nodes_GreedyCycle_start179,TSPB,54820,24070,30750,35,100,200
SteepestLS_Nodes_GreedyCycle_start180,TSPB,53636,24507,29129,29,100,200
SteepestLS_Nodes_GreedyCycle_start181,TSPB,53575,22890,30685,32,100,200
SteepestLS_Nodes_GreedyCycle_start182,TSPB,52394,23302,29092,38,100,200
SteepestLS_Nodes_GreedyCycle_start183,TSPB,50780,22601,28179,31,100,200
SteepestLS_Nodes_GreedyCycle_start184,TSPB,51415,22963,28452,41,100,200
SteepestLS_Nodes_GreedyCycle_start185,TSPB,55837,24260,31577,36,100,200
SteepestLS_Nodes_GreedyCycle_start186,TSPB,51217,23670,27547,41,100,200
SteepestLS_Nodes_GreedyCycle_start187,TSPB,51940,22706,29234,35,100,200
SteepestLS_Nodes_GreedyCycle_start188,TSPB,53517,24341,29176,33,100,200
SteepestLS_Nodes_GreedyCycle_start189,TSPB,53017,23310,29707,38,100,200
SteepestLS_Nodes_GreedyCycle_start190,TSPB,59897,25953,33944,33,100,200
SteepestLS_Nodes_GreedyCycle_start191,TSPB,54935,23241,31694,41,100,200
SteepestLS_Nodes_GreedyCycle_start192,TSPB,58803,27624,31179,30,100,200
SteepestLS_Nodes_GreedyCycle_start193,TSPB,56453,23630,32823,49,100,200
SteepestLS_Nodes_GreedyCycle_start194,TSPB,56291,24631,31660,36,100,200
SteepestLS_Nodes_GreedyCycle_start195,TSPB,53917,24924,28993,29,100,200
SteepestLS_Nodes_GreedyCycle_start196,TSPB,56956,22987,33969,39,100,200
SteepestLS_Nodes_GreedyCycle_start197,TSPB,55516,22817,32699,35,100,200
SteepestLS_Nodes_GreedyCycle_start198,TSPB,51518,24818,26700,37,100,200
SteepestLS_Nodes_GreedyCycle_start199,TSPB,52485,25455,27030,37,100,200
SteepestLS_Edges_Random_start0,TSPB,48428,20975,27453,59,100,200
SteepestLS_Edges_Random_start1,TSPB,48714,22329,26385,53,100,200
SteepestLS_Edges_Random_start2,TSPB,50157,20996,29161,59,100,200
SteepestLS_Edges_Random_start3,TSPB,48440,21381,27059,52,100,200
SteepestLS_Edges_Random_start4,TSPB,47605,21210,26395,58,100,200
SteepestLS_Edges_Random_start5,TSPB,48294,21488,26806,56,100,200
SteepestLS_Edges_Random_start6,TSPB,48621,21073,27548,50,100,200
SteepestLS_Edges_Random_start7,TSPB,47838,20700,27138,60,100,200
SteepestLS_Edges_Random_start8,TSPB,49220,20160,29060,57,100,200
SteepestLS_Edges_Random_start9,TSPB,47652,21913,25739,59,100,200
SteepestLS_Edges_Random_start10,TSPB,49591,20751,28840,58,100,200
SteepestLS_Edges_Random_start11,TSPB,48365,22520,25845,55,100,200
SteepestLS_Edges_Random_start12,TSPB,46623,21175,25448,60,100,200
SteepestLS_Edges_Random_start13,TSPB,48655,21127,27528,53,100,200
SteepestLS_Edges_Random_start14,TSPB,49658,21103,28555,53,100,200
SteepestLS_Edges_Random_start15,TSPB,47998,20574,27424,53,100,200
SteepestLS_Edges_Random_start16,TSPB,48016,21665,26351,60,100,200
SteepestLS_Edges_Random_start17,TSPB,47369,21958,25411,54,100,200
SteepestLS_Edges_Random_start18,TSPB,47491,20498,26993,56,100,200
SteepestLS_Edges_Random_start19,TSPB,49124,22235,26889,58,100,200
SteepestLS_Edges_Random_start20,TSPB,50690,22336,28354,60,100,200
SteepestLS_Edges_Random_start21,TSPB,47284,21084,26200,61,100,200
SteepestLS_Edges_Random_start22,TSPB,47174,21268,25906,66,100,200
SteepestLS_Edges_Random_start23,TSPB,48598,23075,25523,53,100,200
SteepestLS_Edges_Random_start24,TSPB,47552,21527,26025,57,100,200
SteepestLS_Edges_Random_start25,TSPB,51825,22315,29510,51,100,200
SteepestLS_Edges_Random_start26,TSPB,50600,21733,28867,58,100,200
SteepestLS_Edges_Random_start27,TSPB,48800,21345,27455,56,100,200
SteepestLS_Edges_Random_start28,TSPB,48085,20790,27295,59,100,200
SteepestLS_Edges_Random_start29,TSPB,47712,21442,26270,55,100,200
SteepestLS_Edges_Random_start30,TSPB,49040,21674,27366,60,100,200
SteepestLS_Edges_Random_start31,TSPB,48263,21487,26776,58,100,200
SteepestLS_Edges_Random_start32,TSPB,46509,20739,25770,66,100,200
SteepestLS_Edges_Random_start33,TSPB,47009,20998,26011,58,100,200
SteepestLS_Edges_Random_start34,TSPB,47155,20931,26224,58,100,200
SteepestLS_Edges_Random_start35,TSPB,47735,21396,26339,64,100,200
SteepestLS_Edges_Random_start36,TSPB,47184,21110,26074,59,100,200
SteepestLS_Edges_Random_start37,TSPB,47468,20293,27175,64,100,200
SteepestLS_Edges_Random_start38,TSPB,46995,19756,27239,58,100,200
SteepestLS_Edges_Random_start39,TSPB,50220,22121,28099,60,100,200
SteepestLS_Edges_Random_start40,TSPB,46302,20195,26107,58,100,200
SteepestLS_Edges_Random_start41,TSPB,46476,21380,25096,62,100,200
SteepestLS_Edges_Random_start42,TSPB,48624,19447,29177,57,100,200
SteepestLS_Edges_Random_start43,TSPB,48820,21139,27681,57,100,200
SteepestLS_Edges_Random_start44,TSPB,46589,19565,27024,57,100,200
SteepestLS_Edges_Random_start45,TSPB,47643,21619,26024,61,100,200
SteepestLS_Edges_Random_start46,TSPB,47857,20004,27853,58,100,200
SteepestLS_Edges_Random_start47,TSPB,49782,20596,29186,60,100,200
SteepestLS_Edges_Random_start48,TSPB,47575,20935,26640,55,100,200
SteepestLS_Edges_Random_start49,TSPB,47646,20554,27092,60,100,200
SteepestLS_Edges_Random_start50,TSPB,49932,21179,28753,52,100,200
SteepestLS_Edges_Random_start51,TSPB,48356,22261,26095,61,100,200
SteepestLS_Edges_Random_start52,TSPB,47375,21216,26159,59,100,200
SteepestLS_Edges_Random_start53,TSPB,49406,20574,28832,58,100,200
SteepestLS_Edges_Random_start54,TSPB,46344,20157,26187,58,100,200
SteepestLS_Edges_Random_start55,TSPB,49135,21255,27880,60,100,200
SteepestLS_Edges_Random_start56,TSPB,48994,22921,26073,59,100,200
SteepestLS_Edges_Random_start57,TSPB,49030,23884,25146,53,100,200
SteepestLS_Edges_Random_start58,TSPB,47938,21307,26631,61,100,200
SteepestLS_Edges_Random_start59,TSPB,49335,22012,27323,56,100,200
SteepestLS_Edges_Random_start60,TSPB,49590,21227,28363,57,100,200
SteepestLS_Edges_Random_start61,TSPB,48030,20516,27514,57,100,200
SteepestLS_Edges_Random_start62,TSPB,47527,21524,26003,65,100,200
SteepestLS_Edges_Random_start63,TSPB,47165,21373,25792,55,100,200
SteepestLS_Edges_Random_start64,TSPB,50310,21523,28787,59,100,200
SteepestLS_Edges_Random_start65,TSPB,47655,21343,26312,54,100,200
SteepestLS_Edges_Random_start66,TSPB,47700,20882,26818,61,100,200
SteepestLS_Edges_Random_start67,TSPB,49104,22113,26991,60,100,200
SteepestLS_Edges_Random_start68,TSPB,49070,21753,27317,60,100,200
SteepestLS_Edges_Random_start69,TSPB,46535,19961,26574,60,100,200
SteepestLS_Edges_Random_start70,TSPB,47695,22138,25557,62,100,200
SteepestLS_Edges_Random_start71,TSPB,50307,22367,27940,55,100,200
SteepestLS_Edges_Random_start72,TSPB,50164,20678,29486,57,100,200
SteepestLS_Edges_Random_start73,TSPB,50687,19880,30807,57,100,200
SteepestLS_Edges_Random_start74,TSPB,48893,20107,28786,56,100,200
SteepestLS_Edges_Random_start75,TSPB,46745,20511,26234,57,100,200
SteepestLS_Edges_Random_start76,TSPB,49208,20565,28643,65,100,200
SteepestLS_Edges_Random_start77,TSPB,47887,21431,26456,58,100,200
SteepestLS_Edges_Random_start78,TSPB,46433,20169,26264,53,100,200
SteepestLS_Edges_Random_start79,TSPB,50019,22836,27183,54,100,200
SteepestLS_Edges_Random_start80,TSPB,48386,21570,26816,58,100,200
SteepestLS_Edges_Random_start81,TSPB,46807,20661,26146,57,100,200
SteepestLS_Edges_Random_start82,TSPB,47943,20661,27282,60,100,200
SteepestLS_Edges_Random_start83,TSPB,47216,20454,26762,56,100,200
SteepestLS_Edges_Random_start84,TSPB,47993,22469,25524,55,100,200
SteepestLS_Edges_Random_start85,TSPB,47850,21354,26496,54,100,200
SteepestLS_Edges_Random_start86,TSPB,48287,22602,25685,56,100,200
SteepestLS_Edges_Random_start87,TSPB,47900,22008,25892,52,100,200
SteepestLS_Edges_Random_start88,TSPB,47164,22258,24906,59,100,200
SteepestLS_Edges_Random_start89,TSPB,47311,22000,25311,52,100,200
SteepestLS_Edges_Random_start90,TSPB,47837,22370,25467,58,100,200
SteepestLS_Edges_Random_start91,TSPB,48522,21224,27298,52,100,200
SteepestLS_Edges_Random_start92,TSPB,47258,21639,25619,53,100,200
SteepestLS_Edges_Random_start93,TSPB,48452,21962,26490,58,100,200
SteepestLS_Edges_Random_start94,TSPB,48912,22104,26808,60,100,200
SteepestLS_Edges_Random_start95,TSPB,47031,20445,26586,54,100,200
SteepestLS_Edges_Random_start96,TSPB,48437,22437,26000,60,100,200
SteepestLS_Edges_Random_start97,TSPB,45939,20054,25885,55,100,200
SteepestLS_Edges_Random_start98,TSPB,48611,20771,27840,59,100,200
SteepestLS_Edges_Random_start99,TSPB,47845,20557,27288,55,100,200
SteepestLS_Edges_Random_start100,TSPB,47560,20641,26919,62,100,200
SteepestLS_Edges_Random_start101,TSPB,47466,21067,26399,58,100,200
SteepestLS_Edges_Random_start102,TSPB,48119,19714,28405,60,100,200
SteepestLS_Edges_Random_start103,TSPB,46967,19767,27200,57,100,200
SteepestLS_Edges_Random_start104,TSPB,47985,20634,27351,57,100,200
SteepestLS_Edges_Random_start105,TSPB,48208,21709,26499,55,100,200
SteepestLS_Edges_Random_start106,TSPB,47360,20786,26574,56,100,200
SteepestLS_Edges_Random_start107,TSPB,48384,20621,27763,56,100,200
SteepestLS_Edges_Random_start108,TSPB,50006,22294,27712,58,100,200
SteepestLS_Edges_Random_start109,TSPB,48198,22022,26176,57,100,200
SteepestLS_Edges_Random_start110,TSPB,48700,20812,27888,58,100,200
SteepestLS_Edges_Random_start111,TSPB,47638,21028,26610,65,100,200
SteepestLS_Edges_Random_start112,TSPB,49949,21710,28239,53,100,200
SteepestLS_Edges_Random_start113,TSPB,48925,20333,28592,52,100,200
SteepestLS_Edges_Random_start114,TSPB,47381,21194,26187,62,100,200
SteepestLS_Edges_Random_start115,TSPB,46978,21366,25612,57,100,200
SteepestLS_Edges_Random_start116,TSPB,49887,23280,26607,57,100,200
SteepestLS_Edges_Random_start117,TSPB,48732,20964,27768,54,100,200
SteepestLS_Edges_Random_start118,TSPB,49145,20682,28463,55,100,200
SteepestLS_Edges_Random_start119,TSPB,50426,21582,28844,54,100,200
SteepestLS_Edges_Random_start120,TSPB,47022,19825,27197,56,100,200
SteepestLS_Edges_Random_start121,TSPB,47345,20896,26449,60,100,200
SteepestLS_Edges_Random_start122,TSPB,47404,19882,27522,57,100,200
SteepestLS_Edges_Random_start123,TSPB,48054,21384,26670,62,100,200
SteepestLS_Edges_Random_start124,TSPB,48777,21629,27148,52,100,200
SteepestLS_Edges_Random_start125,TSPB,47739,21063,26676,59,100,200
SteepestLS_Edges_Random_start126,TSPB,47626,22642,24984,56,100,200
SteepestLS_Edges_Random_start127,TSPB,48346,21484,26862,60,100,200
SteepestLS_Edges_Random_start128,TSPB,48314,21316,26998,59,100,200
SteepestLS_Edges_Random_start129,TSPB,49143,21262,27881,60,100,200
SteepestLS_Edges_Random_start130,TSPB,48640,23009,25631,59,100,200
SteepestLS_Edges_Random_start131,TSPB,47849,22125,25724,55,100,200
SteepestLS_Edges_Random_start132,TSPB,49258,21375,27883,58,100,200
SteepestLS_Edges_Random_start133,TSPB,48904,21804,27100,54,100,200
SteepestLS_Edges_Random_start134,TSPB,49328,21239,28089,56,100,200
SteepestLS_Edges_Random_start135,TSPB,49363,20978,28385,63,100,200
SteepestLS_Edges_Random_start136,TSPB,47380,20854,26526,55,100,200
SteepestLS_Edges_Random_start137,TSPB,46344,21032,25312,57,100,200
SteepestLS_Edges_Random_start138,TSPB,48195,20754,27441,57,100,200
SteepestLS_Edges_Random_start139,TSPB,47093,19876,27217,60,100,200
SteepestLS_Edges_Random_start140,TSPB,47639,20237,27402,57,100,200
SteepestLS_Edges_Random_start141,TSPB,48215,21154,27061,54,100,200
SteepestLS_Edges_Random_start142,TSPB,46255,19016,27239,55,100,200
SteepestLS_Edges_Random_start143,TSPB,49373,20637,28736,61,100,200
SteepestLS_Edges_Random_start144,TSPB,47049,20928,26121,56,100,200
SteepestLS_Edges_Random_start145,TSPB,48211,22183,26028,55,100,200
SteepestLS_Edges_Random_start146,TSPB,49703,22543,27160,52,100,200
SteepestLS_Edges_Random_start147,TSPB,47675,19957,27718,64,100,200
SteepestLS_Edges_Random_start148,TSPB,48733,21132,27601,58,100,200
SteepestLS_Edges_Random_start149,TSPB,48640,21528,27112,56,100,200
SteepestLS_Edges_Random_start150,TSPB,48027,21294,26733,56,100,200
SteepestLS_Edges_Random_start151,TSPB,49258,21535,27723,56,100,200
SteepestLS_Edges_Random_start152,TSPB,47215,21250,25965,53,100,200
SteepestLS_Edges_Random_start153,TSPB,47591,19601,27990,58,100,200
SteepestLS_Edges_Random_start154,TSPB,46527,19884,26643,55,100,200
SteepestLS_Edges_Random_start155,TSPB,48338,21352,26986,59,100,200
SteepestLS_Edges_Random_start156,TSPB,49753,22168,27585,56,100,200
SteepestLS_Edges_Random_start157,TSPB,46609,20315,26294,64,100,200
SteepestLS_Edges_Random_start158,TSPB,49181,21712,27469,60,100,200
SteepestLS_Edges_Random_start159,TSPB,48002,20592,27410,51,100,200
SteepestLS_Edges_Random_start160,TSPB,49237,20534,28703,54,100,200
SteepestLS_Edges_Random_start161,TSPB,47237,21669,25568,55,100,200
SteepestLS_Edges_Random_start162,TSPB,46840,20665,26175,58,100,200
SteepestLS_Edges_Random_start163,TSPB,47701,21162,26539,54,100,200
SteepestLS_Edges_Random_start164,TSPB,48170,21797,26373,59,100,200
SteepestLS_Edges_Random_start165,TSPB,47125,19935,27190,59,100,200
SteepestLS_Edges_Random_start166,TSPB,47056,20537,26519,60,100,200
SteepestLS_Edges_Random_start167,TSPB,49571,23318,26253,57,100,200
SteepestLS_Edges_Random_start168,TSPB,47335,20624,26711,57,100,200
SteepestLS_Edges_Random_start169,TSPB,49632,21745,27887,54,100,200
SteepestLS_Edges_Random_start170,TSPB,46811,21144,25667,62,100,200
SteepestLS_Edges_Random_start171,TSPB,48719,21748,26971,54,100,200
SteepestLS_Edges_Random_start172,TSPB,48798,21139,27659,52,100,200
SteepestLS_Edges_Random_start173,TSPB,48842,21866,26976,53,100,200
SteepestLS_Edges_Random_start174,TSPB,48570,20984,27586,57,100,200
SteepestLS_Edges_Random_start175,TSPB,48721,21258,27463,54,100,200
SteepestLS_Edges_Random_start176,TSPB,47990,21117,26873,56,100,200
SteepestLS_Edges_Random_start177,TSPB,48140,20045,28095,59,100,200
SteepestLS_Edges_Random_start178,TSPB,47346,20387,26959,59,100,200
SteepestLS_Edges_Random_start179,TSPB,47566,21236,26330,55,100,200
SteepestLS_Edges_Random_start180,TSPB,46623,20909,25714,60,100,200
SteepestLS_Edges_Random_start181,TSPB,47640,22269,25371,60,100,200
SteepestLS_Edges_Random_start182,TSPB,47975,20580,27395,65,100,200
SteepestLS_Edges_Random_start183,TSPB,48441,21063,27378,67,100,200
SteepestLS_Edges_Random_start184,TSPB,48383,21917,26466,64,100,200
SteepestLS_Edges_Random_start185,TSPB,50795,20682,30113,57,100,200
SteepestLS_Edges_Random_start186,TSPB,49932,22140,27792,59,100,200
SteepestLS_Edges_Random_start187,TSPB,46818,19966,26852,62,100,200
SteepestLS_Edges_Random_start188,TSPB,47421,21534,25887,58,100,200
SteepestLS_Edges_Random_start189,TSPB,47144,21708,25436,58,100,200
SteepestLS_Edges_Random_start190,TSPB,47434,19932,27502,59,100,200
SteepestLS_Edges_Random_start191,TSPB,49474,21253,28221,52,100,200
SteepestLS_Edges_Random_start192,TSPB,47848,22682,25166,60,100,200
SteepestLS_Edges_Random_start193,TSPB,48455,21500,26955,57,100,200
SteepestLS_Edges_Random_start194,TSPB,49165,21757,27408,57,100,200
SteepestLS_Edges_Random_start195,TSPB,48823,21730,27093,57,100,200
SteepestLS_Edges_Random_start196,TSPB,47161,22154,25007,63,100,200
SteepestLS_Edges_Random_start197,TSPB,49744,22831,26913,60,100,200
SteepestLS_Edges_Random_start198,TSPB,49648,21607,28041,57,100,200
SteepestLS_Edges_Random_start199,TSPB,47602,22741,24861,59,100,200
SteepestLS_Edges_GreedyCycle_start0,TSPB,52539,19430,33109,36,100,200
SteepestLS_Edges_GreedyCycle_start1,TSPB,52493,19511,32982,36,100,200
SteepestLS_Edges_GreedyCycle_start2,TSPB,47752,19531,28221,35,100,200
SteepestLS_Edges_GreedyCycle_start3,TSPB,51162,18933,32229,35,100,200
SteepestLS_Edges_GreedyCycle_start4,TSPB,50889,20444,30445,34,100,200
SteepestLS_Edges_GreedyCycle_start5,TSPB,52193,19482,32711,35,100,200
SteepestLS_Edges_GreedyCycle_start6,TSPB,50218,18904,31314,39,100,200
SteepestLS_Edges_GreedyCycle_start7,TSPB,45095,19480,25615,33,100,200
SteepestLS_Edges_GreedyCycle_start8,TSPB,49220,21363,27857,37,100,200
SteepestLS_Edges_GreedyCycle_start9,TSPB,50394,18696,31698,37,100,200
SteepestLS_Edges_GreedyCycle_start10,TSPB,51855,20865,30990,30,100,200
SteepestLS_Edges_GreedyCycle_start11,TSPB,47914,20122,27792,37,100,200
SteepestLS_Edges_GreedyCycle_start12,TSPB,50528,18721,31807,34,100,200
SteepestLS_Edges_GreedyCycle_start13,TSPB,49476,20486,28990,32,100,200
SteepestLS_Edges_GreedyCycle_start14,TSPB,47847,20116,27731,36,100,200
SteepestLS_Edges_GreedyCycle_start15,TSPB,49016,20031,28985,34,100,200
SteepestLS_Edges_GreedyCycle_start16,TSPB,49209,20403,28806,34,100,200
SteepestLS_Edges_GreedyCycle_start17,TSPB,48859,20135,28724,36,100,200
SteepestLS_Edges_GreedyCycle_start18,TSPB,49493,18631,30862,36,100,200
SteepestLS_Edges_GreedyCycle_start19,TSPB,54389,19401,34988,35,100,200
SteepestLS_Edges_GreedyCycle_start20,TSPB,45755,19954,25801,43,100,200
SteepestLS_Edges_GreedyCycle_start21,TSPB,47663,22535,25128,35,100,200
SteepestLS_Edges_GreedyCycle_start22,TSPB,47767,20792,26975,38,100,200
SteepestLS_Edges_GreedyCycle_start23,TSPB,52628,19281,33347,37,100,200
SteepestLS_Edges_GreedyCycle_start24,TSPB,54965,19447,35518,35,100,200
SteepestLS_Edges_GreedyCycle_start25,TSPB,46399,20828,25571,34,100,200
SteepestLS_Edges_GreedyCycle_start26,TSPB,50171,19819,30352,33,100,200
SteepestLS_Edges_GreedyCycle_start27,TSPB,55340,19516,35824,38,100,200
SteepestLS_Edges_GreedyCycle_start28,TSPB,49971,18785,31186,37,100,200
SteepestLS_Edges_GreedyCycle_start29,TSPB,49313,19663,29650,35,100,200
SteepestLS_Edges_GreedyCycle_start30,TSPB,51851,20620,31231,34,100,200
SteepestLS_Edges_GreedyCycle_start31,TSPB,49434,20037,29397,39,100,200
SteepestLS_Edges_GreedyCycle_start32,TSPB,46454,19914,26540,35,100,200
SteepestLS_Edges_GreedyCycle_start33,TSPB,49833,21903,27930,37,100,200
SteepestLS_Edges_GreedyCycle_start34,TSPB,50169,20265,29904,36,100,200
SteepestLS_Edges_GreedyCycle_start35,TSPB,50292,21571,28721,36,100,200
SteepestLS_Edges_GreedyCycle_start36,TSPB,48408,21273,27135,35,100,200
SteepestLS_Edges_GreedyCycle_start37,TSPB,58158,18873,39285,40,100,200
SteepestLS_Edges_GreedyCycle_start38,TSPB,46895,20602,26293,37,100,200
SteepestLS_Edges_GreedyCycle_start39,TSPB,50173,19688,30485,35,100,200
SteepestLS_Edges_GreedyCycle_start40,TSPB,53410,19750,33660,35,100,200
SteepestLS_Edges_GreedyCycle_start41,TSPB,50888,19007,31881,33,100,200
SteepestLS_Edges_GreedyCycle_start42,TSPB,48393,22083,26310,33,100,200
SteepestLS_Edges_GreedyCycle_start43,TSPB,49203,21542,27661,34,100,200
SteepestLS_Edges_GreedyCycle_start44,TSPB,51507,19234,32273,50,100,200
SteepestLS_Edges_GreedyCycle_start45,TSPB,47093,20967,26126,32,100,200
SteepestLS_Edges_GreedyCycle_start46,TSPB,50756,20292,30464,33,100,200
SteepestLS_Edges_GreedyCycle_start47,TSPB,47833,20083,27750,33,100,200
SteepestLS_Edges_GreedyCycle_start48,TSPB,50203,18903,31300,40,100,200
SteepestLS_Edges_GreedyCycle_start49,TSPB,50996,19010,31986,32,100,200
SteepestLS_Edges_GreedyCycle_start50,TSPB,47847,20116,27731,36,100,200
SteepestLS_Edges_GreedyCycle_start51,TSPB,55616,19019,36597,42,100,200
SteepestLS_Edges_GreedyCycle_start52,TSPB,50096,19480,30616,33,100,200
SteepestLS_Edges_GreedyCycle_start53,TSPB,47269,19330,27939,36,100,200
SteepestLS_Edges_GreedyCycle_start54,TSPB,49434,20037,29397,36,100,200
SteepestLS_Edges_GreedyCycle_start55,TSPB,49493,18631,30862,39,100,200
SteepestLS_Edges_GreedyCycle_start56,TSPB,48666,21485,27181,35,100,200
SteepestLS_Edges_GreedyCycle_start57,TSPB,49919,18702,31217,35,100,200
SteepestLS_Edges_GreedyCycle_start58,TSPB,49453,20336,29117,36,100,200
SteepestLS_Edges_GreedyCycle_start59,TSPB,51100,18332,32768,43,100,200
SteepestLS_Edges_GreedyCycle_start60,TSPB,52120,18801,33319,36,100,200
SteepestLS_Edges_GreedyCycle_start61,TSPB,50898,19340,31558,38,100,200
SteepestLS_Edges_GreedyCycle_start62,TSPB,49994,19157,30837,35,100,200
SteepestLS_Edges_GreedyCycle_start63,TSPB,48402,18616,29786,35,100,200
SteepestLS_Edges_GreedyCycle_start64,TSPB,51316,18928,32388,35,100,200
SteepestLS_Edges_GreedyCycle_start65,TSPB,50501,20247,30254,33,100,200
SteepestLS_Edges_GreedyCycle_start66,TSPB,50587,19976,30611,36,100,200
SteepestLS_Edges_GreedyCycle_start67,TSPB,56377,19076,37301,37,100,200
SteepestLS_Edges_GreedyCycle_start68,TSPB,51189,19236,31953,37,100,200
SteepestLS_Edges_GreedyCycle_start69,TSPB,50195,21018,29177,33,100,200
SteepestLS_Edges_GreedyCycle_start70,TSPB,49660,18828,30832,35,100,200
SteepestLS_Edges_GreedyCycle_start71,TSPB,55323,19483,35840,41,100,200
SteepestLS_Edges_GreedyCycle_start72,TSPB,55701,19334,36367,38,100,200
SteepestLS_Edges_GreedyCycle_start73,TSPB,53670,18328,35342,33,100,200
SteepestLS_Edges_GreedyCycle_start74,TSPB,48899,20576,28323,37,100,200
SteepestLS_Edges_GreedyCycle_start75,TSPB,48949,20374,28575,36,100,200
SteepestLS_Edges_GreedyCycle_start76,TSPB,50270,19536,30734,37,100,200
SteepestLS_Edges_GreedyCycle_start77,TSPB,49384,19913,29471,35,100,200
SteepestLS_Edges_GreedyCycle_start78,TSPB,48698,21417,27281,40,100,200
SteepestLS_Edges_GreedyCycle_start79,TSPB,51171,22079,29092,34,100,200
SteepestLS_Edges_GreedyCycle_start80,TSPB,51289,19968,31321,34,100,200
SteepestLS_Edges_GreedyCycle_start81,TSPB,49562,19329,30233,38,100,200
SteepestLS_Edges_GreedyCycle_start82,TSPB,57235,19797,37438,36,100,200
SteepestLS_Edges_GreedyCycle_start83,TSPB,50315,17413,32902,36,100,200
SteepestLS_Edges_GreedyCycle_start84,TSPB,50795,19997,30798,31,100,200
SteepestLS_Edges_GreedyCycle_start85,TSPB,54475,20119,34356,32,100,200
SteepestLS_Edges_GreedyCycle_start86,TSPB,50208,18670,31538,33,100,200
SteepestLS_Edges_GreedyCycle_start87,TSPB,51046,23109,27937,32,100,200
SteepestLS_Edges_GreedyCycle_start88,TSPB,50166,19201,30965,36,100,200
SteepestLS_Edges_GreedyCycle_start89,TSPB,49707,18956,30751,39,100,200
SteepestLS_Edges_GreedyCycle_start90,TSPB,57266,18048,39218,36,100,200
SteepestLS_Edges_GreedyCycle_start91,TSPB,48408,21273,27135,35,100,200
SteepestLS_Edges_GreedyCycle_start92,TSPB,49240,20326,28914,36,100,200
SteepestLS_Edges_GreedyCycle_start93,TSPB,49765,19831,29934,33,100,200
SteepestLS_Edges_GreedyCycle_start94,TSPB,48949,21454,27495,34,100,200
SteepestLS_Edges_GreedyCycle_start95,TSPB,51660,19959,31701,35,100,200
SteepestLS_Edges_GreedyCycle_start96,TSPB,48588,20541,28047,38,100,200
SteepestLS_Edges_GreedyCycle_start97,TSPB,49384,19913,29471,35,100,200
SteepestLS_Edges_GreedyCycle_start98,TSPB,50750,19844,30906,37,100,200
SteepestLS_Edges_GreedyCycle_start99,TSPB,50870,19420,31450,38,100,200
SteepestLS_Edges_GreedyCycle_start100,TSPB,55063,19060,36003,40,100,200
SteepestLS_Edges_GreedyCycle_start101,TSPB,51277,18496,32781,42,100,200
SteepestLS_Edges_GreedyCycle_start102,TSPB,49776,20489,29287,31,100,200
SteepestLS_Edges_GreedyCycle_start103,TSPB,50458,19027,31431,37,100,200
SteepestLS_Edges_GreedyCycle_start104,TSPB,48554,21879,26675,38,100,200
SteepestLS_Edges_GreedyCycle_start105,TSPB,46196,19778,26418,32,100,200
SteepestLS_Edges_GreedyCycle_start106,TSPB,52096,18925,33171,35,100,200
SteepestLS_Edges_GreedyCycle_start107,TSPB,54718,18141,36577,40,100,200
SteepestLS_Edges_GreedyCycle_start108,TSPB,50131,21210,28921,33,100,200
SteepestLS_Edges_GreedyCycle_start109,TSPB,52539,19430,33109,39,100,200
SteepestLS_Edges_GreedyCycle_start110,TSPB,49674,22062,27612,40,100,200
SteepestLS_Edges_GreedyCycle_start111,TSPB,50192,18607,31585,38,100,200
SteepestLS_Edges_GreedyCycle_start112,TSPB,51785,19146,32639,33,100,200
SteepestLS_Edges_GreedyCycle_start113,TSPB,50029,18809,31220,40,100,200
SteepestLS_Edges_GreedyCycle_start114,TSPB,49394,18603,30791,35,100,200
SteepestLS_Edges_GreedyCycle_start115,TSPB,52474,20396,32078,33,100,200
SteepestLS_Edges_GreedyCycle_start116,TSPB,54852,18585,36267,37,100,200
SteepestLS_Edges_GreedyCycle_start117,TSPB,47346,19493,27853,31,100,200
SteepestLS_Edges_GreedyCycle_start118,TSPB,52917,19748,33169,36,100,200
SteepestLS_Edges_GreedyCycle_start119,TSPB,49327,18664,30663,32,100,200
SteepestLS_Edges_GreedyCycle_start120,TSPB,55578,19242,36336,41,100,200
SteepestLS_Edges_GreedyCycle_start121,TSPB,49588,21073,28515,32,100,200
SteepestLS_Edges_GreedyCycle_start122,TSPB,52523,20550,31973,36,100,200
SteepestLS_Edges_GreedyCycle_start123,TSPB,46042,19710,26332,38,100,200
SteepestLS_Edges_GreedyCycle_start124,TSPB,50586,19216,31370,34,100,200
SteepestLS_Edges_GreedyCycle_start125,TSPB,50635,20806,29829,34,100,200
SteepestLS_Edges_GreedyCycle_start126,TSPB,49476,20486,28990,29,100,200
SteepestLS_Edges_GreedyCycle_start127,TSPB,51615,19369,32246,38,100,200
SteepestLS_Edges_GreedyCycle_start128,TSPB,48604,21042,27562,36,100,200
SteepestLS_Edges_GreedyCycle_start129,TSPB,50165,17592,32573,36,100,200
SteepestLS_Edges_GreedyCycle_start130,TSPB,49786,19292,30494,37,100,200
SteepestLS_Edges_GreedyCycle_start131,TSPB,48594,18604,29990,37,100,200
SteepestLS_Edges_GreedyCycle_start132,TSPB,49768,18232,31536,36,100,200
SteepestLS_Edges_GreedyCycle_start133,TSPB,47910,20754,27156,37,100,200
SteepestLS_Edges_GreedyCycle_start134,TSPB,50077,18754,31323,35,100,200
SteepestLS_Edges_GreedyCycle_start135,TSPB,52523,20550,31973,35,100,200
SteepestLS_Edges_GreedyCycle_start136,TSPB,53891,21137,32754,34,100,200
SteepestLS_Edges_GreedyCycle_start137,TSPB,48607,19068,29539,37,100,200
SteepestLS_Edges_GreedyCycle_start138,TSPB,49202,20047,29155,33,100,200
SteepestLS_Edges_GreedyCycle_start139,TSPB,48694,21151,27543,33,100,200
SteepestLS_Edges_GreedyCycle_start140,TSPB,48628,20277,28351,36,100,200
SteepestLS_Edges_GreedyCycle_start141,TSPB,50542,20094,30448,39,100,200
SteepestLS_Edges_GreedyCycle_start142,TSPB,50192,19826,30366,34,100,200
SteepestLS_Edges_GreedyCycle_start143,TSPB,49419,20136,29283,38,100,200
SteepestLS_Edges_GreedyCycle_start144,TSPB,54290,20733,33557,36,100,200
SteepestLS_Edges_GreedyCycle_start145,TSPB,49660,18828,30832,35,100,200
SteepestLS_Edges_GreedyCycle_start146,TSPB,47986,19951,28035,33,100,200
SteepestLS_Edges_GreedyCycle_start147,TSPB,55762,18477,37285,36,100,200
SteepestLS_Edges_GreedyCycle_start148,TSPB,47833,20083,27750,33,100,200
SteepestLS_Edges_GreedyCycle_start149,TSPB,50297,18810,31487,36,100,200
SteepestLS_Edges_GreedyCycle_start150,TSPB,49697,20683,29014,34,100,200
SteepestLS_Edges_GreedyCycle_start151,TSPB,47922,21528,26394,35,100,200
SteepestLS_Edges_GreedyCycle_start152,TSPB,47243,18655,28588,35,100,200
SteepestLS_Edges_GreedyCycle_start153,TSPB,49745,18720,31025,34,100,200
SteepestLS_Edges_GreedyCycle_start154,TSPB,48473,19920,28553,31,100,200
SteepestLS_Edges_GreedyCycle_start155,TSPB,49978,20167,29811,43,100,200
SteepestLS_Edges_GreedyCycle_start156,TSPB,47627,21479,26148,33,100,200
SteepestLS_Edges_GreedyCycle_start157,TSPB,49010,19020,29990,33,100,200
SteepestLS_Edges_GreedyCycle_start158,TSPB,54327,18801,35526,38,100,200
SteepestLS_Edges_GreedyCycle_start159,TSPB,49485,18886,30599,36,100,200
SteepestLS_Edges_GreedyCycle_start160,TSPB,58100,18698,39402,33,100,200
SteepestLS_Edges_GreedyCycle_start161,TSPB,50837,19224,31613,29,100,200
SteepestLS_Edges_GreedyCycle_start162,TSPB,49348,21878,27470,35,100,200
SteepestLS_Edges_GreedyCycle_start163,TSPB,49266,18205,31061,38,100,200
SteepestLS_Edges_GreedyCycle_start164,TSPB,48861,20351,28510,34,100,200
SteepestLS_Edges_GreedyCycle_start165,TSPB,49977,20433,29544,36,100,200
SteepestLS_Edges_GreedyCycle_start166,TSPB,48767,20568,28199,31,100,200
SteepestLS_Edges_GreedyCycle_start167,TSPB,49830,21431,28399,33,100,200
SteepestLS_Edges_GreedyCycle_start168,TSPB,50286,19355,30931,30,100,200
SteepestLS_Edges_GreedyCycle_start169,TSPB,49768,18232,31536,36,100,200
SteepestLS_Edges_GreedyCycle_start170,TSPB,50663,19544,31119,36,100,200
SteepestLS_Edges_GreedyCycle_start171,TSPB,49724,19064,30660,32,100,200
SteepestLS_Edges_GreedyCycle_start172,TSPB,49634,19083,30551,36,100,200
SteepestLS_Edges_GreedyCycle_start173,TSPB,52689,21124,31565,34,100,200
SteepestLS_Edges_GreedyCycle_start174,TSPB,50687,18926,31761,28,100,200
SteepestLS_Edges_GreedyCycle_start175,TSPB,51389,19821,31568,37,100,200
SteepestLS_Edges_GreedyCycle_start176,TSPB,50716,18665,32051,37,100,200
SteepestLS_Edges_GreedyCycle_start177,TSPB,50365,20180,30185,34,100,200
SteepestLS_Edges_GreedyCycle_start178,TSPB,52028,20281,31747,33,100,200
SteepestLS_Edges_GreedyCycle_start179,TSPB,49109,18703,30406,38,100,200
SteepestLS_Edges_GreedyCycle_start180,TSPB,48675,20025,28650,34,100,200
SteepestLS_Edges_GreedyCycle_start181,TSPB,51314,20628,30686,31,100,200
SteepestLS_Edges_GreedyCycle_start182,TSPB,49845,20488,29357,35,100,200
SteepestLS_Edges_GreedyCycle_start183,TSPB,47319,19967,27352,36,100,200
SteepestLS_Edges_GreedyCycle_start184,TSPB,48005,20012,27993,33,100,200
SteepestLS_Edges_GreedyCycle_start185,TSPB,50868,19595,31273,38,100,200
SteepestLS_Edges_GreedyCycle_start186,TSPB,47455,20701,26754,40,100,200
SteepestLS_Edges_GreedyCycle_start187,TSPB,50803,20381,30422,33,100,200
SteepestLS_Edges_GreedyCycle_start188,TSPB,50569,20505,30064,33,100,200
SteepestLS_Edges_GreedyCycle_start189,TSPB,50791,19895,30896,34,100,200
SteepestLS_Edges_GreedyCycle_start190,TSPB,53891,21137,32754,36,100,200
SteepestLS_Edges_GreedyCycle_start191,TSPB,52518,20660,31858,33,100,200
SteepestLS_Edges_GreedyCycle_start192,TSPB,49840,20826,29014,33,100,200
SteepestLS_Edges_GreedyCycle_start193,TSPB,50852,18868,31984,41,100,200
SteepestLS_Edges_GreedyCycle_start194,TSPB,50716,18665,32051,34,100,200
SteepestLS_Edges_GreedyCycle_start195,TSPB,49476,20486,28990,32,100,200
SteepestLS_Edges_GreedyCycle_start196,TSPB,54687,18035,36652,36,100,200
SteepestLS_Edges_GreedyCycle_start197,TSPB,52628,19168,33460,37,100,200
SteepestLS_Edges_GreedyCycle_start198,TSPB,47346,19493,27853,31,100,200
SteepestLS_Edges_GreedyCycle_start199,TSPB,47038,19877,27161,41,100,200
GreedyLS_Nodes_Random_start0,TSPB,59517,33156,26361,211,100,200
GreedyLS_Nodes_Random_start1,TSPB,59195,33077,26118,194,100,200
GreedyLS_Nodes_Random_start2,TSPB,63039,37366,25673,210,100,200
GreedyLS_Nodes_Random_start3,TSPB,59809,32435,27374,214,100,200
GreedyLS_Nodes_Random_start4,TSPB,64106,35321,28785,209,100,200
GreedyLS_Nodes_Random_start5,TSPB,63917,34743,29174,212,100,200
GreedyLS_Nodes_Random_start6,TSPB,67168,40242,26926,212,100,200
GreedyLS_Nodes_Random_start7,TSPB,63256,36014,27242,202,100,200
GreedyLS_Nodes_Random_start8,TSPB,57664,31900,25764,208,100,200
GreedyLS_Nodes_Random_start9,TSPB,62542,35532,27010,209,100,200
GreedyLS_Nodes_Random_start10,TSPB,59264,33245,26019,232,100,200
GreedyLS_Nodes_Random_start11,TSPB,60867,34209,26658,202,100,200
GreedyLS_Nodes_Random_start12,TSPB,60201,34756,25445,239,100,200
GreedyLS_Nodes_Random_start13,TSPB,56971,29928,27043,208,100,200
GreedyLS_Nodes_Random_start14,TSPB,60847,31550,29297,241,100,200
GreedyLS_Nodes_Random_start15,TSPB,58243,30935,27308,209,100,200
GreedyLS_Nodes_Random_start16,TSPB,63738,35723,28015,230,100,200
GreedyLS_Nodes_Random_start17,TSPB,64682,38666,26016,218,100,200
GreedyLS_Nodes_Random_start18,TSPB,57237,31636,25601,248,100,200
GreedyLS_Nodes_Random_start19,TSPB,62879,36790,26089,199,100,200
GreedyLS_Nodes_Random_start20,TSPB,65158,39563,25595,207,100,200
GreedyLS_Nodes_Random_start21,TSPB,54575,27977,26598,240,100,200
GreedyLS_Nodes_Random_start22,TSPB,60439,33828,26611,200,100,200
GreedyLS_Nodes_Random_start23,TSPB,60676,36051,24625,-2113,100,200
GreedyLS_Nodes_Random_start24,TSPB,62317,36945,25372,183,100,200
GreedyLS_Nodes_Random_start25,TSPB,63576,37831,25745,208,100,200
GreedyLS_Nodes_Random_start26,TSPB,66092,40310,25782,197,100,200
GreedyLS_Nodes_Random_start27,TSPB,59603,34409,25194,212,100,200
GreedyLS_Nodes_Random_start28,TSPB,63697,38248,25449,240,100,200
GreedyLS_Nodes_Random_start29,TSPB,59166,33920,25246,217,100,200
GreedyLS_Nodes_Random_start30,TSPB,62239,35332,26907,222,100,200
GreedyLS_Nodes_Random_start31,TSPB,59577,33365,26212,220,100,200
GreedyLS_Nodes_Random_start32,TSPB,60612,32704,27908,196,100,200
GreedyLS_Nodes_Random_start33,TSPB,59964,34711,25253,204,100,200
GreedyLS_Nodes_Random_start34,TSPB,60585,33496,27089,208,100,200
GreedyLS_Nodes_Random_start35,TSPB,61379,33365,28014,186,100,200
GreedyLS_Nodes_Random_start36,TSPB,59612,33607,26005,208,100,200
GreedyLS_Nodes_Random_start37,TSPB,60274,34446,25828,208,100,200
GreedyLS_Nodes_Random_start38,TSPB,63124,35902,27222,199,100,200
GreedyLS_Nodes_Random_start39,TSPB,62301,36465,25836,225,100,200
GreedyLS_Nodes_Random_start40,TSPB,61664,35300,26364,204,100,200
GreedyLS_Nodes_Random_start41,TSPB,63743,35464,28279,212,100,200
GreedyLS_Nodes_Random_start42,TSPB,62409,35849,26560,210,100,200
GreedyLS_Nodes_Random_start43,TSPB,67097,40532,26565,216,100,200
GreedyLS_Nodes_Random_start44,TSPB,66047,38343,27704,208,100,200
GreedyLS_Nodes_Random_start45,TSPB,64569,38467,26102,204,100,200
GreedyLS_Nodes_Random_start46,TSPB,65084,39341,25743,201,100,200
GreedyLS_Nodes_Random_start47,TSPB,60648,34182,26466,222,100,200
GreedyLS_Nodes_Random_start48,TSPB,62278,35947,26331,214,100,200
GreedyLS_Nodes_Random_start49,TSPB,56187,29558,26629,226,100,200
GreedyLS_Nodes_Random_start50,TSPB,59609,34501,25108,203,100,200
GreedyLS_Nodes_Random_start51,TSPB,59275,32929,26346,219,100,200
GreedyLS_Nodes_Random_start52,TSPB,64817,38300,26517,202,100,200
GreedyLS_Nodes_Random_start53,TSPB,64634,36017,28617,211,100,200
GreedyLS_Nodes_Random_start54,TSPB,60281,35317,24964,200,100,200
GreedyLS_Nodes_Random_start55,TSPB,61826,36922,24904,221,100,200
GreedyLS_Nodes_Random_start56,TSPB,62176,36039,26137,217,100,200
GreedyLS_Nodes_Random_start57,TSPB,60279,32933,27346,198,100,200
GreedyLS_Nodes_Random_start58,TSPB,60645,36202,24443,233,100,200
GreedyLS_Nodes_Random_start59,TSPB,58799,31965,26834,236,100,200
GreedyLS_Nodes_Random_start60,TSPB,63837,39082,24755,214,100,200
GreedyLS_Nodes_Random_start61,TSPB,59293,33367,25926,193,100,200
GreedyLS_Nodes_Random_start62,TSPB,65720,38334,27386,197,100,200
GreedyLS_Nodes_Random_start63,TSPB,58900,33596,25304,199,100,200
GreedyLS_Nodes_Random_start64,TSPB,60177,34898,25279,223,100,200
GreedyLS_Nodes_Random_start65,TSPB,64168,38642,25526,223,100,200
GreedyLS_Nodes_Random_start66,TSPB,63746,33531,30215,215,100,200
GreedyLS_Nodes_Random_start67,TSPB,62806,36422,26384,212,100,200
GreedyLS_Nodes_Random_start68,TSPB,60453,35011,25442,205,100,200
GreedyLS_Nodes_Random_start69,TSPB,60205,33461,26744,224,100,200
GreedyLS_Nodes_Random_start70,TSPB,60605,35005,25600,215,100,200
GreedyLS_Nodes_Random_start71,TSPB,62492,34588,27904,217,100,200
GreedyLS_Nodes_Random_start72,TSPB,63844,38357,25487,238,100,200
GreedyLS_Nodes_Random_start73,TSPB,58431,30829,27602,214,100,200
GreedyLS_Nodes_Random_start74,TSPB,60173,35141,25032,207,100,200
GreedyLS_Nodes_Random_start75,TSPB,61041,30446,30595,227,100,200
GreedyLS_Nodes_Random_start76,TSPB,60655,30799,29856,245,100,200
GreedyLS_Nodes_Random_start77,TSPB,59800,33553,26247,210,100,200
GreedyLS_Nodes_Random_start78,TSPB,62383,35913,26470,231,100,200
GreedyLS_Nodes_Random_start79,TSPB,57774,31990,25784,229,100,200
GreedyLS_Nodes_Random_start80,TSPB,60795,34992,25803,204,100,200
GreedyLS_Nodes_Random_start81,TSPB,61474,34422,27052,201,100,200
GreedyLS_Nodes_Random_start82,TSPB,63308,36733,26575,228,100,200
GreedyLS_Nodes_Random_start83,TSPB,63560,35532,28028,200,100,200
GreedyLS_Nodes_Random_start84,TSPB,58387,32585,25802,262,100,200
GreedyLS_Nodes_Random_start85,TSPB,63530,37432,26098,189,100,200
GreedyLS_Nodes_Random_start86,TSPB,66864,37631,29233,213,100,200
GreedyLS_Nodes_Random_start87,TSPB,60145,33410,26735,196,100,200
GreedyLS_Nodes_Random_start88,TSPB,60654,32310,28344,225,100,200
GreedyLS_Nodes_Random_start89,TSPB,65997,39535,26462,230,100,200
GreedyLS_Nodes_Random_start90,TSPB,59271,34388,24883,217,100,200
GreedyLS_Nodes_Random_start91,TSPB,65658,39952,25706,186,100,200
GreedyLS_Nodes_Random_start92,TSPB,56672,31005,25667,213,100,200
GreedyLS_Nodes_Random_start93,TSPB,62212,36338,25874,233,100,200
GreedyLS_Nodes_Random_start94,TSPB,61814,36273,25541,241,100,200
GreedyLS_Nodes_Random_start95,TSPB,62605,37181,25424,205,100,200
GreedyLS_Nodes_Random_start96,TSPB,56873,30235,26638,216,100,200
GreedyLS_Nodes_Random_start97,TSPB,61966,32748,29218,208,100,200
GreedyLS_Nodes_Random_start98,TSPB,57879,31557,26322,219,100,200
GreedyLS_Nodes_Random_start99,TSPB,58664,30493,28171,227,100,200
GreedyLS_Nodes_Random_start100,TSPB,53759,25922,27837,227,100,200
GreedyLS_Nodes_Random_start101,TSPB,60517,31381,29136,209,100,200
GreedyLS_Nodes_Random_start102,TSPB,58062,32700,25362,208,100,200
GreedyLS_Nodes_Random_start103,TSPB,59106,31691,27415,211,100,200
GreedyLS_Nodes_Random_start104,TSPB,57827,29493,28334,216,100,200
GreedyLS_Nodes_Random_start105,TSPB,54464,28043,26421,221,100,200
GreedyLS_Nodes_Random_start106,TSPB,57449,30990,26459,238,100,200
GreedyLS_Nodes_Random_start107,TSPB,62623,36714,25909,220,100,200
GreedyLS_Nodes_Random_start108,TSPB,62703,34465,28238,240,100,200
GreedyLS_Nodes_Random_start109,TSPB,63862,35812,28050,183,100,200
GreedyLS_Nodes_Random_start110,TSPB,60798,33695,27103,217,100,200
GreedyLS_Nodes_Random_start111,TSPB,59827,34769,25058,230,100,200
GreedyLS_Nodes_Random_start112,TSPB,62586,36622,25964,221,100,200
GreedyLS_Nodes_Random_start113,TSPB,61146,36447,24699,225,100,200
GreedyLS_Nodes_Random_start114,TSPB,58615,31853,26762,250,100,200
GreedyLS_Nodes_Random_start115,TSPB,59801,33849,25952,226,100,200
GreedyLS_Nodes_Random_start116,TSPB,61090,34795,26295,198,100,200
GreedyLS_Nodes_Random_start117,TSPB,63711,34879,28832,211,100,200
GreedyLS_Nodes_Random_start118,TSPB,63517,38843,24674,217,100,200
GreedyLS_Nodes_Random_start119,TSPB,60246,34873,25373,224,100,200
GreedyLS_Nodes_Random_start120,TSPB,66603,38910,27693,220,100,200
GreedyLS_Nodes_Random_start121,TSPB,59689,33525,26164,217,100,200
GreedyLS_Nodes_Random_start122,TSPB,64246,39226,25020,191,100,200
GreedyLS_Nodes_Random_start123,TSPB,58247,32904,25343,196,100,200
GreedyLS_Nodes_Random_start124,TSPB,62145,36803,25342,222,100,200
GreedyLS_Nodes_Random_start125,TSPB,62362,35408,26954,208,100,200
GreedyLS_Nodes_Random_start126,TSPB,63558,34961,28597,187,100,200
GreedyLS_Nodes_Random_start127,TSPB,60048,33083,26965,225,100,200
GreedyLS_Nodes_Random_start128,TSPB,63954,36475,27479,244,100,200
GreedyLS_Nodes_Random_start129,TSPB,57256,29283,27973,216,100,200
GreedyLS_Nodes_Random_start130,TSPB,58702,33248,25454,222,100,200
GreedyLS_Nodes_Random_start131,TSPB,60426,34247,26179,199,100,200
GreedyLS_Nodes_Random_start132,TSPB,62699,35263,27436,189,100,200
GreedyLS_Nodes_Random_start133,TSPB,56370,27500,28870,185,100,200
GreedyLS_Nodes_Random_start134,TSPB,62933,35707,27226,213,100,200
GreedyLS_Nodes_Random_start135,TSPB,62885,36283,26602,220,100,200
GreedyLS_Nodes_Random_start136,TSPB,62484,35199,27285,196,100,200
GreedyLS_Nodes_Random_start137,TSPB,61234,36633,24601,201,100,200
GreedyLS_Nodes_Random_start138,TSPB,62136,34831,27305,210,100,200
GreedyLS_Nodes_Random_start139,TSPB,57840,29400,28440,214,100,200
GreedyLS_Nodes_Random_start140,TSPB,61773,33697,28076,206,100,200
GreedyLS_Nodes_Random_start141,TSPB,57665,32797,24868,220,100,200
GreedyLS_Nodes_Random_start142,TSPB,62016,36227,25789,199,100,200
GreedyLS_Nodes_Random_start143,TSPB,59653,33368,26285,228,100,200
GreedyLS_Nodes_Random_start144,TSPB,61387,34932,26455,212,100,200
GreedyLS_Nodes_Random_start145,TSPB,64826,38239,26587,249,100,200
GreedyLS_Nodes_Random_start146,TSPB,61937,34275,27662,233,100,200
GreedyLS_Nodes_Random_start147,TSPB,63206,35441,27765,206,100,200
GreedyLS_Nodes_Random_start148,TSPB,59272,33081,26191,209,100,200
GreedyLS_Nodes_Random_start149,TSPB,62917,36390,26527,231,100,200
GreedyLS_Nodes_Random_start150,TSPB,64102,38560,25542,222,100,200
GreedyLS_Nodes_Random_start151,TSPB,63684,34966,28718,204,100,200
GreedyLS_Nodes_Random_start152,TSPB,57837,30308,27529,211,100,200
GreedyLS_Nodes_Random_start153,TSPB,64254,36849,27405,204,100,200
GreedyLS_Nodes_Random_start154,TSPB,57942,30494,27448,202,100,200
GreedyLS_Nodes_Random_start155,TSPB,62483,36463,26020,211,100,200
GreedyLS_Nodes_Random_start156,TSPB,60797,33768,27029,220,100,200
GreedyLS_Nodes_Random_start157,TSPB,57333,32475,24858,213,100,200
GreedyLS_Nodes_Random_start158,TSPB,65832,37993,27839,200,100,200
GreedyLS_Nodes_Random_start159,TSPB,59634,32077,27557,222,100,200
GreedyLS_Nodes_Random_start160,TSPB,60147,34065,26082,194,100,200
GreedyLS_Nodes_Random_start161,TSPB,65699,37066,28633,213,100,200
GreedyLS_Nodes_Random_start162,TSPB,61599,36025,25574,197,100,200
GreedyLS_Nodes_Random_start163,TSPB,63246,34820,28426,200,100,200
GreedyLS_Nodes_Random_start164,TSPB,62227,35505,26722,-2060,100,200
GreedyLS_Nodes_Random_start165,TSPB,62664,33737,28927,208,100,200
GreedyLS_Nodes_Random_start166,TSPB,64216,38779,25437,192,100,200
GreedyLS_Nodes_Random_start167,TSPB,60961,34399,26562,242,100,200
GreedyLS_Nodes_Random_start168,TSPB,61446,34125,27321,232,100,200
GreedyLS_Nodes_Random_start169,TSPB,61961,34724,27237,196,100,200
GreedyLS_Nodes_Random_start170,TSPB,59835,33510,26325,211,100,200
GreedyLS_Nodes_Random_start171,TSPB,59959,32910,27049,213,100,200
GreedyLS_Nodes_Random_start172,TSPB,60044,35052,24992,196,100,200
GreedyLS_Nodes_Random_start173,TSPB,60509,35013,25496,207,100,200
GreedyLS_Nodes_Random_start174,TSPB,61664,33697,27967,193,100,200
GreedyLS_Nodes_Random_start175,TSPB,56163,30220,25943,217,100,200
GreedyLS_Nodes_Random_start176,TSPB,62203,36189,26014,195,100,200
GreedyLS_Nodes_Random_start177,TSPB,64188,36114,28074,198,100,200
GreedyLS_Nodes_Random_start178,TSPB,56332,31097,25235,231,100,200
GreedyLS_Nodes_Random_start179,TSPB,61196,34104,27092,222,100,200
GreedyLS_Nodes_Random_start180,TSPB,62831,36242,26589,187,100,200
GreedyLS_Nodes_Random_start181,TSPB,57908,33316,24592,250,100,200
GreedyLS_Nodes_Random_start182,TSPB,60302,31812,28490,216,100,200
GreedyLS_Nodes_Random_start183,TSPB,60514,32161,28353,195,100,200
GreedyLS_Nodes_Random_start184,TSPB,57018,31273,25745,216,100,200
GreedyLS_Nodes_Random_start185,TSPB,64926,39965,24961,213,100,200
GreedyLS_Nodes_Random_start186,TSPB,62460,36509,25951,200,100,200
GreedyLS_Nodes_Random_start187,TSPB,61870,36079,25791,234,100,200
GreedyLS_Nodes_Random_start188,TSPB,62997,36632,26365,224,100,200
GreedyLS_Nodes_Random_start189,TSPB,61812,35277,26535,225,100,200
GreedyLS_Nodes_Random_start190,TSPB,57615,30600,27015,236,100,200
GreedyLS_Nodes_Random_start191,TSPB,56104,28061,28043,224,100,200
GreedyLS_Nodes_Random_start192,TSPB,62003,37377,24626,216,100,200
GreedyLS_Nodes_Random_start193,TSPB,64484,38329,26155,210,100,200
GreedyLS_Nodes_Random_start194,TSPB,61561,33470,28091,260,100,200
GreedyLS_Nodes_Random_start195,TSPB,62699,34790,27909,221,100,200
GreedyLS_Nodes_Random_start196,TSPB,60423,33801,26622,236,100,200
GreedyLS_Nodes_Random_start197,TSPB,66247,40254,25993,190,100,200
GreedyLS_Nodes_Random_start198,TSPB,57354,30630,26724,234,100,200
GreedyLS_Nodes_Random_start199,TSPB,61562,34012,27550,198,100,200
GreedyLS_Nodes_GreedyCycle_start0,TSPB,56215,24624,31591,114,100,200
GreedyLS_Nodes_GreedyCycle_start1,TSPB,57037,22965,34072,90,100,200
GreedyLS_Nodes_GreedyCycle_start2,TSPB,52597,24842,27755,87,100,200
GreedyLS_Nodes_GreedyCycle_start3,TSPB,55155,24237,30918,86,100,200
GreedyLS_Nodes_GreedyCycle_start4,TSPB,52115,25821,26294,94,100,200
GreedyLS_Nodes_GreedyCycle_start5,TSPB,55830,23042,32788,97,100,200
GreedyLS_Nodes_GreedyCycle_start6,TSPB,52738,22924,29814,79,100,200
GreedyLS_Nodes_GreedyCycle_start7,TSPB,49733,24314,25419,107,100,200
GreedyLS_Nodes_GreedyCycle_start8,TSPB,50606,21566,29040,100,100,200
GreedyLS_Nodes_GreedyCycle_start9,TSPB,55287,23849,31438,92,100,200
GreedyLS_Nodes_GreedyCycle_start10,TSPB,55320,26228,29092,89,100,200
GreedyLS_Nodes_GreedyCycle_start11,TSPB,52707,25736,26971,101,100,200
GreedyLS_Nodes_GreedyCycle_start12,TSPB,54062,24197,29865,94,100,200
GreedyLS_Nodes_GreedyCycle_start13,TSPB,54785,24029,30756,85,100,200
GreedyLS_Nodes_GreedyCycle_start14,TSPB,51961,24097,27864,95,100,200
GreedyLS_Nodes_GreedyCycle_start15,TSPB,53611,25076,28535,86,100,200
GreedyLS_Nodes_GreedyCycle_start16,TSPB,53210,25924,27286,98,100,200
GreedyLS_Nodes_GreedyCycle_start17,TSPB,53280,23867,29413,99,100,200
GreedyLS_Nodes_GreedyCycle_start18,TSPB,53408,22899,30509,79,100,200
GreedyLS_Nodes_GreedyCycle_start19,TSPB,58247,24367,33880,97,100,200
GreedyLS_Nodes_GreedyCycle_start20,TSPB,50843,22868,27975,107,100,200
GreedyLS_Nodes_GreedyCycle_start21,TSPB,52050,25847,26203,90,100,200
GreedyLS_Nodes_GreedyCycle_start22,TSPB,50714,24893,25821,109,100,200
GreedyLS_Nodes_GreedyCycle_start23,TSPB,55637,23015,32622,105,100,200
GreedyLS_Nodes_GreedyCycle_start24,TSPB,57611,21151,36460,92,100,200
GreedyLS_Nodes_GreedyCycle_start25,TSPB,52791,25770,27021,101,100,200
GreedyLS_Nodes_GreedyCycle_start26,TSPB,55512,24099,31413,108,100,200
GreedyLS_Nodes_GreedyCycle_start27,TSPB,55081,23232,31849,125,100,200
GreedyLS_Nodes_GreedyCycle_start28,TSPB,53878,25075,28803,103,100,200
GreedyLS_Nodes_GreedyCycle_start29,TSPB,54948,26262,28686,111,100,200
GreedyLS_Nodes_GreedyCycle_start30,TSPB,52680,21826,30854,98,100,200
GreedyLS_Nodes_GreedyCycle_start31,TSPB,55472,26569,28903,92,100,200
GreedyLS_Nodes_GreedyCycle_start32,TSPB,53082,27623,25459,81,100,200
GreedyLS_Nodes_GreedyCycle_start33,TSPB,51666,24006,27660,110,100,200
GreedyLS_Nodes_GreedyCycle_start34,TSPB,57373,26531,30842,85,100,200
GreedyLS_Nodes_GreedyCycle_start35,TSPB,52329,24099,28230,96,100,200
GreedyLS_Nodes_GreedyCycle_start36,TSPB,51045,26310,24735,103,100,200
GreedyLS_Nodes_GreedyCycle_start37,TSPB,57814,23036,34778,115,100,200
GreedyLS_Nodes_GreedyCycle_start38,TSPB,53296,26423,26873,101,100,200
GreedyLS_Nodes_GreedyCycle_start39,TSPB,54607,23792,30815,108,100,200
GreedyLS_Nodes_GreedyCycle_start40,TSPB,53642,23670,29972,109,100,200
GreedyLS_Nodes_GreedyCycle_start41,TSPB,55625,26803,28822,93,100,200
GreedyLS_Nodes_GreedyCycle_start42,TSPB,50871,24876,25995,106,100,200
GreedyLS_Nodes_GreedyCycle_start43,TSPB,49050,22758,26292,104,100,200
GreedyLS_Nodes_GreedyCycle_start44,TSPB,55810,24230,31580,100,100,200
GreedyLS_Nodes_GreedyCycle_start45,TSPB,48720,22569,26151,100,100,200
GreedyLS_Nodes_GreedyCycle_start46,TSPB,53607,24778,28829,99,100,200
GreedyLS_Nodes_GreedyCycle_start47,TSPB,53093,24856,28237,80,100,200
GreedyLS_Nodes_GreedyCycle_start48,TSPB,52770,23653,29117,116,100,200
GreedyLS_Nodes_GreedyCycle_start49,TSPB,53368,21734,31634,91,100,200
GreedyLS_Nodes_GreedyCycle_start50,TSPB,53698,24725,28973,99,100,200
GreedyLS_Nodes_GreedyCycle_start51,TSPB,59333,28722,30611,104,100,200
GreedyLS_Nodes_GreedyCycle_start52,TSPB,56462,26400,30062,104,100,200
GreedyLS_Nodes_GreedyCycle_start53,TSPB,50605,23486,27119,99,100,200
GreedyLS_Nodes_GreedyCycle_start54,TSPB,54945,26135,28810,105,100,200
GreedyLS_Nodes_GreedyCycle_start55,TSPB,52794,23057,29737,81,100,200
GreedyLS_Nodes_GreedyCycle_start56,TSPB,51564,25273,26291,121,100,200
GreedyLS_Nodes_GreedyCycle_start57,TSPB,56827,26660,30167,91,100,200
GreedyLS_Nodes_GreedyCycle_start58,TSPB,52651,21401,31250,84,100,200
GreedyLS_Nodes_GreedyCycle_start59,TSPB,54392,23661,30731,118,100,200
GreedyLS_Nodes_GreedyCycle_start60,TSPB,57768,24218,33550,84,100,200
GreedyLS_Nodes_GreedyCycle_start61,TSPB,53781,23758,30023,85,100,200
GreedyLS_Nodes_GreedyCycle_start62,TSPB,51800,23188,28612,99,100,200
GreedyLS_Nodes_GreedyCycle_start63,TSPB,55149,24916,30233,87,100,200
GreedyLS_Nodes_GreedyCycle_start64,TSPB,55775,24715,31060,83,100,200
GreedyLS_Nodes_GreedyCycle_start65,TSPB,54672,24997,29675,99,100,200
GreedyLS_Nodes_GreedyCycle_start66,TSPB,53987,23767,30220,119,100,200
GreedyLS_Nodes_GreedyCycle_start67,TSPB,58011,26520,31491,132,100,200
GreedyLS_Nodes_GreedyCycle_start68,TSPB,59599,29115,30484,114,100,200
GreedyLS_Nodes_GreedyCycle_start69,TSPB,52790,24510,28280,107,100,200
GreedyLS_Nodes_GreedyCycle_start70,TSPB,54827,24574,30253,100,100,200
GreedyLS_Nodes_GreedyCycle_start71,TSPB,61269,24382,36887,110,100,200
GreedyLS_Nodes_GreedyCycle_start72,TSPB,56350,21575,34775,108,100,200
GreedyLS_Nodes_GreedyCycle_start73,TSPB,56137,25629,30508,105,100,200
GreedyLS_Nodes_GreedyCycle_start74,TSPB,50402,23356,27046,125,100,200
GreedyLS_Nodes_GreedyCycle_start75,TSPB,54752,24700,30052,104,100,200
GreedyLS_Nodes_GreedyCycle_start76,TSPB,53909,24085,29824,114,100,200
GreedyLS_Nodes_GreedyCycle_start77,TSPB,53315,24085,29230,111,100,200
GreedyLS_Nodes_GreedyCycle_start78,TSPB,53330,23653,29677,88,100,200
GreedyLS_Nodes_GreedyCycle_start79,TSPB,52312,23983,28329,106,100,200
GreedyLS_Nodes_GreedyCycle_start80,TSPB,54187,23342,30845,93,100,200
GreedyLS_Nodes_GreedyCycle_start81,TSPB,55097,27089,28008,92,100,200
GreedyLS_Nodes_GreedyCycle_start82,TSPB,60059,25541,34518,97,100,200
GreedyLS_Nodes_GreedyCycle_start83,TSPB,53578,22034,31544,97,100,200
GreedyLS_Nodes_GreedyCycle_start84,TSPB,53647,22230,31417,98,100,200
GreedyLS_Nodes_GreedyCycle_start85,TSPB,55008,23743,31265,102,100,200
GreedyLS_Nodes_GreedyCycle_start86,TSPB,53454,22534,30920,97,100,200
GreedyLS_Nodes_GreedyCycle_start87,TSPB,54761,27592,27169,108,100,200
GreedyLS_Nodes_GreedyCycle_start88,TSPB,57081,27193,29888,109,100,200
GreedyLS_Nodes_GreedyCycle_start89,TSPB,54651,22417,32234,110,100,200
GreedyLS_Nodes_GreedyCycle_start90,TSPB,62129,24033,38096,98,100,200
GreedyLS_Nodes_GreedyCycle_start91,TSPB,54818,26997,27821,88,100,200
GreedyLS_Nodes_GreedyCycle_start92,TSPB,54757,25158,29599,109,100,200
GreedyLS_Nodes_GreedyCycle_start93,TSPB,54995,25207,29788,94,100,200
GreedyLS_Nodes_GreedyCycle_start94,TSPB,51160,24252,26908,99,100,200
GreedyLS_Nodes_GreedyCycle_start95,TSPB,54495,22627,31868,110,100,200
GreedyLS_Nodes_GreedyCycle_start96,TSPB,51643,23585,28058,113,100,200
GreedyLS_Nodes_GreedyCycle_start97,TSPB,54330,26510,27820,106,100,200
GreedyLS_Nodes_GreedyCycle_start98,TSPB,53233,25592,27641,109,100,200
GreedyLS_Nodes_GreedyCycle_start99,TSPB,54313,20866,33447,95,100,200
GreedyLS_Nodes_GreedyCycle_start100,TSPB,56643,23692,32951,100,100,200
GreedyLS_Nodes_GreedyCycle_start101,TSPB,53804,22477,31327,100,100,200
GreedyLS_Nodes_GreedyCycle_start102,TSPB,51207,24415,26792,104,100,200
GreedyLS_Nodes_GreedyCycle_start103,TSPB,53886,23605,30281,93,100,200
GreedyLS_Nodes_GreedyCycle_start104,TSPB,52210,25255,26955,107,100,200
GreedyLS_Nodes_GreedyCycle_start105,TSPB,50087,21934,28153,75,100,200
GreedyLS_Nodes_GreedyCycle_start106,TSPB,56900,24611,32289,114,100,200
GreedyLS_Nodes_GreedyCycle_start107,TSPB,56487,22095,34392,93,100,200
GreedyLS_Nodes_GreedyCycle_start108,TSPB,54154,22961,31193,90,100,200
GreedyLS_Nodes_GreedyCycle_start109,TSPB,56237,24628,31609,94,100,200
GreedyLS_Nodes_GreedyCycle_start110,TSPB,51978,24480,27498,108,100,200
GreedyLS_Nodes_GreedyCycle_start111,TSPB,58156,25975,32181,91,100,200
GreedyLS_Nodes_GreedyCycle_start112,TSPB,54642,22734,31908,99,100,200
GreedyLS_Nodes_GreedyCycle_start113,TSPB,52953,24519,28434,103,100,200
GreedyLS_Nodes_GreedyCycle_start114,TSPB,52562,22883,29679,93,100,200
GreedyLS_Nodes_GreedyCycle_start115,TSPB,55046,24122,30924,86,100,200
GreedyLS_Nodes_GreedyCycle_start116,TSPB,56379,25745,30634,104,100,200
GreedyLS_Nodes_GreedyCycle_start117,TSPB,52202,24929,27273,85,100,200
GreedyLS_Nodes_GreedyCycle_start118,TSPB,58248,25797,32451,101,100,200
GreedyLS_Nodes_GreedyCycle_start119,TSPB,55332,25668,29664,86,100,200
GreedyLS_Nodes_GreedyCycle_start120,TSPB,58836,25881,32955,105,100,200
GreedyLS_Nodes_GreedyCycle_start121,TSPB,52144,22953,29191,97,100,200
GreedyLS_Nodes_GreedyCycle_start122,TSPB,55188,24703,30485,96,100,200
GreedyLS_Nodes_GreedyCycle_start123,TSPB,49951,23842,26109,93,100,200
GreedyLS_Nodes_GreedyCycle_start124,TSPB,53754,21269,32485,95,100,200
GreedyLS_Nodes_GreedyCycle_start125,TSPB,52871,23859,29012,105,100,200
GreedyLS_Nodes_GreedyCycle_start126,TSPB,54393,23813,30580,77,100,200
GreedyLS_Nodes_GreedyCycle_start127,TSPB,54823,24418,30405,111,100,200
GreedyLS_Nodes_GreedyCycle_start128,TSPB,50448,24082,26366,89,100,200
GreedyLS_Nodes_GreedyCycle_start129,TSPB,55453,23910,31543,83,100,200
GreedyLS_Nodes_GreedyCycle_start130,TSPB,52452,24706,27746,89,100,200
GreedyLS_Nodes_GreedyCycle_start131,TSPB,54338,26684,27654,108,100,200
GreedyLS_Nodes_GreedyCycle_start132,TSPB,52301,22232,30069,87,100,200
GreedyLS_Nodes_GreedyCycle_start133,TSPB,50615,24093,26522,96,100,200
GreedyLS_Nodes_GreedyCycle_start134,TSPB,55012,23902,31110,81,100,200
GreedyLS_Nodes_GreedyCycle_start135,TSPB,51763,23494,28269,116,100,200
GreedyLS_Nodes_GreedyCycle_start136,TSPB,60716,25684,35032,95,100,200
GreedyLS_Nodes_GreedyCycle_start137,TSPB,52962,25085,27877,105,100,200
GreedyLS_Nodes_GreedyCycle_start138,TSPB,54296,26057,28239,110,100,200
GreedyLS_Nodes_GreedyCycle_start139,TSPB,51039,22901,28138,95,100,200
GreedyLS_Nodes_GreedyCycle_start140,TSPB,51556,23657,27899,107,100,200
GreedyLS_Nodes_GreedyCycle_start141,TSPB,57200,24593,32607,112,100,200
GreedyLS_Nodes_GreedyCycle_start142,TSPB,54776,24852,29924,101,100,200
GreedyLS_Nodes_GreedyCycle_start143,TSPB,57559,26041,31518,90,100,200
GreedyLS_Nodes_GreedyCycle_start144,TSPB,56588,23537,33051,105,100,200
GreedyLS_Nodes_GreedyCycle_start145,TSPB,53150,24971,28179,92,100,200
GreedyLS_Nodes_GreedyCycle_start146,TSPB,51163,24249,26914,106,100,200
GreedyLS_Nodes_GreedyCycle_start147,TSPB,61655,22383,39272,99,100,200
GreedyLS_Nodes_GreedyCycle_start148,TSPB,53147,26047,27100,80,100,200
GreedyLS_Nodes_GreedyCycle_start149,TSPB,55720,22563,33157,96,100,200
GreedyLS_Nodes_GreedyCycle_start150,TSPB,54663,25010,29653,90,100,200
GreedyLS_Nodes_GreedyCycle_start151,TSPB,51269,23741,27528,104,100,200
GreedyLS_Nodes_GreedyCycle_start152,TSPB,50998,23859,27139,101,100,200
GreedyLS_Nodes_GreedyCycle_start153,TSPB,52309,21935,30374,106,100,200
GreedyLS_Nodes_GreedyCycle_start154,TSPB,51500,23425,28075,73,100,200
GreedyLS_Nodes_GreedyCycle_start155,TSPB,56983,26598,30385,96,100,200
GreedyLS_Nodes_GreedyCycle_start156,TSPB,50183,24237,25946,106,100,200
GreedyLS_Nodes_GreedyCycle_start157,TSPB,55772,26776,28996,93,100,200
GreedyLS_Nodes_GreedyCycle_start158,TSPB,56252,23430,32822,97,100,200
GreedyLS_Nodes_GreedyCycle_start159,TSPB,55510,24579,30931,94,100,200
GreedyLS_Nodes_GreedyCycle_start160,TSPB,60677,22369,38308,107,100,200
GreedyLS_Nodes_GreedyCycle_start161,TSPB,53878,24108,29770,85,100,200
GreedyLS_Nodes_GreedyCycle_start162,TSPB,52251,25646,26605,90,100,200
GreedyLS_Nodes_GreedyCycle_start163,TSPB,56442,25081,31361,106,100,200
GreedyLS_Nodes_GreedyCycle_start164,TSPB,52214,23800,28414,93,100,200
GreedyLS_Nodes_GreedyCycle_start165,TSPB,54694,27627,27067,107,100,200
GreedyLS_Nodes_GreedyCycle_start166,TSPB,52282,24361,27921,88,100,200
GreedyLS_Nodes_GreedyCycle_start167,TSPB,53454,24293,29161,72,100,200
GreedyLS_Nodes_GreedyCycle_start168,TSPB,54026,22689,31337,89,100,200
GreedyLS_Nodes_GreedyCycle_start169,TSPB,53430,24316,29114,90,100,200
GreedyLS_Nodes_GreedyCycle_start170,TSPB,53685,23136,30549,109,100,200
GreedyLS_Nodes_GreedyCycle_start171,TSPB,53241,23078,30163,98,100,200
GreedyLS_Nodes_GreedyCycle_start172,TSPB,55706,24272,31434,100,100,200
GreedyLS_Nodes_GreedyCycle_start173,TSPB,53451,22901,30550,105,100,200
GreedyLS_Nodes_GreedyCycle_start174,TSPB,54714,23019,31695,83,100,200
GreedyLS_Nodes_GreedyCycle_start175,TSPB,52563,21739,30824,99,100,200
GreedyLS_Nodes_GreedyCycle_start176,TSPB,55412,25182,30230,86,100,200
GreedyLS_Nodes_GreedyCycle_start177,TSPB,53170,23186,29984,90,100,200
GreedyLS_Nodes_GreedyCycle_start178,TSPB,55644,25612,30032,102,100,200
GreedyLS_Nodes_GreedyCycle_start179,TSPB,51072,21573,29499,108,100,200
GreedyLS_Nodes_GreedyCycle_start180,TSPB,52420,23058,29362,88,100,200
GreedyLS_Nodes_GreedyCycle_start181,TSPB,53403,22056,31347,86,100,200
GreedyLS_Nodes_GreedyCycle_start182,TSPB,53512,26290,27222,87,100,200
GreedyLS_Nodes_GreedyCycle_start183,TSPB,52643,24213,28430,71,100,200
GreedyLS_Nodes_GreedyCycle_start184,TSPB,52325,22462,29863,89,100,200
GreedyLS_Nodes_GreedyCycle_start185,TSPB,54988,25786,29202,107,100,200
GreedyLS_Nodes_GreedyCycle_start186,TSPB,54004,25314,28690,102,100,200
GreedyLS_Nodes_GreedyCycle_start187,TSPB,51433,21843,29590,98,100,200
GreedyLS_Nodes_GreedyCycle_start188,TSPB,52192,23753,28439,90,100,200
GreedyLS_Nodes_GreedyCycle_start189,TSPB,53372,23560,29812,91,100,200
GreedyLS_Nodes_GreedyCycle_start190,TSPB,54593,23221,31372,99,100,200
GreedyLS_Nodes_GreedyCycle_start191,TSPB,54820,24190,30630,111,100,200
GreedyLS_Nodes_GreedyCycle_start192,TSPB,54051,24127,29924,90,100,200
GreedyLS_Nodes_GreedyCycle_start193,TSPB,53146,23494,29652,113,100,200
GreedyLS_Nodes_GreedyCycle_start194,TSPB,55817,25992,29825,96,100,200
GreedyLS_Nodes_GreedyCycle_start195,TSPB,54265,23379,30886,82,100,200
GreedyLS_Nodes_GreedyCycle_start196,TSPB,55676,24207,31469,99,100,200
GreedyLS_Nodes_GreedyCycle_start197,TSPB,58398,25927,32471,72,100,200
GreedyLS_Nodes_GreedyCycle_start198,TSPB,51519,24213,27306,99,100,200
GreedyLS_Nodes_GreedyCycle_start199,TSPB,50580,23386,27194,142,100,200
GreedyLS_Edges_Random_start0,TSPB,50250,22959,27291,194,100,200
GreedyLS_Edges_Random_start1,TSPB,50225,22111,28114,205,100,200
GreedyLS_Edges_Random_start2,TSPB,49040,22296,26744,210,100,200
GreedyLS_Edges_Random_start3,TSPB,48452,19880,28572,199,100,200
GreedyLS_Edges_Random_start4,TSPB,48490,21133,27357,206,100,200
GreedyLS_Edges_Random_start5,TSPB,46940,20066,26874,215,100,200
GreedyLS_Edges_Random_start6,TSPB,48880,22786,26094,203,100,200
GreedyLS_Edges_Random_start7,TSPB,48423,20171,28252,218,100,200
GreedyLS_Edges_Random_start8,TSPB,47926,21578,26348,206,100,200
GreedyLS_Edges_Random_start9,TSPB,49881,22447,27434,205,100,200
GreedyLS_Edges_Random_start10,TSPB,49520,21974,27546,201,100,200
GreedyLS_Edges_Random_start11,TSPB,47659,21602,26057,201,100,200
GreedyLS_Edges_Random_start12,TSPB,49137,23248,25889,-2092,100,200
GreedyLS_Edges_Random_start13,TSPB,47417,19906,27511,202,100,200
GreedyLS_Edges_Random_start14,TSPB,50355,21230,29125,212,100,200
GreedyLS_Edges_Random_start15,TSPB,48088,20562,27526,205,100,200
GreedyLS_Edges_Random_start16,TSPB,48429,21482,26947,196,100,200
GreedyLS_Edges_Random_start17,TSPB,47193,20863,26330,209,100,200
GreedyLS_Edges_Random_start18,TSPB,48249,22057,26192,200,100,200
GreedyLS_Edges_Random_start19,TSPB,46868,20614,26254,213,100,200
GreedyLS_Edges_Random_start20,TSPB,48843,22010,26833,214,100,200
GreedyLS_Edges_Random_start21,TSPB,48114,22675,25439,205,100,200
GreedyLS_Edges_Random_start22,TSPB,47802,22744,25058,211,100,200
GreedyLS_Edges_Random_start23,TSPB,48383,21093,27290,205,100,200
GreedyLS_Edges_Random_start24,TSPB,49014,22011,27003,216,100,200
GreedyLS_Edges_Random_start25,TSPB,48446,21829,26617,231,100,200
GreedyLS_Edges_Random_start26,TSPB,49032,21424,27608,213,100,200
GreedyLS_Edges_Random_start27,TSPB,47422,20813,26609,216,100,200
GreedyLS_Edges_Random_start28,TSPB,47878,22455,25423,208,100,200
GreedyLS_Edges_Random_start29,TSPB,47589,20933,26656,221,100,200
GreedyLS_Edges_Random_start30,TSPB,50890,23264,27626,186,100,200
GreedyLS_Edges_Random_start31,TSPB,47863,20918,26945,182,100,200
GreedyLS_Edges_Random_start32,TSPB,50227,22433,27794,189,100,200
GreedyLS_Edges_Random_start33,TSPB,49019,21277,27742,212,100,200
GreedyLS_Edges_Random_start34,TSPB,46168,21021,25147,219,100,200
GreedyLS_Edges_Random_start35,TSPB,47958,21821,26137,221,100,200
GreedyLS_Edges_Random_start36,TSPB,48156,21742,26414,198,100,200
GreedyLS_Edges_Random_start37,TSPB,49081,23190,25891,183,100,200
GreedyLS_Edges_Random_start38,TSPB,47807,21380,26427,212,100,200
GreedyLS_Edges_Random_start39,TSPB,47311,20928,26383,228,100,200
GreedyLS_Edges_Random_start40,TSPB,47675,20840,26835,224,100,200
GreedyLS_Edges_Random_start41,TSPB,48527,21440,27087,212,100,200
GreedyLS_Edges_Random_start42,TSPB,49509,20299,29210,213,100,200
GreedyLS_Edges_Random_start43,TSPB,48199,19836,28363,205,100,200
GreedyLS_Edges_Random_start44,TSPB,49210,23263,25947,218,100,200
GreedyLS_Edges_Random_start45,TSPB,47457,21657,25800,228,100,200
GreedyLS_Edges_Random_start46,TSPB,49359,22202,27157,193,100,200
GreedyLS_Edges_Random_start47,TSPB,47626,22235,25391,215,100,200
GreedyLS_Edges_Random_start48,TSPB,48670,20260,28410,213,100,200
GreedyLS_Edges_Random_start49,TSPB,49073,21397,27676,188,100,200
GreedyLS_Edges_Random_start50,TSPB,48742,20905,27837,220,100,200
GreedyLS_Edges_Random_start51,TSPB,49364,22041,27323,199,100,200
GreedyLS_Edges_Random_start52,TSPB,48456,23548,24908,221,100,200
GreedyLS_Edges_Random_start53,TSPB,48279,21308,26971,216,100,200
GreedyLS_Edges_Random_start54,TSPB,50244,23211,27033,210,100,200
GreedyLS_Edges_Random_start55,TSPB,48563,20516,28047,212,100,200
GreedyLS_Edges_Random_start56,TSPB,47091,21566,25525,229,100,200
GreedyLS_Edges_Random_start57,TSPB,48382,21996,26386,213,100,200
GreedyLS_Edges_Random_start58,TSPB,48461,21741,26720,230,100,200
GreedyLS_Edges_Random_start59,TSPB,48674,22394,26280,208,100,200
GreedyLS_Edges_Random_start60,TSPB,48637,21704,26933,218,100,200
GreedyLS_Edges_Random_start61,TSPB,48266,22119,26147,213,100,200
GreedyLS_Edges_Random_start62,TSPB,49111,22275,26836,196,100,200
GreedyLS_Edges_Random_start63,TSPB,48472,21360,27112,194,100,200
GreedyLS_Edges_Random_start64,TSPB,48503,21082,27421,208,100,200
GreedyLS_Edges_Random_start65,TSPB,47067,20758,26309,224,100,200
GreedyLS_Edges_Random_start66,TSPB,48450,21695,26755,212,100,200
GreedyLS_Edges_Random_start67,TSPB,46468,20341,26127,230,100,200
GreedyLS_Edges_Random_start68,TSPB,47616,21269,26347,222,100,200
GreedyLS_Edges_Random_start69,TSPB,50681,21296,29385,210,100,200
GreedyLS_Edges_Random_start70,TSPB,48115,22650,25465,219,100,200
GreedyLS_Edges_Random_start71,TSPB,48246,21226,27020,198,100,200
GreedyLS_Edges_Random_start72,TSPB,47598,21144,26454,191,100,200
GreedyLS_Edges_Random_start73,TSPB,48079,21310,26769,199,100,200
GreedyLS_Edges_Random_start74,TSPB,47250,21144,26106,206,100,200
GreedyLS_Edges_Random_start75,TSPB,48031,21212,26819,207,100,200
GreedyLS_Edges_Random_start76,TSPB,49040,22221,26819,211,100,200
GreedyLS_Edges_Random_start77,TSPB,48891,22807,26084,214,100,200
GreedyLS_Edges_Random_start78,TSPB,48613,22406,26207,211,100,200
GreedyLS_Edges_Random_start79,TSPB,50600,22445,28155,194,100,200
GreedyLS_Edges_Random_start80,TSPB,47675,21905,25770,193,100,200
GreedyLS_Edges_Random_start81,TSPB,48253,21353,26900,216,100,200
GreedyLS_Edges_Random_start82,TSPB,49979,20716,29263,201,100,200
GreedyLS_Edges_Random_start83,TSPB,46357,21389,24968,214,100,200
GreedyLS_Edges_Random_start84,TSPB,47850,21214,26636,226,100,200
GreedyLS_Edges_Random_start85,TSPB,46740,21576,25164,204,100,200
GreedyLS_Edges_Random_start86,TSPB,49077,22835,26242,206,100,200
GreedyLS_Edges_Random_start87,TSPB,47806,20458,27348,231,100,200
GreedyLS_Edges_Random_start88,TSPB,47217,20897,26320,215,100,200
GreedyLS_Edges_Random_start89,TSPB,48249,21535,26714,199,100,200
GreedyLS_Edges_Random_start90,TSPB,48381,21662,26719,203,100,200
GreedyLS_Edges_Random_start91,TSPB,47676,21057,26619,201,100,200
GreedyLS_Edges_Random_start92,TSPB,48651,20862,27789,223,100,200
GreedyLS_Edges_Random_start93,TSPB,48443,20881,27562,199,100,200
GreedyLS_Edges_Random_start94,TSPB,48000,20928,27072,207,100,200
GreedyLS_Edges_Random_start95,TSPB,47678,22336,25342,204,100,200
GreedyLS_Edges_Random_start96,TSPB,49817,22166,27651,197,100,200
GreedyLS_Edges_Random_start97,TSPB,49490,22561,26929,205,100,200
GreedyLS_Edges_Random_start98,TSPB,48744,21079,27665,243,100,200
GreedyLS_Edges_Random_start99,TSPB,48957,22515,26442,224,100,200
GreedyLS_Edges_Random_start100,TSPB,47668,21389,26279,215,100,200
GreedyLS_Edges_Random_start101,TSPB,49880,21430,28450,234,100,200
GreedyLS_Edges_Random_start102,TSPB,46836,20159,26677,219,100,200
GreedyLS_Edges_Random_start103,TSPB,49109,23768,25341,208,100,200
GreedyLS_Edges_Random_start104,TSPB,47930,20830,27100,216,100,200
GreedyLS_Edges_Random_start105,TSPB,48634,21359,27275,205,100,200
GreedyLS_Edges_Random_start106,TSPB,47755,20080,27675,198,100,200
GreedyLS_Edges_Random_start107,TSPB,49699,22730,26969,193,100,200
GreedyLS_Edges_Random_start108,TSPB,49733,23215,26518,213,100,200
GreedyLS_Edges_Random_start109,TSPB,47987,19477,28510,212,100,200
GreedyLS_Edges_Random_start110,TSPB,46927,20104,26823,227,100,200
GreedyLS_Edges_Random_start111,TSPB,48047,21898,26149,197,100,200
GreedyLS_Edges_Random_start112,TSPB,48014,21325,26689,208,100,200
GreedyLS_Edges_Random_start113,TSPB,49896,22451,27445,197,100,200
GreedyLS_Edges_Random_start114,TSPB,47137,21096,26041,227,100,200
GreedyLS_Edges_Random_start115,TSPB,48856,23587,25269,231,100,200
GreedyLS_Edges_Random_start116,TSPB,47723,20988,26735,231,100,200
GreedyLS_Edges_Random_start117,TSPB,48626,22711,25915,205,100,200
GreedyLS_Edges_Random_start118,TSPB,49165,21789,27376,219,100,200
GreedyLS_Edges_Random_start119,TSPB,47136,21227,25909,229,100,200
GreedyLS_Edges_Random_start120,TSPB,47274,21515,25759,215,100,200
GreedyLS_Edges_Random_start121,TSPB,47983,21240,26743,217,100,200
GreedyLS_Edges_Random_start122,TSPB,48342,20768,27574,197,100,200
GreedyLS_Edges_Random_start123,TSPB,49633,23434,26199,204,100,200
GreedyLS_Edges_Random_start124,TSPB,46325,20446,25879,213,100,200
GreedyLS_Edges_Random_start125,TSPB,49674,20781,28893,197,100,200
GreedyLS_Edges_Random_start126,TSPB,48762,22984,25778,216,100,200
GreedyLS_Edges_Random_start127,TSPB,49154,22761,26393,219,100,200
GreedyLS_Edges_Random_start128,TSPB,47138,19808,27330,217,100,200
GreedyLS_Edges_Random_start129,TSPB,48386,20728,27658,229,100,200
GreedyLS_Edges_Random_start130,TSPB,48537,21292,27245,221,100,200
GreedyLS_Edges_Random_start131,TSPB,47534,22226,25308,213,100,200
GreedyLS_Edges_Random_start132,TSPB,45969,19857,26112,201,100,200
GreedyLS_Edges_Random_start133,TSPB,49151,21593,27558,214,100,200
GreedyLS_Edges_Random_start134,TSPB,47589,20515,27074,213,100,200
GreedyLS_Edges_Random_start135,TSPB,49148,21689,27459,202,100,200
GreedyLS_Edges_Random_start136,TSPB,48608,22181,26427,195,100,200
GreedyLS_Edges_Random_start137,TSPB,46829,20563,26266,207,100,200
GreedyLS_Edges_Random_start138,TSPB,49108,21535,27573,212,100,200
GreedyLS_Edges_Random_start139,TSPB,51715,21422,30293,194,100,200
GreedyLS_Edges_Random_start140,TSPB,47674,21587,26087,214,100,200
GreedyLS_Edges_Random_start141,TSPB,49999,22106,27893,207,100,200
GreedyLS_Edges_Random_start142,TSPB,47425,21285,26140,214,100,200
GreedyLS_Edges_Random_start143,TSPB,46982,20461,26521,235,100,200
GreedyLS_Edges_Random_start144,TSPB,46275,19577,26698,204,100,200
GreedyLS_Edges_Random_start145,TSPB,47818,22211,25607,214,100,200
GreedyLS_Edges_Random_start146,TSPB,46602,20273,26329,230,100,200
GreedyLS_Edges_Random_start147,TSPB,48185,20197,27988,189,100,200
GreedyLS_Edges_Random_start148,TSPB,46528,20778,25750,227,100,200
GreedyLS_Edges_Random_start149,TSPB,49275,22451,26824,211,100,200
GreedyLS_Edges_Random_start150,TSPB,47164,21064,26100,209,100,200
GreedyLS_Edges_Random_start151,TSPB,47791,21418,26373,197,100,200
GreedyLS_Edges_Random_start152,TSPB,46880,20709,26171,197,100,200
GreedyLS_Edges_Random_start153,TSPB,49663,20883,28780,199,100,200
GreedyLS_Edges_Random_start154,TSPB,46514,21227,25287,739,100,200
GreedyLS_Edges_Random_start155,TSPB,45767,19726,26041,-2610,100,200
GreedyLS_Edges_Random_start156,TSPB,49141,21914,27227,206,100,200
GreedyLS_Edges_Random_start157,TSPB,47154,20319,26835,212,100,200
GreedyLS_Edges_Random_start158,TSPB,47510,20432,27078,216,100,200
GreedyLS_Edges_Random_start159,TSPB,48592,21755,26837,200,100,200
GreedyLS_Edges_Random_start160,TSPB,48857,21678,27179,210,100,200
GreedyLS_Edges_Random_start161,TSPB,49691,22301,27390,212,100,200
GreedyLS_Edges_Random_start162,TSPB,46801,19807,26994,220,100,200
GreedyLS_Edges_Random_start163,TSPB,46264,21804,24460,216,100,200
GreedyLS_Edges_Random_start164,TSPB,46868,20904,25964,216,100,200
GreedyLS_Edges_Random_start165,TSPB,48271,20360,27911,210,100,200
GreedyLS_Edges_Random_start166,TSPB,48739,21897,26842,215,100,200
GreedyLS_Edges_Random_start167,TSPB,48455,20143,28312,236,100,200
GreedyLS_Edges_Random_start168,TSPB,50877,20677,30200,201,100,200
GreedyLS_Edges_Random_start169,TSPB,48688,21117,27571,220,100,200
GreedyLS_Edges_Random_start170,TSPB,48067,20538,27529,206,100,200
GreedyLS_Edges_Random_start171,TSPB,48599,22428,26171,208,100,200
GreedyLS_Edges_Random_start172,TSPB,47868,21700,26168,219,100,200
GreedyLS_Edges_Random_start173,TSPB,48345,20989,27356,207,100,200
GreedyLS_Edges_Random_start174,TSPB,47502,21950,25552,230,100,200
GreedyLS_Edges_Random_start175,TSPB,47982,19499,28483,228,100,200
GreedyLS_Edges_Random_start176,TSPB,48676,21216,27460,199,100,200
GreedyLS_Edges_Random_start177,TSPB,47910,23056,24854,207,100,200
GreedyLS_Edges_Random_start178,TSPB,48406,20846,27560,231,100,200
GreedyLS_Edges_Random_start179,TSPB,49320,23084,26236,215,100,200
GreedyLS_Edges_Random_start180,TSPB,48226,21004,27222,205,100,200
GreedyLS_Edges_Random_start181,TSPB,47539,19852,27687,196,100,200
GreedyLS_Edges_Random_start182,TSPB,48114,21642,26472,209,100,200
GreedyLS_Edges_Random_start183,TSPB,49270,21468,27802,187,100,200
GreedyLS_Edges_Random_start184,TSPB,46602,21038,25564,227,100,200
GreedyLS_Edges_Random_start185,TSPB,50069,22182,27887,205,100,200
GreedyLS_Edges_Random_start186,TSPB,46682,19758,26924,217,100,200
GreedyLS_Edges_Random_start187,TSPB,47253,20872,26381,221,100,200
GreedyLS_Edges_Random_start188,TSPB,49763,21812,27951,206,100,200
GreedyLS_Edges_Random_start189,TSPB,50531,21380,29151,198,100,200
GreedyLS_Edges_Random_start190,TSPB,49607,22689,26918,212,100,200
GreedyLS_Edges_Random_start191,TSPB,46880,20124,26756,225,100,200
GreedyLS_Edges_Random_start192,TSPB,48713,21230,27483,201,100,200
GreedyLS_Edges_Random_start193,TSPB,48446,21062,27384,204,100,200
GreedyLS_Edges_Random_start194,TSPB,47286,20503,26783,210,100,200
GreedyLS_Edges_Random_start195,TSPB,49940,21760,28180,213,100,200
GreedyLS_Edges_Random_start196,TSPB,49905,21415,28490,206,100,200
GreedyLS_Edges_Random_start197,TSPB,48818,21173,27645,206,100,200
GreedyLS_Edges_Random_start198,TSPB,49962,21111,28851,213,100,200
GreedyLS_Edges_Random_start199,TSPB,48525,21768,26757,199,100,200
GreedyLS_Edges_GreedyCycle_start0,TSPB,52564,19878,32686,110,100,200
GreedyLS_Edges_GreedyCycle_start1,TSPB,52843,19461,33382,104,100,200
GreedyLS_Edges_GreedyCycle_start2,TSPB,47818,19340,28478,99,100,200
GreedyLS_Edges_GreedyCycle_start3,TSPB,51695,19279,32416,97,100,200
GreedyLS_Edges_GreedyCycle_start4,TSPB,49449,19167,30282,102,100,200
GreedyLS_Edges_GreedyCycle_start5,TSPB,52429,20905,31524,118,100,200
GreedyLS_Edges_GreedyCycle_start6,TSPB,52309,19658,32651,96,100,200
GreedyLS_Edges_GreedyCycle_start7,TSPB,47127,21596,25531,108,100,200
GreedyLS_Edges_GreedyCycle_start8,TSPB,48625,20569,28056,114,100,200
GreedyLS_Edges_GreedyCycle_start9,TSPB,49049,18658,30391,94,100,200
GreedyLS_Edges_GreedyCycle_start10,TSPB,48943,20388,28555,111,100,200
GreedyLS_Edges_GreedyCycle_start11,TSPB,48696,20586,28110,98,100,200
GreedyLS_Edges_GreedyCycle_start12,TSPB,48290,19522,28768,120,100,200
GreedyLS_Edges_GreedyCycle_start13,TSPB,50682,21836,28846,92,100,200
GreedyLS_Edges_GreedyCycle_start14,TSPB,48818,20259,28559,104,100,200
GreedyLS_Edges_GreedyCycle_start15,TSPB,50721,20570,30151,96,100,200
GreedyLS_Edges_GreedyCycle_start16,TSPB,49753,21105,28648,92,100,200
GreedyLS_Edges_GreedyCycle_start17,TSPB,50073,20605,29468,130,100,200
GreedyLS_Edges_GreedyCycle_start18,TSPB,48645,19713,28932,89,100,200
GreedyLS_Edges_GreedyCycle_start19,TSPB,52941,19141,33800,114,100,200
GreedyLS_Edges_GreedyCycle_start20,TSPB,48002,20535,27467,95,100,200
GreedyLS_Edges_GreedyCycle_start21,TSPB,47893,21967,25926,114,100,200
GreedyLS_Edges_GreedyCycle_start22,TSPB,47524,19742,27782,106,100,200
GreedyLS_Edges_GreedyCycle_start23,TSPB,53368,18908,34460,106,100,200
GreedyLS_Edges_GreedyCycle_start24,TSPB,52215,18174,34041,137,100,200
GreedyLS_Edges_GreedyCycle_start25,TSPB,47029,22074,24955,85,100,200
GreedyLS_Edges_GreedyCycle_start26,TSPB,49602,19121,30481,112,100,200
GreedyLS_Edges_GreedyCycle_start27,TSPB,52551,22298,30253,115,100,200
GreedyLS_Edges_GreedyCycle_start28,TSPB,50387,18752,31635,103,100,200
GreedyLS_Edges_GreedyCycle_start29,TSPB,50383,20740,29643,130,100,200
GreedyLS_Edges_GreedyCycle_start30,TSPB,52796,21235,31561,111,100,200
GreedyLS_Edges_GreedyCycle_start31,TSPB,52059,22922,29137,112,100,200
GreedyLS_Edges_GreedyCycle_start32,TSPB,47011,20631,26380,120,100,200
GreedyLS_Edges_GreedyCycle_start33,TSPB,48925,22993,25932,104,100,200
GreedyLS_Edges_GreedyCycle_start34,TSPB,51826,20494,31332,94,100,200
GreedyLS_Edges_GreedyCycle_start35,TSPB,48076,22090,25986,108,100,200
GreedyLS_Edges_GreedyCycle_start36,TSPB,46948,20165,26783,118,100,200
GreedyLS_Edges_GreedyCycle_start37,TSPB,54365,19253,35112,120,100,200
GreedyLS_Edges_GreedyCycle_start38,TSPB,47092,19695,27397,119,100,200
GreedyLS_Edges_GreedyCycle_start39,TSPB,50564,20515,30049,123,100,200
GreedyLS_Edges_GreedyCycle_start40,TSPB,53526,20725,32801,100,100,200
GreedyLS_Edges_GreedyCycle_start41,TSPB,49784,20291,29493,102,100,200
GreedyLS_Edges_GreedyCycle_start42,TSPB,47437,21824,25613,109,100,200
GreedyLS_Edges_GreedyCycle_start43,TSPB,48940,21237,27703,106,100,200
GreedyLS_Edges_GreedyCycle_start44,TSPB,51537,20112,31425,125,100,200
GreedyLS_Edges_GreedyCycle_start45,TSPB,46628,21361,25267,89,100,200
GreedyLS_Edges_GreedyCycle_start46,TSPB,49356,19669,29687,110,100,200
GreedyLS_Edges_GreedyCycle_start47,TSPB,47113,20494,26619,94,100,200
GreedyLS_Edges_GreedyCycle_start48,TSPB,50018,19428,30590,106,100,200
GreedyLS_Edges_GreedyCycle_start49,TSPB,50956,21220,29736,98,100,200
GreedyLS_Edges_GreedyCycle_start50,TSPB,48790,20380,28410,98,100,200
GreedyLS_Edges_GreedyCycle_start51,TSPB,52682,18858,33824,124,100,200
GreedyLS_Edges_GreedyCycle_start52,TSPB,50517,18933,31584,106,100,200
GreedyLS_Edges_GreedyCycle_start53,TSPB,48903,20963,27940,110,100,200
GreedyLS_Edges_GreedyCycle_start54,TSPB,49425,20852,28573,114,100,200
GreedyLS_Edges_GreedyCycle_start55,TSPB,48338,19870,28468,93,100,200
GreedyLS_Edges_GreedyCycle_start56,TSPB,47610,20288,27322,131,100,200
GreedyLS_Edges_GreedyCycle_start57,TSPB,51014,20353,30661,107,100,200
GreedyLS_Edges_GreedyCycle_start58,TSPB,50311,20577,29734,97,100,200
GreedyLS_Edges_GreedyCycle_start59,TSPB,50945,19301,31644,121,100,200
GreedyLS_Edges_GreedyCycle_start60,TSPB,52999,19138,33861,106,100,200
GreedyLS_Edges_GreedyCycle_start61,TSPB,50486,19404,31082,118,100,200
GreedyLS_Edges_GreedyCycle_start62,TSPB,48745,19101,29644,98,100,200
GreedyLS_Edges_GreedyCycle_start63,TSPB,46894,21292,25602,112,100,200
GreedyLS_Edges_GreedyCycle_start64,TSPB,50066,19750,30316,98,100,200
GreedyLS_Edges_GreedyCycle_start65,TSPB,47346,19638,27708,116,100,200
GreedyLS_Edges_GreedyCycle_start66,TSPB,50197,20007,30190,120,100,200
GreedyLS_Edges_GreedyCycle_start67,TSPB,56378,20295,36083,113,100,200
GreedyLS_Edges_GreedyCycle_start68,TSPB,51645,18925,32720,114,100,200
GreedyLS_Edges_GreedyCycle_start69,TSPB,50829,20420,30409,126,100,200
GreedyLS_Edges_GreedyCycle_start70,TSPB,48847,19473,29374,110,100,200
GreedyLS_Edges_GreedyCycle_start71,TSPB,54613,20393,34220,132,100,200
GreedyLS_Edges_GreedyCycle_start72,TSPB,55708,18554,37154,114,100,200
GreedyLS_Edges_GreedyCycle_start73,TSPB,51596,18648,32948,103,100,200
GreedyLS_Edges_GreedyCycle_start74,TSPB,48751,21146,27605,111,100,200
GreedyLS_Edges_GreedyCycle_start75,TSPB,50944,20421,30523,99,100,200
GreedyLS_Edges_GreedyCycle_start76,TSPB,50674,20537,30137,110,100,200
GreedyLS_Edges_GreedyCycle_start77,TSPB,47277,19621,27656,92,100,200
GreedyLS_Edges_GreedyCycle_start78,TSPB,48268,21253,27015,107,100,200
GreedyLS_Edges_GreedyCycle_start79,TSPB,49401,22392,27009,108,100,200
GreedyLS_Edges_GreedyCycle_start80,TSPB,51662,20253,31409,103,100,200
GreedyLS_Edges_GreedyCycle_start81,TSPB,51093,20441,30652,115,100,200
GreedyLS_Edges_GreedyCycle_start82,TSPB,52889,20503,32386,118,100,200
GreedyLS_Edges_GreedyCycle_start83,TSPB,50739,20798,29941,111,100,200
GreedyLS_Edges_GreedyCycle_start84,TSPB,50123,20423,29700,103,100,200
GreedyLS_Edges_GreedyCycle_start85,TSPB,53608,21445,32163,106,100,200
GreedyLS_Edges_GreedyCycle_start86,TSPB,50097,20439,29658,107,100,200
GreedyLS_Edges_GreedyCycle_start87,TSPB,49587,21437,28150,127,100,200
GreedyLS_Edges_GreedyCycle_start88,TSPB,50809,18501,32308,110,100,200
GreedyLS_Edges_GreedyCycle_start89,TSPB,50943,18663,32280,106,100,200
GreedyLS_Edges_GreedyCycle_start90,TSPB,56381,19849,36532,104,100,200
GreedyLS_Edges_GreedyCycle_start91,TSPB,46739,20667,26072,115,100,200
GreedyLS_Edges_GreedyCycle_start92,TSPB,51338,21004,30334,108,100,200
GreedyLS_Edges_GreedyCycle_start93,TSPB,48533,19391,29142,115,100,200
GreedyLS_Edges_GreedyCycle_start94,TSPB,50214,21695,28519,93,100,200
GreedyLS_Edges_GreedyCycle_start95,TSPB,51515,21340,30175,95,100,200
GreedyLS_Edges_GreedyCycle_start96,TSPB,49629,21551,28078,113,100,200
GreedyLS_Edges_GreedyCycle_start97,TSPB,49976,19782,30194,108,100,200
GreedyLS_Edges_GreedyCycle_start98,TSPB,52046,20471,31575,99,100,200
GreedyLS_Edges_GreedyCycle_start99,TSPB,51437,21119,30318,114,100,200
GreedyLS_Edges_GreedyCycle_start100,TSPB,54105,17828,36277,94,100,200
GreedyLS_Edges_GreedyCycle_start101,TSPB,51896,18937,32959,109,100,200
GreedyLS_Edges_GreedyCycle_start102,TSPB,50096,21669,28427,100,100,200
GreedyLS_Edges_GreedyCycle_start103,TSPB,51051,19914,31137,103,100,200
GreedyLS_Edges_GreedyCycle_start104,TSPB,49579,23404,26175,126,100,200
GreedyLS_Edges_GreedyCycle_start105,TSPB,46871,19932,26939,104,100,200
GreedyLS_Edges_GreedyCycle_start106,TSPB,51749,18811,32938,134,100,200
GreedyLS_Edges_GreedyCycle_start107,TSPB,52025,20182,31843,112,100,200
GreedyLS_Edges_GreedyCycle_start108,TSPB,50403,21164,29239,101,100,200
GreedyLS_Edges_GreedyCycle_start109,TSPB,53269,19721,33548,109,100,200
GreedyLS_Edges_GreedyCycle_start110,TSPB,49803,23143,26660,125,100,200
GreedyLS_Edges_GreedyCycle_start111,TSPB,50872,22568,28304,119,100,200
GreedyLS_Edges_GreedyCycle_start112,TSPB,51868,20895,30973,104,100,200
GreedyLS_Edges_GreedyCycle_start113,TSPB,49015,20246,28769,117,100,200
GreedyLS_Edges_GreedyCycle_start114,TSPB,48896,20779,28117,94,100,200
GreedyLS_Edges_GreedyCycle_start115,TSPB,52679,20988,31691,121,100,200
GreedyLS_Edges_GreedyCycle_start116,TSPB,51018,19506,31512,115,100,200
GreedyLS_Edges_GreedyCycle_start117,TSPB,47918,21966,25952,113,100,200
GreedyLS_Edges_GreedyCycle_start118,TSPB,50752,20340,30412,121,100,200
GreedyLS_Edges_GreedyCycle_start119,TSPB,50198,19876,30322,107,100,200
GreedyLS_Edges_GreedyCycle_start120,TSPB,54094,20984,33110,120,100,200
GreedyLS_Edges_GreedyCycle_start121,TSPB,49285,21302,27983,101,100,200
GreedyLS_Edges_GreedyCycle_start122,TSPB,49564,20684,28880,117,100,200
GreedyLS_Edges_GreedyCycle_start123,TSPB,46510,20793,25717,115,100,200
GreedyLS_Edges_GreedyCycle_start124,TSPB,50986,21106,29880,109,100,200
GreedyLS_Edges_GreedyCycle_start125,TSPB,49358,21142,28216,98,100,200
GreedyLS_Edges_GreedyCycle_start126,TSPB,51198,20684,30514,104,100,200
GreedyLS_Edges_GreedyCycle_start127,TSPB,51906,22267,29639,123,100,200
GreedyLS_Edges_GreedyCycle_start128,TSPB,48921,21699,27222,105,100,200
GreedyLS_Edges_GreedyCycle_start129,TSPB,52162,21359,30803,100,100,200
GreedyLS_Edges_GreedyCycle_start130,TSPB,50856,19837,31019,98,100,200
GreedyLS_Edges_GreedyCycle_start131,TSPB,49723,22840,26883,100,100,200
GreedyLS_Edges_GreedyCycle_start132,TSPB,50166,20417,29749,110,100,200
GreedyLS_Edges_GreedyCycle_start133,TSPB,47343,21995,25348,106,100,200
GreedyLS_Edges_GreedyCycle_start134,TSPB,50791,20437,30354,104,100,200
GreedyLS_Edges_GreedyCycle_start135,TSPB,52911,20681,32230,104,100,200
GreedyLS_Edges_GreedyCycle_start136,TSPB,51687,19435,32252,107,100,200
GreedyLS_Edges_GreedyCycle_start137,TSPB,48762,18609,30153,124,100,200
GreedyLS_Edges_GreedyCycle_start138,TSPB,49433,22076,27357,114,100,200
GreedyLS_Edges_GreedyCycle_start139,TSPB,50184,22039,28145,113,100,200
GreedyLS_Edges_GreedyCycle_start140,TSPB,50330,22682,27648,105,100,200
GreedyLS_Edges_GreedyCycle_start141,TSPB,50222,22048,28174,110,100,200
GreedyLS_Edges_GreedyCycle_start142,TSPB,51802,21282,30520,98,100,200
GreedyLS_Edges_GreedyCycle_start143,TSPB,50538,20647,29891,87,100,200
GreedyLS_Edges_GreedyCycle_start144,TSPB,53671,21523,32148,94,100,200
GreedyLS_Edges_GreedyCycle_start145,TSPB,49453,19468,29985,104,100,200
GreedyLS_Edges_GreedyCycle_start146,TSPB,48375,20717,27658,108,100,200
GreedyLS_Edges_GreedyCycle_start147,TSPB,57285,18522,38763,108,100,200
GreedyLS_Edges_GreedyCycle_start148,TSPB,48246,21319,26927,97,100,200
GreedyLS_Edges_GreedyCycle_start149,TSPB,48853,21106,27747,111,100,200
GreedyLS_Edges_GreedyCycle_start150,TSPB,49407,19722,29685,105,100,200
GreedyLS_Edges_GreedyCycle_start151,TSPB,47729,20567,27162,116,100,200
GreedyLS_Edges_GreedyCycle_start152,TSPB,47823,19711,28112,109,100,200
GreedyLS_Edges_GreedyCycle_start153,TSPB,48821,19305,29516,106,100,200
GreedyLS_Edges_GreedyCycle_start154,TSPB,49072,19954,29118,94,100,200
GreedyLS_Edges_GreedyCycle_start155,TSPB,50194,19258,30936,109,100,200
GreedyLS_Edges_GreedyCycle_start156,TSPB,47346,21544,25802,109,100,200
GreedyLS_Edges_GreedyCycle_start157,TSPB,49569,21376,28193,118,100,200
GreedyLS_Edges_GreedyCycle_start158,TSPB,53239,20503,32736,103,100,200
GreedyLS_Edges_GreedyCycle_start159,TSPB,51685,18836,32849,91,100,200
GreedyLS_Edges_GreedyCycle_start160,TSPB,57761,20432,37329,119,100,200
GreedyLS_Edges_GreedyCycle_start161,TSPB,49767,21422,28345,103,100,200
GreedyLS_Edges_GreedyCycle_start162,TSPB,46629,20684,25945,125,100,200
GreedyLS_Edges_GreedyCycle_start163,TSPB,50488,21611,28877,112,100,200
GreedyLS_Edges_GreedyCycle_start164,TSPB,51055,20816,30239,104,100,200
GreedyLS_Edges_GreedyCycle_start165,TSPB,48583,20369,28214,105,100,200
GreedyLS_Edges_GreedyCycle_start166,TSPB,50218,20832,29386,102,100,200
GreedyLS_Edges_GreedyCycle_start167,TSPB,49742,21801,27941,97,100,200
GreedyLS_Edges_GreedyCycle_start168,TSPB,49201,20690,28511,99,100,200
GreedyLS_Edges_GreedyCycle_start169,TSPB,48849,18232,30617,109,100,200
GreedyLS_Edges_GreedyCycle_start170,TSPB,48085,19930,28155,117,100,200
GreedyLS_Edges_GreedyCycle_start171,TSPB,50085,20703,29382,95,100,200
GreedyLS_Edges_GreedyCycle_start172,TSPB,51363,19173,32190,97,100,200
GreedyLS_Edges_GreedyCycle_start173,TSPB,51925,20021,31904,111,100,200
GreedyLS_Edges_GreedyCycle_start174,TSPB,49763,20524,29239,124,100,200
GreedyLS_Edges_GreedyCycle_start175,TSPB,51306,21360,29946,97,100,200
GreedyLS_Edges_GreedyCycle_start176,TSPB,51207,19836,31371,125,100,200
GreedyLS_Edges_GreedyCycle_start177,TSPB,50193,20118,30075,101,100,200
GreedyLS_Edges_GreedyCycle_start178,TSPB,51813,20426,31387,103,100,200
GreedyLS_Edges_GreedyCycle_start179,TSPB,49479,20047,29432,116,100,200
GreedyLS_Edges_GreedyCycle_start180,TSPB,49169,19298,29871,104,100,200
GreedyLS_Edges_GreedyCycle_start181,TSPB,49840,20912,28928,90,100,200
GreedyLS_Edges_GreedyCycle_start182,TSPB,50643,20753,29890,94,100,200
GreedyLS_Edges_GreedyCycle_start183,TSPB,47259,20219,27040,81,100,200
GreedyLS_Edges_GreedyCycle_start184,TSPB,48417,21070,27347,98,100,200
GreedyLS_Edges_GreedyCycle_start185,TSPB,49878,20919,28959,110,100,200
GreedyLS_Edges_GreedyCycle_start186,TSPB,47901,21014,26887,115,100,200
GreedyLS_Edges_GreedyCycle_start187,TSPB,49288,20049,29239,98,100,200
GreedyLS_Edges_GreedyCycle_start188,TSPB,48162,20871,27291,115,100,200
GreedyLS_Edges_GreedyCycle_start189,TSPB,49122,20407,28715,631,100,200
GreedyLS_Edges_GreedyCycle_start190,TSPB,51549,19783,31766,-2729,100,200
GreedyLS_Edges_GreedyCycle_start191,TSPB,50944,21853,29091,117,100,200
GreedyLS_Edges_GreedyCycle_start192,TSPB,49672,20713,28959,108,100,200
GreedyLS_Edges_GreedyCycle_start193,TSPB,51699,21261,30438,117,100,200
GreedyLS_Edges_GreedyCycle_start194,TSPB,52462,19724,32738,107,100,200
GreedyLS_Edges_GreedyCycle_start195,TSPB,49941,19939,30002,92,100,200
GreedyLS_Edges_GreedyCycle_start196,TSPB,52846,19365,33481,113,100,200
GreedyLS_Edges_GreedyCycle_start197,TSPB,53440,20592,32848,105,100,200
GreedyLS_Edges_GreedyCycle_start198,TSPB,47473,19400,28073,95,100,200
GreedyLS_Edges_GreedyCycle_start199,TSPB,48306,21915,26391,117,100,200
