algorithm,instance,objective_value,path_length,node_costs,computation_time_ms,selected_nodes,total_nodes
SteepestLS_Nodes_Random_start0,TSPB,65046,38782,26264,82,100,200
SteepestLS_Nodes_Random_start1,TSPB,66191,40555,25636,65,100,200
SteepestLS_Nodes_Random_start2,TSPB,68437,44035,24402,72,100,200
SteepestLS_Nodes_Random_start3,TSPB,58947,31987,26960,73,100,200
SteepestLS_Nodes_Random_start4,TSPB,57960,32831,25129,81,100,200
SteepestLS_Nodes_Random_start5,TSPB,64800,39311,25489,84,100,200
SteepestLS_Nodes_Random_start6,TSPB,65764,39012,26752,61,100,200
SteepestLS_Nodes_Random_start7,TSPB,63226,38659,24567,73,100,200
SteepestLS_Nodes_Random_start8,TSPB,63754,38269,25485,76,100,200
SteepestLS_Nodes_Random_start9,TSPB,65477,40458,25019,66,100,200
SteepestLS_Nodes_Random_start10,TSPB,57439,30365,27074,62,100,200
SteepestLS_Nodes_Random_start11,TSPB,64894,40686,24208,58,100,200
SteepestLS_Nodes_Random_start12,TSPB,63970,38925,25045,64,100,200
SteepestLS_Nodes_Random_start13,TSPB,66450,40135,26315,61,100,200
SteepestLS_Nodes_Random_start14,TSPB,59222,33828,25394,85,100,200
SteepestLS_Nodes_Random_start15,TSPB,66180,40723,25457,72,100,200
SteepestLS_Nodes_Random_start16,TSPB,61183,35652,25531,84,100,200
SteepestLS_Nodes_Random_start17,TSPB,64946,40168,24778,69,100,200
SteepestLS_Nodes_Random_start18,TSPB,62039,36112,25927,71,100,200
SteepestLS_Nodes_Random_start19,TSPB,67186,41103,26083,63,100,200
SteepestLS_Nodes_Random_start20,TSPB,61779,35662,26117,71,100,200
SteepestLS_Nodes_Random_start21,TSPB,62002,36315,25687,68,100,200
SteepestLS_Nodes_Random_start22,TSPB,64772,38487,26285,59,100,200
SteepestLS_Nodes_Random_start23,TSPB,66230,40589,25641,67,100,200
SteepestLS_Nodes_Random_start24,TSPB,63049,37827,25222,76,100,200
SteepestLS_Nodes_Random_start25,TSPB,61530,37094,24436,69,100,200
SteepestLS_Nodes_Random_start26,TSPB,61686,36091,25595,70,100,200
SteepestLS_Nodes_Random_start27,TSPB,64448,38442,26006,65,100,200
SteepestLS_Nodes_Random_start28,TSPB,63669,35945,27724,70,100,200
SteepestLS_Nodes_Random_start29,TSPB,66793,40207,26586,67,100,200
SteepestLS_Nodes_Random_start30,TSPB,60597,36364,24233,64,100,200
SteepestLS_Nodes_Random_start31,TSPB,62430,36232,26198,69,100,200
SteepestLS_Nodes_Random_start32,TSPB,63991,38698,25293,64,100,200
SteepestLS_Nodes_Random_start33,TSPB,66514,40747,25767,71,100,200
SteepestLS_Nodes_Random_start34,TSPB,72635,46932,25703,70,100,200
SteepestLS_Nodes_Random_start35,TSPB,60438,35298,25140,66,100,200
SteepestLS_Nodes_Random_start36,TSPB,61803,36514,25289,76,100,200
SteepestLS_Nodes_Random_start37,TSPB,64167,38058,26109,75,100,200
SteepestLS_Nodes_Random_start38,TSPB,66398,41373,25025,65,100,200
SteepestLS_Nodes_Random_start39,TSPB,62787,35455,27332,76,100,200
SteepestLS_Nodes_Random_start40,TSPB,60262,34725,25537,68,100,200
SteepestLS_Nodes_Random_start41,TSPB,69095,43726,25369,57,100,200
SteepestLS_Nodes_Random_start42,TSPB,65117,39059,26058,72,100,200
SteepestLS_Nodes_Random_start43,TSPB,58015,31610,26405,56,100,200
SteepestLS_Nodes_Random_start44,TSPB,62264,35532,26732,68,100,200
SteepestLS_Nodes_Random_start45,TSPB,64632,40303,24329,77,100,200
SteepestLS_Nodes_Random_start46,TSPB,65918,38232,27686,60,100,200
SteepestLS_Nodes_Random_start47,TSPB,67266,40643,26623,65,100,200
SteepestLS_Nodes_Random_start48,TSPB,59492,31731,27761,74,100,200
SteepestLS_Nodes_Random_start49,TSPB,61792,36838,24954,67,100,200
SteepestLS_Nodes_Random_start50,TSPB,67181,39743,27438,66,100,200
SteepestLS_Nodes_Random_start51,TSPB,63395,37879,25516,73,100,200
SteepestLS_Nodes_Random_start52,TSPB,67451,39515,27936,59,100,200
SteepestLS_Nodes_Random_start53,TSPB,61474,32743,28731,76,100,200
SteepestLS_Nodes_Random_start54,TSPB,62511,36059,26452,78,100,200
SteepestLS_Nodes_Random_start55,TSPB,64827,39090,25737,62,100,200
SteepestLS_Nodes_Random_start56,TSPB,59339,34293,25046,80,100,200
SteepestLS_Nodes_Random_start57,TSPB,64169,36911,27258,69,100,200
SteepestLS_Nodes_Random_start58,TSPB,60271,34446,25825,69,100,200
SteepestLS_Nodes_Random_start59,TSPB,65049,36884,28165,65,100,200
SteepestLS_Nodes_Random_start60,TSPB,64335,37512,26823,70,100,200
SteepestLS_Nodes_Random_start61,TSPB,54687,27917,26770,66,100,200
SteepestLS_Nodes_Random_start62,TSPB,61291,36147,25144,65,100,200
SteepestLS_Nodes_Random_start63,TSPB,62687,37963,24724,69,100,200
SteepestLS_Nodes_Random_start64,TSPB,68066,42842,25224,68,100,200
SteepestLS_Nodes_Random_start65,TSPB,60493,35955,24538,69,100,200
SteepestLS_Nodes_Random_start66,TSPB,59472,33420,26052,73,100,200
SteepestLS_Nodes_Random_start67,TSPB,58200,32985,25215,81,100,200
SteepestLS_Nodes_Random_start68,TSPB,61897,36657,25240,69,100,200
SteepestLS_Nodes_Random_start69,TSPB,60992,35523,25469,72,100,200
SteepestLS_Nodes_Random_start70,TSPB,66578,39704,26874,71,100,200
SteepestLS_Nodes_Random_start71,TSPB,57230,31473,25757,74,100,200
SteepestLS_Nodes_Random_start72,TSPB,67197,42124,25073,66,100,200
SteepestLS_Nodes_Random_start73,TSPB,65140,39813,25327,59,100,200
SteepestLS_Nodes_Random_start74,TSPB,60595,34887,25708,72,100,200
SteepestLS_Nodes_Random_start75,TSPB,64870,38216,26654,66,100,200
SteepestLS_Nodes_Random_start76,TSPB,62441,37849,24592,69,100,200
SteepestLS_Nodes_Random_start77,TSPB,63053,38125,24928,79,100,200
SteepestLS_Nodes_Random_start78,TSPB,64157,39512,24645,61,100,200
SteepestLS_Nodes_Random_start79,TSPB,64494,37038,27456,66,100,200
SteepestLS_Nodes_Random_start80,TSPB,59643,35197,24446,69,100,200
SteepestLS_Nodes_Random_start81,TSPB,61548,36641,24907,74,100,200
SteepestLS_Nodes_Random_start82,TSPB,61100,36380,24720,68,100,200
SteepestLS_Nodes_Random_start83,TSPB,67913,40137,27776,68,100,200
SteepestLS_Nodes_Random_start84,TSPB,60227,34764,25463,66,100,200
SteepestLS_Nodes_Random_start85,TSPB,65340,38216,27124,68,100,200
SteepestLS_Nodes_Random_start86,TSPB,62892,36632,26260,57,100,200
SteepestLS_Nodes_Random_start87,TSPB,63094,39037,24057,80,100,200
SteepestLS_Nodes_Random_start88,TSPB,62023,35529,26494,64,100,200
SteepestLS_Nodes_Random_start89,TSPB,64330,37381,26949,81,100,200
SteepestLS_Nodes_Random_start90,TSPB,62245,35329,26916,79,100,200
SteepestLS_Nodes_Random_start91,TSPB,60407,35452,24955,70,100,200
SteepestLS_Nodes_Random_start92,TSPB,62229,37852,24377,68,100,200
SteepestLS_Nodes_Random_start93,TSPB,59261,33752,25509,70,100,200
SteepestLS_Nodes_Random_start94,TSPB,60382,35424,24958,74,100,200
SteepestLS_Nodes_Random_start95,TSPB,60899,36393,24506,61,100,200
SteepestLS_Nodes_Random_start96,TSPB,68179,42877,25302,71,100,200
SteepestLS_Nodes_Random_start97,TSPB,66405,40320,26085,62,100,200
SteepestLS_Nodes_Random_start98,TSPB,61840,36891,24949,67,100,200
SteepestLS_Nodes_Random_start99,TSPB,59675,33362,26313,71,100,200
SteepestLS_Nodes_Random_start100,TSPB,63091,38539,24552,64,100,200
SteepestLS_Nodes_Random_start101,TSPB,63469,38220,25249,62,100,200
SteepestLS_Nodes_Random_start102,TSPB,60870,35705,25165,81,100,200
SteepestLS_Nodes_Random_start103,TSPB,66259,39741,26518,73,100,200
SteepestLS_Nodes_Random_start104,TSPB,63191,37801,25390,64,100,200
SteepestLS_Nodes_Random_start105,TSPB,61196,34557,26639,71,100,200
SteepestLS_Nodes_Random_start106,TSPB,57286,30885,26401,68,100,200
SteepestLS_Nodes_Random_start107,TSPB,67613,39871,27742,66,100,200
SteepestLS_Nodes_Random_start108,TSPB,63631,37863,25768,66,100,200
SteepestLS_Nodes_Random_start109,TSPB,63734,39623,24111,71,100,200
SteepestLS_Nodes_Random_start110,TSPB,57374,32140,25234,63,100,200
SteepestLS_Nodes_Random_start111,TSPB,63295,38057,25238,59,100,200
SteepestLS_Nodes_Random_start112,TSPB,62710,34892,27818,59,100,200
SteepestLS_Nodes_Random_start113,TSPB,63635,38064,25571,77,100,200
SteepestLS_Nodes_Random_start114,TSPB,67010,38485,28525,67,100,200
SteepestLS_Nodes_Random_start115,TSPB,61238,36262,24976,71,100,200
SteepestLS_Nodes_Random_start116,TSPB,63686,39594,24092,72,100,200
SteepestLS_Nodes_Random_start117,TSPB,60659,35283,25376,74,100,200
SteepestLS_Nodes_Random_start118,TSPB,67257,41517,25740,63,100,200
SteepestLS_Nodes_Random_start119,TSPB,65258,39000,26258,69,100,200
SteepestLS_Nodes_Random_start120,TSPB,65763,39828,25935,66,100,200
SteepestLS_Nodes_Random_start121,TSPB,65967,39281,26686,71,100,200
SteepestLS_Nodes_Random_start122,TSPB,62463,37355,25108,68,100,200
SteepestLS_Nodes_Random_start123,TSPB,64716,39774,24942,72,100,200
SteepestLS_Nodes_Random_start124,TSPB,59927,33828,26099,70,100,200
SteepestLS_Nodes_Random_start125,TSPB,65378,39418,25960,62,100,200
SteepestLS_Nodes_Random_start126,TSPB,59076,33647,25429,65,100,200
SteepestLS_Nodes_Random_start127,TSPB,61227,36895,24332,75,100,200
SteepestLS_Nodes_Random_start128,TSPB,61145,35228,25917,71,100,200
SteepestLS_Nodes_Random_start129,TSPB,62534,38290,24244,63,100,200
SteepestLS_Nodes_Random_start130,TSPB,59782,34412,25370,70,100,200
SteepestLS_Nodes_Random_start131,TSPB,64760,39389,25371,69,100,200
SteepestLS_Nodes_Random_start132,TSPB,61410,35588,25822,61,100,200
SteepestLS_Nodes_Random_start133,TSPB,62960,35700,27260,85,100,200
SteepestLS_Nodes_Random_start134,TSPB,63977,39103,24874,70,100,200
SteepestLS_Nodes_Random_start135,TSPB,62381,37044,25337,60,100,200
SteepestLS_Nodes_Random_start136,TSPB,63908,38379,25529,63,100,200
SteepestLS_Nodes_Random_start137,TSPB,61540,36046,25494,71,100,200
SteepestLS_Nodes_Random_start138,TSPB,65242,39150,26092,70,100,200
SteepestLS_Nodes_Random_start139,TSPB,57963,33421,24542,75,100,200
SteepestLS_Nodes_Random_start140,TSPB,64589,38825,25764,67,100,200
SteepestLS_Nodes_Random_start141,TSPB,64008,38040,25968,62,100,200
SteepestLS_Nodes_Random_start142,TSPB,62046,35753,26293,68,100,200
SteepestLS_Nodes_Random_start143,TSPB,61536,35711,25825,64,100,200
SteepestLS_Nodes_Random_start144,TSPB,62360,35350,27010,79,100,200
SteepestLS_Nodes_Random_start145,TSPB,62233,35636,26597,74,100,200
SteepestLS_Nodes_Random_start146,TSPB,63380,38744,24636,69,100,200
SteepestLS_Nodes_Random_start147,TSPB,63525,38630,24895,67,100,200
SteepestLS_Nodes_Random_start148,TSPB,57808,32526,25282,70,100,200
SteepestLS_Nodes_Random_start149,TSPB,66022,41027,24995,61,100,200
SteepestLS_Nodes_Random_start150,TSPB,62314,36760,25554,68,100,200
SteepestLS_Nodes_Random_start151,TSPB,62739,36406,26333,64,100,200
SteepestLS_Nodes_Random_start152,TSPB,65859,38808,27051,61,100,200
SteepestLS_Nodes_Random_start153,TSPB,59788,33901,25887,86,100,200
SteepestLS_Nodes_Random_start154,TSPB,66864,37639,29225,55,100,200
SteepestLS_Nodes_Random_start155,TSPB,68809,42589,26220,58,100,200
SteepestLS_Nodes_Random_start156,TSPB,65760,39773,25987,63,100,200
SteepestLS_Nodes_Random_start157,TSPB,57587,32205,25382,79,100,200
SteepestLS_Nodes_Random_start158,TSPB,61234,33685,27549,64,100,200
SteepestLS_Nodes_Random_start159,TSPB,71722,45030,26692,64,100,200
SteepestLS_Nodes_Random_start160,TSPB,58012,32941,25071,74,100,200
SteepestLS_Nodes_Random_start161,TSPB,65005,39046,25959,76,100,200
SteepestLS_Nodes_Random_start162,TSPB,62837,37791,25046,67,100,200
SteepestLS_Nodes_Random_start163,TSPB,63962,37339,26623,62,100,200
SteepestLS_Nodes_Random_start164,TSPB,62487,36925,25562,64,100,200
SteepestLS_Nodes_Random_start165,TSPB,63033,36322,26711,69,100,200
SteepestLS_Nodes_Random_start166,TSPB,61517,34509,27008,66,100,200
SteepestLS_Nodes_Random_start167,TSPB,61972,36924,25048,63,100,200
SteepestLS_Nodes_Random_start168,TSPB,62968,37980,24988,64,100,200
SteepestLS_Nodes_Random_start169,TSPB,65567,39755,25812,71,100,200
SteepestLS_Nodes_Random_start170,TSPB,66293,39521,26772,64,100,200
SteepestLS_Nodes_Random_start171,TSPB,66161,40384,25777,67,100,200
SteepestLS_Nodes_Random_start172,TSPB,60866,35306,25560,70,100,200
SteepestLS_Nodes_Random_start173,TSPB,60667,34131,26536,66,100,200
SteepestLS_Nodes_Random_start174,TSPB,60718,34531,26187,72,100,200
SteepestLS_Nodes_Random_start175,TSPB,60604,36018,24586,59,100,200
SteepestLS_Nodes_Random_start176,TSPB,68006,41587,26419,73,100,200
SteepestLS_Nodes_Random_start177,TSPB,61853,36103,25750,70,100,200
SteepestLS_Nodes_Random_start178,TSPB,59848,35239,24609,76,100,200
SteepestLS_Nodes_Random_start179,TSPB,60759,35628,25131,75,100,200
SteepestLS_Nodes_Random_start180,TSPB,63031,34365,28666,58,100,200
SteepestLS_Nodes_Random_start181,TSPB,63972,38523,25449,72,100,200
SteepestLS_Nodes_Random_start182,TSPB,56029,29872,26157,79,100,200
SteepestLS_Nodes_Random_start183,TSPB,64240,38532,25708,67,100,200
SteepestLS_Nodes_Random_start184,TSPB,64412,39091,25321,73,100,200
SteepestLS_Nodes_Random_start185,TSPB,56798,31155,25643,74,100,200
SteepestLS_Nodes_Random_start186,TSPB,65198,39461,25737,61,100,200
SteepestLS_Nodes_Random_start187,TSPB,61618,35617,26001,61,100,200
SteepestLS_Nodes_Random_start188,TSPB,62812,36568,26244,74,100,200
SteepestLS_Nodes_Random_start189,TSPB,64537,39098,25439,70,100,200
SteepestLS_Nodes_Random_start190,TSPB,65166,40605,24561,85,100,200
SteepestLS_Nodes_Random_start191,TSPB,67081,40631,26450,66,100,200
SteepestLS_Nodes_Random_start192,TSPB,61962,35173,26789,68,100,200
SteepestLS_Nodes_Random_start193,TSPB,59597,34339,25258,63,100,200
SteepestLS_Nodes_Random_start194,TSPB,63713,37857,25856,65,100,200
SteepestLS_Nodes_Random_start195,TSPB,59772,33995,25777,72,100,200
SteepestLS_Nodes_Random_start196,TSPB,64988,39810,25178,70,100,200
SteepestLS_Nodes_Random_start197,TSPB,58797,33749,25048,77,100,200
SteepestLS_Nodes_Random_start198,TSPB,59926,32704,27222,79,100,200
SteepestLS_Nodes_Random_start199,TSPB,64083,36715,27368,58,100,200
SteepestLS_Nodes_NearestNeighborAny2Regret_w1_1_start0,TSPB,45836,19071,26765,5,100,200
SteepestLS_Nodes_NearestNeighborAny2Regret_w1_1_start1,TSPB,44488,19854,24634,6,100,200
SteepestLS_Nodes_NearestNeighborAny2Regret_w1_1_start2,TSPB,45826,19506,26320,7,100,200
SteepestLS_Nodes_NearestNeighborAny2Regret_w1_1_start3,TSPB,48742,20998,27744,6,100,200
SteepestLS_Nodes_NearestNeighborAny2Regret_w1_1_start4,TSPB,48338,21840,26498,7,100,200
SteepestLS_Nodes_NearestNeighborAny2Regret_w1_1_start5,TSPB,47132,20595,26537,6,100,200
SteepestLS_Nodes_NearestNeighborAny2Regret_w1_1_start6,TSPB,46075,20800,25275,5,100,200
SteepestLS_Nodes_NearestNeighborAny2Regret_w1_1_start7,TSPB,49799,19347,30452,7,100,200
SteepestLS_Nodes_NearestNeighborAny2Regret_w1_1_start8,TSPB,45836,19071,26765,6,100,200
SteepestLS_Nodes_NearestNeighborAny2Regret_w1_1_start9,TSPB,46210,20921,25289,5,100,200
SteepestLS_Nodes_NearestNeighborAny2Regret_w1_1_start10,TSPB,46606,21971,24635,7,100,200
SteepestLS_Nodes_NearestNeighborAny2Regret_w1_1_start11,TSPB,49786,19871,29915,8,100,200
SteepestLS_Nodes_NearestNeighborAny2Regret_w1_1_start12,TSPB,46158,19109,27049,5,100,200
SteepestLS_Nodes_NearestNeighborAny2Regret_w1_1_start13,TSPB,48713,20724,27989,4,100,200
SteepestLS_Nodes_NearestNeighborAny2Regret_w1_1_start14,TSPB,47605,19545,28060,9,100,200
SteepestLS_Nodes_NearestNeighborAny2Regret_w1_1_start15,TSPB,48742,20998,27744,6,100,200
SteepestLS_Nodes_NearestNeighborAny2Regret_w1_1_start16,TSPB,44488,19854,24634,6,100,200
SteepestLS_Nodes_NearestNeighborAny2Regret_w1_1_start17,TSPB,44979,20530,24449,7,100,200
SteepestLS_Nodes_NearestNeighborAny2Regret_w1_1_start18,TSPB,48338,21840,26498,6,100,200
SteepestLS_Nodes_NearestNeighborAny2Regret_w1_1_start19,TSPB,44845,20396,24449,7,100,200
SteepestLS_Nodes_NearestNeighborAny2Regret_w1_1_start20,TSPB,48088,19975,28113,6,100,200
SteepestLS_Nodes_NearestNeighborAny2Regret_w1_1_start21,TSPB,46153,20516,25637,9,100,200
SteepestLS_Nodes_NearestNeighborAny2Regret_w1_1_start22,TSPB,48088,19975,28113,6,100,200
SteepestLS_Nodes_NearestNeighborAny2Regret_w1_1_start23,TSPB,48540,21870,26670,8,100,200
SteepestLS_Nodes_NearestNeighborAny2Regret_w1_1_start24,TSPB,44808,20086,24722,10,100,200
SteepestLS_Nodes_NearestNeighborAny2Regret_w1_1_start25,TSPB,48088,19975,28113,6,100,200
SteepestLS_Nodes_NearestNeighborAny2Regret_w1_1_start26,TSPB,44696,20102,24594,8,100,200
SteepestLS_Nodes_NearestNeighborAny2Regret_w1_1_start27,TSPB,46075,20800,25275,5,100,200
SteepestLS_Nodes_NearestNeighborAny2Regret_w1_1_start28,TSPB,48338,21840,26498,6,100,200
SteepestLS_Nodes_NearestNeighborAny2Regret_w1_1_start29,TSPB,45836,19071,26765,6,100,200
SteepestLS_Nodes_NearestNeighborAny2Regret_w1_1_start30,TSPB,44808,20086,24722,8,100,200
SteepestLS_Nodes_NearestNeighborAny2Regret_w1_1_start31,TSPB,46466,20915,25551,6,100,200
SteepestLS_Nodes_NearestNeighborAny2Regret_w1_1_start32,TSPB,48088,19975,28113,6,100,200
SteepestLS_Nodes_NearestNeighborAny2Regret_w1_1_start33,TSPB,45836,19071,26765,6,100,200
SteepestLS_Nodes_NearestNeighborAny2Regret_w1_1_start34,TSPB,46094,20515,25579,7,100,200
SteepestLS_Nodes_NearestNeighborAny2Regret_w1_1_start35,TSPB,45836,19071,26765,5,100,200
SteepestLS_Nodes_NearestNeighborAny2Regret_w1_1_start36,TSPB,48088,19975,28113,6,100,200
SteepestLS_Nodes_NearestNeighborAny2Regret_w1_1_start37,TSPB,48077,23420,24657,7,100,200
SteepestLS_Nodes_NearestNeighborAny2Regret_w1_1_start38,TSPB,45670,20143,25527,6,100,200
SteepestLS_Nodes_NearestNeighborAny2Regret_w1_1_start39,TSPB,50314,20465,29849,6,100,200
SteepestLS_Nodes_NearestNeighborAny2Regret_w1_1_start40,TSPB,48088,19975,28113,6,100,200
SteepestLS_Nodes_NearestNeighborAny2Regret_w1_1_start41,TSPB,47697,19730,27967,7,100,200
SteepestLS_Nodes_NearestNeighborAny2Regret_w1_1_start42,TSPB,44488,19854,24634,6,100,200
SteepestLS_Nodes_NearestNeighborAny2Regret_w1_1_start43,TSPB,48742,20998,27744,6,100,200
SteepestLS_Nodes_NearestNeighborAny2Regret_w1_1_start44,TSPB,48800,20658,28142,6,100,200
SteepestLS_Nodes_NearestNeighborAny2Regret_w1_1_start45,TSPB,47132,20595,26537,6,100,200
SteepestLS_Nodes_NearestNeighborAny2Regret_w1_1_start46,TSPB,46082,19134,26948,6,100,200
SteepestLS_Nodes_NearestNeighborAny2Regret_w1_1_start47,TSPB,48088,19975,28113,6,100,200
SteepestLS_Nodes_NearestNeighborAny2Regret_w1_1_start48,TSPB,52850,23040,29810,8,100,200
SteepestLS_Nodes_NearestNeighborAny2Regret_w1_1_start49,TSPB,45914,18838,27076,5,100,200
SteepestLS_Nodes_NearestNeighborAny2Regret_w1_1_start50,TSPB,47605,19545,28060,8,100,200
SteepestLS_Nodes_NearestNeighborAny2Regret_w1_1_start51,TSPB,46466,20915,25551,5,100,200
SteepestLS_Nodes_NearestNeighborAny2Regret_w1_1_start52,TSPB,48520,19573,28947,7,100,200
SteepestLS_Nodes_NearestNeighborAny2Regret_w1_1_start53,TSPB,45948,20361,25587,9,100,200
SteepestLS_Nodes_NearestNeighborAny2Regret_w1_1_start54,TSPB,46466,20915,25551,6,100,200
SteepestLS_Nodes_NearestNeighborAny2Regret_w1_1_start55,TSPB,48338,21840,26498,6,100,200
SteepestLS_Nodes_NearestNeighborAny2Regret_w1_1_start56,TSPB,47183,20519,26664,7,100,200
SteepestLS_Nodes_NearestNeighborAny2Regret_w1_1_start57,TSPB,48088,19975,28113,6,100,200
SteepestLS_Nodes_NearestNeighborAny2Regret_w1_1_start58,TSPB,48744,20946,27798,7,100,200
SteepestLS_Nodes_NearestNeighborAny2Regret_w1_1_start59,TSPB,48338,21840,26498,7,100,200
SteepestLS_Nodes_NearestNeighborAny2Regret_w1_1_start60,TSPB,48338,21840,26498,7,100,200
SteepestLS_Nodes_NearestNeighborAny2Regret_w1_1_start61,TSPB,48088,19975,28113,6,100,200
SteepestLS_Nodes_NearestNeighborAny2Regret_w1_1_start62,TSPB,48338,21840,26498,7,100,200
SteepestLS_Nodes_NearestNeighborAny2Regret_w1_1_start63,TSPB,48088,19975,28113,5,100,200
SteepestLS_Nodes_NearestNeighborAny2Regret_w1_1_start64,TSPB,45278,19720,25558,8,100,200
SteepestLS_Nodes_NearestNeighborAny2Regret_w1_1_start65,TSPB,48960,20721,28239,5,100,200
SteepestLS_Nodes_NearestNeighborAny2Regret_w1_1_start66,TSPB,48088,19975,28113,7,100,200
SteepestLS_Nodes_NearestNeighborAny2Regret_w1_1_start67,TSPB,45758,20837,24921,6,100,200
SteepestLS_Nodes_NearestNeighborAny2Regret_w1_1_start68,TSPB,50276,18834,31442,8,100,200
SteepestLS_Nodes_NearestNeighborAny2Regret_w1_1_start69,TSPB,46143,20044,26099,6,100,200
SteepestLS_Nodes_NearestNeighborAny2Regret_w1_1_start70,TSPB,48742,20998,27744,6,100,200
SteepestLS_Nodes_NearestNeighborAny2Regret_w1_1_start71,TSPB,46797,19796,27001,6,100,200
SteepestLS_Nodes_NearestNeighborAny2Regret_w1_1_start72,TSPB,44961,20300,24661,6,100,200
SteepestLS_Nodes_NearestNeighborAny2Regret_w1_1_start73,TSPB,45883,20467,25416,4,100,200
SteepestLS_Nodes_NearestNeighborAny2Regret_w1_1_start74,TSPB,47233,21618,25615,9,100,200
SteepestLS_Nodes_NearestNeighborAny2Regret_w1_1_start75,TSPB,44846,20192,24654,9,100,200
SteepestLS_Nodes_NearestNeighborAny2Regret_w1_1_start76,TSPB,51451,20777,30674,8,100,200
SteepestLS_Nodes_NearestNeighborAny2Regret_w1_1_start77,TSPB,44488,19854,24634,7,100,200
SteepestLS_Nodes_NearestNeighborAny2Regret_w1_1_start78,TSPB,47132,20595,26537,6,100,200
SteepestLS_Nodes_NearestNeighborAny2Regret_w1_1_start79,TSPB,48152,19959,28193,5,100,200
SteepestLS_Nodes_NearestNeighborAny2Regret_w1_1_start80,TSPB,46466,20915,25551,6,100,200
SteepestLS_Nodes_NearestNeighborAny2Regret_w1_1_start81,TSPB,48338,21840,26498,9,100,200
SteepestLS_Nodes_NearestNeighborAny2Regret_w1_1_start82,TSPB,46727,20498,26229,8,100,200
SteepestLS_Nodes_NearestNeighborAny2Regret_w1_1_start83,TSPB,48507,21891,26616,8,100,200
SteepestLS_Nodes_NearestNeighborAny2Regret_w1_1_start84,TSPB,45355,19930,25425,7,100,200
SteepestLS_Nodes_NearestNeighborAny2Regret_w1_1_start85,TSPB,45633,19769,25864,6,100,200
SteepestLS_Nodes_NearestNeighborAny2Regret_w1_1_start86,TSPB,48088,19975,28113,6,100,200
SteepestLS_Nodes_NearestNeighborAny2Regret_w1_1_start87,TSPB,46453,20619,25834,8,100,200
SteepestLS_Nodes_NearestNeighborAny2Regret_w1_1_start88,TSPB,48006,19962,28044,6,100,200
SteepestLS_Nodes_NearestNeighborAny2Regret_w1_1_start89,TSPB,48088,19975,28113,6,100,200
SteepestLS_Nodes_NearestNeighborAny2Regret_w1_1_start90,TSPB,44845,20396,24449,7,100,200
SteepestLS_Nodes_NearestNeighborAny2Regret_w1_1_start91,TSPB,48088,19975,28113,6,100,200
SteepestLS_Nodes_NearestNeighborAny2Regret_w1_1_start92,TSPB,48088,19975,28113,6,100,200
SteepestLS_Nodes_NearestNeighborAny2Regret_w1_1_start93,TSPB,51546,20944,30602,8,100,200
SteepestLS_Nodes_NearestNeighborAny2Regret_w1_1_start94,TSPB,48088,19975,28113,6,100,200
SteepestLS_Nodes_NearestNeighborAny2Regret_w1_1_start95,TSPB,51362,22702,28660,7,100,200
SteepestLS_Nodes_NearestNeighborAny2Regret_w1_1_start96,TSPB,48088,19975,28113,6,100,200
SteepestLS_Nodes_NearestNeighborAny2Regret_w1_1_start97,TSPB,44755,19938,24817,6,100,200
SteepestLS_Nodes_NearestNeighborAny2Regret_w1_1_start98,TSPB,45278,19904,25374,7,100,200
SteepestLS_Nodes_NearestNeighborAny2Regret_w1_1_start99,TSPB,48088,19975,28113,6,100,200
SteepestLS_Nodes_NearestNeighborAny2Regret_w1_1_start100,TSPB,48088,19975,28113,6,100,200
SteepestLS_Nodes_NearestNeighborAny2Regret_w1_1_start101,TSPB,48611,21830,26781,8,100,200
SteepestLS_Nodes_NearestNeighborAny2Regret_w1_1_start102,TSPB,48088,19975,28113,5,100,200
SteepestLS_Nodes_NearestNeighborAny2Regret_w1_1_start103,TSPB,44488,19854,24634,6,100,200
SteepestLS_Nodes_NearestNeighborAny2Regret_w1_1_start104,TSPB,45836,19071,26765,6,100,200
SteepestLS_Nodes_NearestNeighborAny2Regret_w1_1_start105,TSPB,45135,19270,25865,7,100,200
SteepestLS_Nodes_NearestNeighborAny2Regret_w1_1_start106,TSPB,48338,21840,26498,7,100,200
SteepestLS_Nodes_NearestNeighborAny2Regret_w1_1_start107,TSPB,48088,19975,28113,6,100,200
SteepestLS_Nodes_NearestNeighborAny2Regret_w1_1_start108,TSPB,46569,20519,26050,8,100,200
SteepestLS_Nodes_NearestNeighborAny2Regret_w1_1_start109,TSPB,45836,19071,26765,6,100,200
SteepestLS_Nodes_NearestNeighborAny2Regret_w1_1_start110,TSPB,45966,19730,26236,6,100,200
SteepestLS_Nodes_NearestNeighborAny2Regret_w1_1_start111,TSPB,48712,18663,30049,8,100,200
SteepestLS_Nodes_NearestNeighborAny2Regret_w1_1_start112,TSPB,45076,20416,24660,6,100,200
SteepestLS_Nodes_NearestNeighborAny2Regret_w1_1_start113,TSPB,48088,19975,28113,6,100,200
SteepestLS_Nodes_NearestNeighborAny2Regret_w1_1_start114,TSPB,45300,19862,25438,6,100,200
SteepestLS_Nodes_NearestNeighborAny2Regret_w1_1_start115,TSPB,44895,20323,24572,8,100,200
SteepestLS_Nodes_NearestNeighborAny2Regret_w1_1_start116,TSPB,45056,20155,24901,5,100,200
SteepestLS_Nodes_NearestNeighborAny2Regret_w1_1_start117,TSPB,46466,20915,25551,6,100,200
SteepestLS_Nodes_NearestNeighborAny2Regret_w1_1_start118,TSPB,45685,19884,25801,4,100,200
SteepestLS_Nodes_NearestNeighborAny2Regret_w1_1_start119,TSPB,47598,21260,26338,7,100,200
SteepestLS_Nodes_NearestNeighborAny2Regret_w1_1_start120,TSPB,45758,20837,24921,7,100,200
SteepestLS_Nodes_NearestNeighborAny2Regret_w1_1_start121,TSPB,44845,20396,24449,7,100,200
SteepestLS_Nodes_NearestNeighborAny2Regret_w1_1_start122,TSPB,48088,19975,28113,5,100,200
SteepestLS_Nodes_NearestNeighborAny2Regret_w1_1_start123,TSPB,48291,19968,28323,6,100,200
SteepestLS_Nodes_NearestNeighborAny2Regret_w1_1_start124,TSPB,48338,21840,26498,7,100,200
SteepestLS_Nodes_NearestNeighborAny2Regret_w1_1_start125,TSPB,48088,19975,28113,5,100,200
SteepestLS_Nodes_NearestNeighborAny2Regret_w1_1_start126,TSPB,48664,20601,28063,5,100,200
SteepestLS_Nodes_NearestNeighborAny2Regret_w1_1_start127,TSPB,48088,19975,28113,6,100,200
SteepestLS_Nodes_NearestNeighborAny2Regret_w1_1_start128,TSPB,46134,20406,25728,8,100,200
SteepestLS_Nodes_NearestNeighborAny2Regret_w1_1_start129,TSPB,44488,19854,24634,7,100,200
SteepestLS_Nodes_NearestNeighborAny2Regret_w1_1_start130,TSPB,48243,21772,26471,7,100,200
SteepestLS_Nodes_NearestNeighborAny2Regret_w1_1_start131,TSPB,48088,19975,28113,7,100,200
SteepestLS_Nodes_NearestNeighborAny2Regret_w1_1_start132,TSPB,48713,20724,27989,4,100,200
SteepestLS_Nodes_NearestNeighborAny2Regret_w1_1_start133,TSPB,48619,20720,27899,6,100,200
SteepestLS_Nodes_NearestNeighborAny2Regret_w1_1_start134,TSPB,45621,19916,25705,6,100,200
SteepestLS_Nodes_NearestNeighborAny2Regret_w1_1_start135,TSPB,48088,19975,28113,5,100,200
SteepestLS_Nodes_NearestNeighborAny2Regret_w1_1_start136,TSPB,46447,20847,25600,7,100,200
SteepestLS_Nodes_NearestNeighborAny2Regret_w1_1_start137,TSPB,54391,23460,30931,8,100,200
SteepestLS_Nodes_NearestNeighborAny2Regret_w1_1_start138,TSPB,49984,20288,29696,10,100,200
SteepestLS_Nodes_NearestNeighborAny2Regret_w1_1_start139,TSPB,49186,19551,29635,6,100,200
SteepestLS_Nodes_NearestNeighborAny2Regret_w1_1_start140,TSPB,48338,21840,26498,7,100,200
SteepestLS_Nodes_NearestNeighborAny2Regret_w1_1_start141,TSPB,44488,19854,24634,6,100,200
SteepestLS_Nodes_NearestNeighborAny2Regret_w1_1_start142,TSPB,47132,20595,26537,6,100,200
SteepestLS_Nodes_NearestNeighborAny2Regret_w1_1_start143,TSPB,47818,19072,28746,8,100,200
SteepestLS_Nodes_NearestNeighborAny2Regret_w1_1_start144,TSPB,45863,18882,26981,7,100,200
SteepestLS_Nodes_NearestNeighborAny2Regret_w1_1_start145,TSPB,48742,20998,27744,6,100,200
SteepestLS_Nodes_NearestNeighborAny2Regret_w1_1_start146,TSPB,46982,20049,26933,6,100,200
SteepestLS_Nodes_NearestNeighborAny2Regret_w1_1_start147,TSPB,46466,20915,25551,5,100,200
SteepestLS_Nodes_NearestNeighborAny2Regret_w1_1_start148,TSPB,48088,19975,28113,7,100,200
SteepestLS_Nodes_NearestNeighborAny2Regret_w1_1_start149,TSPB,48338,21840,26498,7,100,200
SteepestLS_Nodes_NearestNeighborAny2Regret_w1_1_start150,TSPB,46685,21221,25464,6,100,200
SteepestLS_Nodes_NearestNeighborAny2Regret_w1_1_start151,TSPB,44845,20396,24449,7,100,200
SteepestLS_Nodes_NearestNeighborAny2Regret_w1_1_start152,TSPB,45621,19916,25705,6,100,200
SteepestLS_Nodes_NearestNeighborAny2Regret_w1_1_start153,TSPB,44488,19854,24634,6,100,200
SteepestLS_Nodes_NearestNeighborAny2Regret_w1_1_start154,TSPB,46672,20845,25827,6,100,200
SteepestLS_Nodes_NearestNeighborAny2Regret_w1_1_start155,TSPB,46466,20915,25551,6,100,200
SteepestLS_Nodes_NearestNeighborAny2Regret_w1_1_start156,TSPB,44606,20265,24341,7,100,200
SteepestLS_Nodes_NearestNeighborAny2Regret_w1_1_start157,TSPB,45955,19179,26776,7,100,200
SteepestLS_Nodes_NearestNeighborAny2Regret_w1_1_start158,TSPB,48088,19975,28113,7,100,200
SteepestLS_Nodes_NearestNeighborAny2Regret_w1_1_start159,TSPB,47472,20580,26892,7,100,200
SteepestLS_Nodes_NearestNeighborAny2Regret_w1_1_start160,TSPB,49984,20288,29696,7,100,200
SteepestLS_Nodes_NearestNeighborAny2Regret_w1_1_start161,TSPB,45587,19601,25986,6,100,200
SteepestLS_Nodes_NearestNeighborAny2Regret_w1_1_start162,TSPB,47132,20595,26537,6,100,200
SteepestLS_Nodes_NearestNeighborAny2Regret_w1_1_start163,TSPB,44488,19854,24634,6,100,200
SteepestLS_Nodes_NearestNeighborAny2Regret_w1_1_start164,TSPB,46397,20818,25579,6,100,200
SteepestLS_Nodes_NearestNeighborAny2Regret_w1_1_start165,TSPB,44639,19917,24722,6,100,200
SteepestLS_Nodes_NearestNeighborAny2Regret_w1_1_start166,TSPB,48088,19975,28113,6,100,200
SteepestLS_Nodes_NearestNeighborAny2Regret_w1_1_start167,TSPB,46192,20115,26077,11,100,200
SteepestLS_Nodes_NearestNeighborAny2Regret_w1_1_start168,TSPB,48713,20724,27989,5,100,200
SteepestLS_Nodes_NearestNeighborAny2Regret_w1_1_start169,TSPB,48713,20724,27989,5,100,200
SteepestLS_Nodes_NearestNeighborAny2Regret_w1_1_start170,TSPB,46411,20463,25948,6,100,200
SteepestLS_Nodes_NearestNeighborAny2Regret_w1_1_start171,TSPB,46985,19515,27470,7,100,200
SteepestLS_Nodes_NearestNeighborAny2Regret_w1_1_start172,TSPB,44488,19854,24634,6,100,200
SteepestLS_Nodes_NearestNeighborAny2Regret_w1_1_start173,TSPB,44759,19856,24903,7,100,200
SteepestLS_Nodes_NearestNeighborAny2Regret_w1_1_start174,TSPB,48550,21909,26641,8,100,200
SteepestLS_Nodes_NearestNeighborAny2Regret_w1_1_start175,TSPB,47132,20595,26537,6,100,200
SteepestLS_Nodes_NearestNeighborAny2Regret_w1_1_start176,TSPB,48088,19975,28113,6,100,200
SteepestLS_Nodes_NearestNeighborAny2Regret_w1_1_start177,TSPB,47132,20595,26537,6,100,200
SteepestLS_Nodes_NearestNeighborAny2Regret_w1_1_start178,TSPB,44895,20323,24572,8,100,200
SteepestLS_Nodes_NearestNeighborAny2Regret_w1_1_start179,TSPB,44488,19854,24634,6,100,200
SteepestLS_Nodes_NearestNeighborAny2Regret_w1_1_start180,TSPB,48006,19962,28044,6,100,200
SteepestLS_Nodes_NearestNeighborAny2Regret_w1_1_start181,TSPB,48586,19612,28974,8,100,200
SteepestLS_Nodes_NearestNeighborAny2Regret_w1_1_start182,TSPB,49786,19871,29915,8,100,200
SteepestLS_Nodes_NearestNeighborAny2Regret_w1_1_start183,TSPB,48338,21840,26498,7,100,200
SteepestLS_Nodes_NearestNeighborAny2Regret_w1_1_start184,TSPB,46051,20866,25185,6,100,200
SteepestLS_Nodes_NearestNeighborAny2Regret_w1_1_start185,TSPB,48088,19975,28113,6,100,200
SteepestLS_Nodes_NearestNeighborAny2Regret_w1_1_start186,TSPB,44488,19854,24634,7,100,200
SteepestLS_Nodes_NearestNeighborAny2Regret_w1_1_start187,TSPB,46445,19928,26517,6,100,200
SteepestLS_Nodes_NearestNeighborAny2Regret_w1_1_start188,TSPB,48713,20724,27989,5,100,200
SteepestLS_Nodes_NearestNeighborAny2Regret_w1_1_start189,TSPB,46943,21102,25841,7,100,200
SteepestLS_Nodes_NearestNeighborAny2Regret_w1_1_start190,TSPB,46466,20915,25551,5,100,200
SteepestLS_Nodes_NearestNeighborAny2Regret_w1_1_start191,TSPB,46797,19796,27001,6,100,200
SteepestLS_Nodes_NearestNeighborAny2Regret_w1_1_start192,TSPB,46685,21221,25464,7,100,200
SteepestLS_Nodes_NearestNeighborAny2Regret_w1_1_start193,TSPB,45883,20467,25416,4,100,200
SteepestLS_Nodes_NearestNeighborAny2Regret_w1_1_start194,TSPB,48088,19975,28113,6,100,200
SteepestLS_Nodes_NearestNeighborAny2Regret_w1_1_start195,TSPB,48713,20724,27989,5,100,200
SteepestLS_Nodes_NearestNeighborAny2Regret_w1_1_start196,TSPB,47104,20596,26508,5,100,200
SteepestLS_Nodes_NearestNeighborAny2Regret_w1_1_start197,TSPB,44895,19843,25052,9,100,200
SteepestLS_Nodes_NearestNeighborAny2Regret_w1_1_start198,TSPB,45883,20467,25416,5,100,200
SteepestLS_Nodes_NearestNeighborAny2Regret_w1_1_start199,TSPB,48319,22110,26209,8,100,200
SteepestLS_Edges_Random_start0,TSPB,49876,21595,28281,53,100,200
SteepestLS_Edges_Random_start1,TSPB,47620,20477,27143,57,100,200
SteepestLS_Edges_Random_start2,TSPB,49591,20770,28821,59,100,200
SteepestLS_Edges_Random_start3,TSPB,48785,20988,27797,53,100,200
SteepestLS_Edges_Random_start4,TSPB,47801,20536,27265,58,100,200
SteepestLS_Edges_Random_start5,TSPB,48078,20182,27896,53,100,200
SteepestLS_Edges_Random_start6,TSPB,49170,21440,27730,51,100,200
SteepestLS_Edges_Random_start7,TSPB,49508,20847,28661,54,100,200
SteepestLS_Edges_Random_start8,TSPB,48441,21326,27115,53,100,200
SteepestLS_Edges_Random_start9,TSPB,48473,22176,26297,54,100,200
SteepestLS_Edges_Random_start10,TSPB,48097,21185,26912,57,100,200
SteepestLS_Edges_Random_start11,TSPB,48309,21260,27049,56,100,200
SteepestLS_Edges_Random_start12,TSPB,47106,20859,26247,59,100,200
SteepestLS_Edges_Random_start13,TSPB,48134,20238,27896,64,100,200
SteepestLS_Edges_Random_start14,TSPB,50704,20551,30153,55,100,200
SteepestLS_Edges_Random_start15,TSPB,48563,21788,26775,56,100,200
SteepestLS_Edges_Random_start16,TSPB,49852,18608,31244,57,100,200
SteepestLS_Edges_Random_start17,TSPB,48716,21101,27615,55,100,200
SteepestLS_Edges_Random_start18,TSPB,50160,23380,26780,58,100,200
SteepestLS_Edges_Random_start19,TSPB,46862,19577,27285,42,100,200
SteepestLS_Edges_Random_start20,TSPB,48051,20257,27794,64,100,200
SteepestLS_Edges_Random_start21,TSPB,48498,21474,27024,55,100,200
SteepestLS_Edges_Random_start22,TSPB,48843,21766,27077,57,100,200
SteepestLS_Edges_Random_start23,TSPB,48108,20702,27406,51,100,200
SteepestLS_Edges_Random_start24,TSPB,48779,22261,26518,60,100,200
SteepestLS_Edges_Random_start25,TSPB,46914,20551,26363,64,100,200
SteepestLS_Edges_Random_start26,TSPB,47939,21217,26722,59,100,200
SteepestLS_Edges_Random_start27,TSPB,48555,20433,28122,59,100,200
SteepestLS_Edges_Random_start28,TSPB,48264,20669,27595,54,100,200
SteepestLS_Edges_Random_start29,TSPB,49231,22514,26717,54,100,200
SteepestLS_Edges_Random_start30,TSPB,47066,20829,26237,59,100,200
SteepestLS_Edges_Random_start31,TSPB,50933,22133,28800,56,100,200
SteepestLS_Edges_Random_start32,TSPB,48008,20786,27222,54,100,200
SteepestLS_Edges_Random_start33,TSPB,49940,22421,27519,55,100,200
SteepestLS_Edges_Random_start34,TSPB,48867,21664,27203,62,100,200
SteepestLS_Edges_Random_start35,TSPB,48084,20881,27203,52,100,200
SteepestLS_Edges_Random_start36,TSPB,47601,21182,26419,57,100,200
SteepestLS_Edges_Random_start37,TSPB,48122,21184,26938,59,100,200
SteepestLS_Edges_Random_start38,TSPB,48454,20785,27669,56,100,200
SteepestLS_Edges_Random_start39,TSPB,47314,21406,25908,58,100,200
SteepestLS_Edges_Random_start40,TSPB,48331,21723,26608,54,100,200
SteepestLS_Edges_Random_start41,TSPB,47489,21722,25767,57,100,200
SteepestLS_Edges_Random_start42,TSPB,46064,20401,25663,58,100,200
SteepestLS_Edges_Random_start43,TSPB,47841,21170,26671,54,100,200
SteepestLS_Edges_Random_start44,TSPB,47867,21355,26512,58,100,200
SteepestLS_Edges_Random_start45,TSPB,47942,19398,28544,54,100,200
SteepestLS_Edges_Random_start46,TSPB,50226,23561,26665,58,100,200
SteepestLS_Edges_Random_start47,TSPB,48707,21053,27654,56,100,200
SteepestLS_Edges_Random_start48,TSPB,51223,22736,28487,50,100,200
SteepestLS_Edges_Random_start49,TSPB,46975,21780,25195,55,100,200
SteepestLS_Edges_Random_start50,TSPB,48960,21730,27230,55,100,200
SteepestLS_Edges_Random_start51,TSPB,47142,21986,25156,59,100,200
SteepestLS_Edges_Random_start52,TSPB,49145,21196,27949,56,100,200
SteepestLS_Edges_Random_start53,TSPB,47864,20026,27838,61,100,200
SteepestLS_Edges_Random_start54,TSPB,49132,19690,29442,54,100,200
SteepestLS_Edges_Random_start55,TSPB,48590,20265,28325,57,100,200
SteepestLS_Edges_Random_start56,TSPB,48326,21817,26509,55,100,200
SteepestLS_Edges_Random_start57,TSPB,47378,21277,26101,65,100,200
SteepestLS_Edges_Random_start58,TSPB,46841,20342,26499,56,100,200
SteepestLS_Edges_Random_start59,TSPB,47384,20541,26843,60,100,200
SteepestLS_Edges_Random_start60,TSPB,50620,21485,29135,53,100,200
SteepestLS_Edges_Random_start61,TSPB,47838,20513,27325,55,100,200
SteepestLS_Edges_Random_start62,TSPB,49508,20899,28609,54,100,200
SteepestLS_Edges_Random_start63,TSPB,47695,21653,26042,49,100,200
SteepestLS_Edges_Random_start64,TSPB,47168,20544,26624,59,100,200
SteepestLS_Edges_Random_start65,TSPB,48881,20838,28043,54,100,200
SteepestLS_Edges_Random_start66,TSPB,47081,20101,26980,58,100,200
SteepestLS_Edges_Random_start67,TSPB,49101,20819,28282,58,100,200
SteepestLS_Edges_Random_start68,TSPB,48143,21201,26942,59,100,200
SteepestLS_Edges_Random_start69,TSPB,52759,21878,30881,51,100,200
SteepestLS_Edges_Random_start70,TSPB,48009,21838,26171,57,100,200
SteepestLS_Edges_Random_start71,TSPB,47236,21322,25914,58,100,200
SteepestLS_Edges_Random_start72,TSPB,48985,21079,27906,57,100,200
SteepestLS_Edges_Random_start73,TSPB,48735,22893,25842,55,100,200
SteepestLS_Edges_Random_start74,TSPB,47030,19714,27316,57,100,200
SteepestLS_Edges_Random_start75,TSPB,49536,21127,28409,56,100,200
SteepestLS_Edges_Random_start76,TSPB,47519,20711,26808,57,100,200
SteepestLS_Edges_Random_start77,TSPB,47849,20758,27091,57,100,200
SteepestLS_Edges_Random_start78,TSPB,48835,20967,27868,55,100,200
SteepestLS_Edges_Random_start79,TSPB,48355,21475,26880,54,100,200
SteepestLS_Edges_Random_start80,TSPB,47228,21026,26202,55,100,200
SteepestLS_Edges_Random_start81,TSPB,48771,21401,27370,59,100,200
SteepestLS_Edges_Random_start82,TSPB,49344,21802,27542,53,100,200
SteepestLS_Edges_Random_start83,TSPB,49601,23938,25663,53,100,200
SteepestLS_Edges_Random_start84,TSPB,48966,21836,27130,53,100,200
SteepestLS_Edges_Random_start85,TSPB,48198,21306,26892,57,100,200
SteepestLS_Edges_Random_start86,TSPB,48102,20591,27511,54,100,200
SteepestLS_Edges_Random_start87,TSPB,46732,21084,25648,59,100,200
SteepestLS_Edges_Random_start88,TSPB,47500,19477,28023,56,100,200
SteepestLS_Edges_Random_start89,TSPB,46498,19568,26930,53,100,200
SteepestLS_Edges_Random_start90,TSPB,47786,21162,26624,61,100,200
SteepestLS_Edges_Random_start91,TSPB,46841,21811,25030,54,100,200
SteepestLS_Edges_Random_start92,TSPB,50957,22317,28640,57,100,200
SteepestLS_Edges_Random_start93,TSPB,48405,21953,26452,58,100,200
SteepestLS_Edges_Random_start94,TSPB,48606,21426,27180,57,100,200
SteepestLS_Edges_Random_start95,TSPB,46801,20734,26067,53,100,200
SteepestLS_Edges_Random_start96,TSPB,49968,21982,27986,55,100,200
SteepestLS_Edges_Random_start97,TSPB,47970,22418,25552,57,100,200
SteepestLS_Edges_Random_start98,TSPB,46693,20984,25709,57,100,200
SteepestLS_Edges_Random_start99,TSPB,47237,20586,26651,58,100,200
SteepestLS_Edges_Random_start100,TSPB,47770,21070,26700,55,100,200
SteepestLS_Edges_Random_start101,TSPB,48751,21291,27460,57,100,200
SteepestLS_Edges_Random_start102,TSPB,48134,22116,26018,58,100,200
SteepestLS_Edges_Random_start103,TSPB,48109,21674,26435,55,100,200
SteepestLS_Edges_Random_start104,TSPB,48059,19285,28774,51,100,200
SteepestLS_Edges_Random_start105,TSPB,47884,20411,27473,60,100,200
SteepestLS_Edges_Random_start106,TSPB,46876,20185,26691,56,100,200
SteepestLS_Edges_Random_start107,TSPB,49358,20311,29047,57,100,200
SteepestLS_Edges_Random_start108,TSPB,48421,20883,27538,57,100,200
SteepestLS_Edges_Random_start109,TSPB,48162,22172,25990,59,100,200
SteepestLS_Edges_Random_start110,TSPB,50018,21151,28867,53,100,200
SteepestLS_Edges_Random_start111,TSPB,49901,22440,27461,58,100,200
SteepestLS_Edges_Random_start112,TSPB,49130,22955,26175,55,100,200
SteepestLS_Edges_Random_start113,TSPB,48813,21970,26843,55,100,200
SteepestLS_Edges_Random_start114,TSPB,49037,22189,26848,53,100,200
SteepestLS_Edges_Random_start115,TSPB,48563,20970,27593,60,100,200
SteepestLS_Edges_Random_start116,TSPB,47913,21356,26557,57,100,200
SteepestLS_Edges_Random_start117,TSPB,47668,19598,28070,54,100,200
SteepestLS_Edges_Random_start118,TSPB,47495,22320,25175,56,100,200
SteepestLS_Edges_Random_start119,TSPB,46664,20223,26441,54,100,200
SteepestLS_Edges_Random_start120,TSPB,48273,22758,25515,58,100,200
SteepestLS_Edges_Random_start121,TSPB,47765,21354,26411,55,100,200
SteepestLS_Edges_Random_start122,TSPB,47425,21037,26388,56,100,200
SteepestLS_Edges_Random_start123,TSPB,48145,20780,27365,54,100,200
SteepestLS_Edges_Random_start124,TSPB,48474,21879,26595,57,100,200
SteepestLS_Edges_Random_start125,TSPB,46705,19951,26754,53,100,200
SteepestLS_Edges_Random_start126,TSPB,47380,21028,26352,60,100,200
SteepestLS_Edges_Random_start127,TSPB,49195,20988,28207,56,100,200
SteepestLS_Edges_Random_start128,TSPB,50265,21500,28765,58,100,200
SteepestLS_Edges_Random_start129,TSPB,47943,19936,28007,59,100,200
SteepestLS_Edges_Random_start130,TSPB,49247,20453,28794,56,100,200
SteepestLS_Edges_Random_start131,TSPB,47064,21458,25606,57,100,200
SteepestLS_Edges_Random_start132,TSPB,51354,21530,29824,54,100,200
SteepestLS_Edges_Random_start133,TSPB,46608,19192,27416,61,100,200
SteepestLS_Edges_Random_start134,TSPB,48818,21576,27242,50,100,200
SteepestLS_Edges_Random_start135,TSPB,48840,21373,27467,59,100,200
SteepestLS_Edges_Random_start136,TSPB,49789,19936,29853,57,100,200
SteepestLS_Edges_Random_start137,TSPB,49226,20586,28640,59,100,200
SteepestLS_Edges_Random_start138,TSPB,47622,21316,26306,53,100,200
SteepestLS_Edges_Random_start139,TSPB,48653,21019,27634,58,100,200
SteepestLS_Edges_Random_start140,TSPB,49411,21242,28169,53,100,200
SteepestLS_Edges_Random_start141,TSPB,47632,21299,26333,63,100,200
SteepestLS_Edges_Random_start142,TSPB,47251,20521,26730,57,100,200
SteepestLS_Edges_Random_start143,TSPB,52056,21585,30471,54,100,200
SteepestLS_Edges_Random_start144,TSPB,46756,20037,26719,60,100,200
SteepestLS_Edges_Random_start145,TSPB,48695,21446,27249,54,100,200
SteepestLS_Edges_Random_start146,TSPB,48261,19325,28936,58,100,200
SteepestLS_Edges_Random_start147,TSPB,47595,20796,26799,54,100,200
SteepestLS_Edges_Random_start148,TSPB,46803,20302,26501,59,100,200
SteepestLS_Edges_Random_start149,TSPB,49056,23154,25902,54,100,200
SteepestLS_Edges_Random_start150,TSPB,48224,20368,27856,59,100,200
SteepestLS_Edges_Random_start151,TSPB,46841,20808,26033,59,100,200
SteepestLS_Edges_Random_start152,TSPB,48997,21692,27305,59,100,200
SteepestLS_Edges_Random_start153,TSPB,47235,20314,26921,58,100,200
SteepestLS_Edges_Random_start154,TSPB,48841,20154,28687,55,100,200
SteepestLS_Edges_Random_start155,TSPB,48188,21114,27074,55,100,200
SteepestLS_Edges_Random_start156,TSPB,49670,20913,28757,58,100,200
SteepestLS_Edges_Random_start157,TSPB,48235,21348,26887,59,100,200
SteepestLS_Edges_Random_start158,TSPB,49312,20588,28724,57,100,200
SteepestLS_Edges_Random_start159,TSPB,47637,20563,27074,58,100,200
SteepestLS_Edges_Random_start160,TSPB,48469,21549,26920,56,100,200
SteepestLS_Edges_Random_start161,TSPB,47640,20585,27055,59,100,200
SteepestLS_Edges_Random_start162,TSPB,47538,20442,27096,57,100,200
SteepestLS_Edges_Random_start163,TSPB,46334,19500,26834,59,100,200
SteepestLS_Edges_Random_start164,TSPB,47942,21654,26288,55,100,200
SteepestLS_Edges_Random_start165,TSPB,48335,21291,27044,51,100,200
SteepestLS_Edges_Random_start166,TSPB,46944,20416,26528,57,100,200
SteepestLS_Edges_Random_start167,TSPB,47765,20580,27185,55,100,200
SteepestLS_Edges_Random_start168,TSPB,50125,22893,27232,58,100,200
SteepestLS_Edges_Random_start169,TSPB,49185,20727,28458,57,100,200
SteepestLS_Edges_Random_start170,TSPB,48550,22325,26225,59,100,200
SteepestLS_Edges_Random_start171,TSPB,48580,22300,26280,54,100,200
SteepestLS_Edges_Random_start172,TSPB,47379,21210,26169,59,100,200
SteepestLS_Edges_Random_start173,TSPB,48893,23182,25711,58,100,200
SteepestLS_Edges_Random_start174,TSPB,48596,22114,26482,57,100,200
SteepestLS_Edges_Random_start175,TSPB,48575,21499,27076,57,100,200
SteepestLS_Edges_Random_start176,TSPB,47853,22015,25838,57,100,200
SteepestLS_Edges_Random_start177,TSPB,48399,22996,25403,57,100,200
SteepestLS_Edges_Random_start178,TSPB,47019,20756,26263,54,100,200
SteepestLS_Edges_Random_start179,TSPB,47745,20418,27327,57,100,200
SteepestLS_Edges_Random_start180,TSPB,48769,21038,27731,56,100,200
SteepestLS_Edges_Random_start181,TSPB,48411,22296,26115,56,100,200
SteepestLS_Edges_Random_start182,TSPB,47635,22040,25595,54,100,200
SteepestLS_Edges_Random_start183,TSPB,46660,20261,26399,60,100,200
SteepestLS_Edges_Random_start184,TSPB,49863,20735,29128,56,100,200
SteepestLS_Edges_Random_start185,TSPB,48099,20592,27507,65,100,200
SteepestLS_Edges_Random_start186,TSPB,47463,19052,28411,64,100,200
SteepestLS_Edges_Random_start187,TSPB,49081,20400,28681,54,100,200
SteepestLS_Edges_Random_start188,TSPB,47849,21206,26643,61,100,200
SteepestLS_Edges_Random_start189,TSPB,50115,22971,27144,56,100,200
SteepestLS_Edges_Random_start190,TSPB,47988,21231,26757,58,100,200
SteepestLS_Edges_Random_start191,TSPB,48698,21373,27325,54,100,200
SteepestLS_Edges_Random_start192,TSPB,49630,21065,28565,60,100,200
SteepestLS_Edges_Random_start193,TSPB,49110,21716,27394,61,100,200
SteepestLS_Edges_Random_start194,TSPB,47965,20011,27954,56,100,200
SteepestLS_Edges_Random_start195,TSPB,48582,21858,26724,56,100,200
SteepestLS_Edges_Random_start196,TSPB,49029,21535,27494,61,100,200
SteepestLS_Edges_Random_start197,TSPB,49897,22546,27351,55,100,200
SteepestLS_Edges_Random_start198,TSPB,48878,21722,27156,52,100,200
SteepestLS_Edges_Random_start199,TSPB,49075,22754,26321,60,100,200
SteepestLS_Edges_NearestNeighborAny2Regret_w1_1_start0,TSPB,45768,19226,26542,6,100,200
SteepestLS_Edges_NearestNeighborAny2Regret_w1_1_start1,TSPB,44420,20009,24411,6,100,200
SteepestLS_Edges_NearestNeighborAny2Regret_w1_1_start2,TSPB,45711,19607,26104,8,100,200
SteepestLS_Edges_NearestNeighborAny2Regret_w1_1_start3,TSPB,46979,19401,27578,10,100,200
SteepestLS_Edges_NearestNeighborAny2Regret_w1_1_start4,TSPB,46085,20083,26002,11,100,200
SteepestLS_Edges_NearestNeighborAny2Regret_w1_1_start5,TSPB,45877,18603,27274,7,100,200
SteepestLS_Edges_NearestNeighborAny2Regret_w1_1_start6,TSPB,44973,19760,25213,7,100,200
SteepestLS_Edges_NearestNeighborAny2Regret_w1_1_start7,TSPB,49466,19499,29967,8,100,200
SteepestLS_Edges_NearestNeighborAny2Regret_w1_1_start8,TSPB,45768,19226,26542,6,100,200
SteepestLS_Edges_NearestNeighborAny2Regret_w1_1_start9,TSPB,46095,21022,25073,7,100,200
SteepestLS_Edges_NearestNeighborAny2Regret_w1_1_start10,TSPB,45135,20389,24746,7,100,200
SteepestLS_Edges_NearestNeighborAny2Regret_w1_1_start11,TSPB,49458,19543,29915,9,100,200
SteepestLS_Edges_NearestNeighborAny2Regret_w1_1_start12,TSPB,46090,19264,26826,5,100,200
SteepestLS_Edges_NearestNeighborAny2Regret_w1_1_start13,TSPB,47317,19671,27646,9,100,200
SteepestLS_Edges_NearestNeighborAny2Regret_w1_1_start14,TSPB,47461,19466,27995,7,100,200
SteepestLS_Edges_NearestNeighborAny2Regret_w1_1_start15,TSPB,46979,19401,27578,9,100,200
SteepestLS_Edges_NearestNeighborAny2Regret_w1_1_start16,TSPB,44420,20009,24411,6,100,200
SteepestLS_Edges_NearestNeighborAny2Regret_w1_1_start17,TSPB,44320,20087,24233,12,100,200
SteepestLS_Edges_NearestNeighborAny2Regret_w1_1_start18,TSPB,46085,20083,26002,11,100,200
SteepestLS_Edges_NearestNeighborAny2Regret_w1_1_start19,TSPB,44320,20087,24233,10,100,200
SteepestLS_Edges_NearestNeighborAny2Regret_w1_1_start20,TSPB,47717,19551,28166,6,100,200
SteepestLS_Edges_NearestNeighborAny2Regret_w1_1_start21,TSPB,45014,19260,25754,11,100,200
SteepestLS_Edges_NearestNeighborAny2Regret_w1_1_start22,TSPB,47717,19551,28166,7,100,200
SteepestLS_Edges_NearestNeighborAny2Regret_w1_1_start23,TSPB,46287,20113,26174,12,100,200
SteepestLS_Edges_NearestNeighborAny2Regret_w1_1_start24,TSPB,44641,20135,24506,9,100,200
SteepestLS_Edges_NearestNeighborAny2Regret_w1_1_start25,TSPB,47717,19551,28166,7,100,200
SteepestLS_Edges_NearestNeighborAny2Regret_w1_1_start26,TSPB,44628,20257,24371,7,100,200
SteepestLS_Edges_NearestNeighborAny2Regret_w1_1_start27,TSPB,44973,19760,25213,7,100,200
SteepestLS_Edges_NearestNeighborAny2Regret_w1_1_start28,TSPB,46085,20083,26002,11,100,200
SteepestLS_Edges_NearestNeighborAny2Regret_w1_1_start29,TSPB,45768,19226,26542,6,100,200
SteepestLS_Edges_NearestNeighborAny2Regret_w1_1_start30,TSPB,44641,20135,24506,9,100,200
SteepestLS_Edges_NearestNeighborAny2Regret_w1_1_start31,TSPB,45364,19875,25489,8,100,200
SteepestLS_Edges_NearestNeighborAny2Regret_w1_1_start32,TSPB,47717,19551,28166,6,100,200
SteepestLS_Edges_NearestNeighborAny2Regret_w1_1_start33,TSPB,45768,19226,26542,6,100,200
SteepestLS_Edges_NearestNeighborAny2Regret_w1_1_start34,TSPB,45183,19820,25363,10,100,200
SteepestLS_Edges_NearestNeighborAny2Regret_w1_1_start35,TSPB,45768,19226,26542,5,100,200
SteepestLS_Edges_NearestNeighborAny2Regret_w1_1_start36,TSPB,47717,19551,28166,9,100,200
SteepestLS_Edges_NearestNeighborAny2Regret_w1_1_start37,TSPB,45224,20834,24390,10,100,200
SteepestLS_Edges_NearestNeighborAny2Regret_w1_1_start38,TSPB,44999,19800,25199,10,100,200
SteepestLS_Edges_NearestNeighborAny2Regret_w1_1_start39,TSPB,49904,20055,29849,9,100,200
SteepestLS_Edges_NearestNeighborAny2Regret_w1_1_start40,TSPB,47717,19551,28166,6,100,200
SteepestLS_Edges_NearestNeighborAny2Regret_w1_1_start41,TSPB,47553,19651,27902,7,100,200
SteepestLS_Edges_NearestNeighborAny2Regret_w1_1_start42,TSPB,44420,20009,24411,7,100,200
SteepestLS_Edges_NearestNeighborAny2Regret_w1_1_start43,TSPB,46979,19401,27578,9,100,200
SteepestLS_Edges_NearestNeighborAny2Regret_w1_1_start44,TSPB,46995,19485,27510,9,100,200
SteepestLS_Edges_NearestNeighborAny2Regret_w1_1_start45,TSPB,45877,18603,27274,6,100,200
SteepestLS_Edges_NearestNeighborAny2Regret_w1_1_start46,TSPB,46014,19289,26725,6,100,200
SteepestLS_Edges_NearestNeighborAny2Regret_w1_1_start47,TSPB,47717,19551,28166,7,100,200
SteepestLS_Edges_NearestNeighborAny2Regret_w1_1_start48,TSPB,49367,20268,29099,11,100,200
SteepestLS_Edges_NearestNeighborAny2Regret_w1_1_start49,TSPB,45846,18993,26853,6,100,200
SteepestLS_Edges_NearestNeighborAny2Regret_w1_1_start50,TSPB,47461,19466,27995,7,100,200
SteepestLS_Edges_NearestNeighborAny2Regret_w1_1_start51,TSPB,45364,19875,25489,8,100,200
SteepestLS_Edges_NearestNeighborAny2Regret_w1_1_start52,TSPB,48376,19494,28882,6,100,200
SteepestLS_Edges_NearestNeighborAny2Regret_w1_1_start53,TSPB,45833,20462,25371,9,100,200
SteepestLS_Edges_NearestNeighborAny2Regret_w1_1_start54,TSPB,45364,19875,25489,7,100,200
SteepestLS_Edges_NearestNeighborAny2Regret_w1_1_start55,TSPB,46085,20083,26002,12,100,200
SteepestLS_Edges_NearestNeighborAny2Regret_w1_1_start56,TSPB,46030,18358,27672,9,100,200
SteepestLS_Edges_NearestNeighborAny2Regret_w1_1_start57,TSPB,47717,19551,28166,6,100,200
SteepestLS_Edges_NearestNeighborAny2Regret_w1_1_start58,TSPB,46918,19372,27546,11,100,200
SteepestLS_Edges_NearestNeighborAny2Regret_w1_1_start59,TSPB,46085,20083,26002,11,100,200
SteepestLS_Edges_NearestNeighborAny2Regret_w1_1_start60,TSPB,46085,20083,26002,11,100,200
SteepestLS_Edges_NearestNeighborAny2Regret_w1_1_start61,TSPB,47717,19551,28166,6,100,200
SteepestLS_Edges_NearestNeighborAny2Regret_w1_1_start62,TSPB,46085,20083,26002,12,100,200
SteepestLS_Edges_NearestNeighborAny2Regret_w1_1_start63,TSPB,47717,19551,28166,6,100,200
SteepestLS_Edges_NearestNeighborAny2Regret_w1_1_start64,TSPB,45163,19821,25342,10,100,200
SteepestLS_Edges_NearestNeighborAny2Regret_w1_1_start65,TSPB,47427,19440,27987,9,100,200
SteepestLS_Edges_NearestNeighborAny2Regret_w1_1_start66,TSPB,47717,19551,28166,7,100,200
SteepestLS_Edges_NearestNeighborAny2Regret_w1_1_start67,TSPB,45356,20435,24921,7,100,200
SteepestLS_Edges_NearestNeighborAny2Regret_w1_1_start68,TSPB,50208,18989,31219,8,100,200
SteepestLS_Edges_NearestNeighborAny2Regret_w1_1_start69,TSPB,46028,19929,26099,6,100,200
SteepestLS_Edges_NearestNeighborAny2Regret_w1_1_start70,TSPB,46979,19401,27578,9,100,200
SteepestLS_Edges_NearestNeighborAny2Regret_w1_1_start71,TSPB,45695,18756,26939,8,100,200
SteepestLS_Edges_NearestNeighborAny2Regret_w1_1_start72,TSPB,44543,19882,24661,7,100,200
SteepestLS_Edges_NearestNeighborAny2Regret_w1_1_start73,TSPB,44781,19427,25354,6,100,200
SteepestLS_Edges_NearestNeighborAny2Regret_w1_1_start74,TSPB,46124,20900,25224,12,100,200
SteepestLS_Edges_NearestNeighborAny2Regret_w1_1_start75,TSPB,44778,20347,24431,11,100,200
SteepestLS_Edges_NearestNeighborAny2Regret_w1_1_start76,TSPB,49766,18958,30808,8,100,200
SteepestLS_Edges_NearestNeighborAny2Regret_w1_1_start77,TSPB,44420,20009,24411,6,100,200
SteepestLS_Edges_NearestNeighborAny2Regret_w1_1_start78,TSPB,45877,18603,27274,7,100,200
SteepestLS_Edges_NearestNeighborAny2Regret_w1_1_start79,TSPB,47666,19636,28030,8,100,200
SteepestLS_Edges_NearestNeighborAny2Regret_w1_1_start80,TSPB,45364,19875,25489,8,100,200
SteepestLS_Edges_NearestNeighborAny2Regret_w1_1_start81,TSPB,46085,20083,26002,11,100,200
SteepestLS_Edges_NearestNeighborAny2Regret_w1_1_start82,TSPB,45370,19203,26167,9,100,200
SteepestLS_Edges_NearestNeighborAny2Regret_w1_1_start83,TSPB,46254,20134,26120,13,100,200
SteepestLS_Edges_NearestNeighborAny2Regret_w1_1_start84,TSPB,45240,20031,25209,9,100,200
SteepestLS_Edges_NearestNeighborAny2Regret_w1_1_start85,TSPB,45633,19769,25864,6,100,200
SteepestLS_Edges_NearestNeighborAny2Regret_w1_1_start86,TSPB,47717,19551,28166,6,100,200
SteepestLS_Edges_NearestNeighborAny2Regret_w1_1_start87,TSPB,45128,19545,25583,10,100,200
SteepestLS_Edges_NearestNeighborAny2Regret_w1_1_start88,TSPB,47520,19639,27881,9,100,200
SteepestLS_Edges_NearestNeighborAny2Regret_w1_1_start89,TSPB,47717,19551,28166,7,100,200
SteepestLS_Edges_NearestNeighborAny2Regret_w1_1_start90,TSPB,44320,20087,24233,9,100,200
SteepestLS_Edges_NearestNeighborAny2Regret_w1_1_start91,TSPB,47717,19551,28166,7,100,200
SteepestLS_Edges_NearestNeighborAny2Regret_w1_1_start92,TSPB,47717,19551,28166,9,100,200
SteepestLS_Edges_NearestNeighborAny2Regret_w1_1_start93,TSPB,51431,20929,30502,8,100,200
SteepestLS_Edges_NearestNeighborAny2Regret_w1_1_start94,TSPB,47717,19551,28166,7,100,200
SteepestLS_Edges_NearestNeighborAny2Regret_w1_1_start95,TSPB,48756,20092,28664,9,100,200
SteepestLS_Edges_NearestNeighborAny2Regret_w1_1_start96,TSPB,47717,19551,28166,7,100,200
SteepestLS_Edges_NearestNeighborAny2Regret_w1_1_start97,TSPB,44687,20093,24594,6,100,200
SteepestLS_Edges_NearestNeighborAny2Regret_w1_1_start98,TSPB,45163,20005,25158,9,100,200
SteepestLS_Edges_NearestNeighborAny2Regret_w1_1_start99,TSPB,47717,19551,28166,7,100,200
SteepestLS_Edges_NearestNeighborAny2Regret_w1_1_start100,TSPB,47717,19551,28166,6,100,200
SteepestLS_Edges_NearestNeighborAny2Regret_w1_1_start101,TSPB,46358,20073,26285,13,100,200
SteepestLS_Edges_NearestNeighborAny2Regret_w1_1_start102,TSPB,47717,19551,28166,7,100,200
SteepestLS_Edges_NearestNeighborAny2Regret_w1_1_start103,TSPB,44420,20009,24411,7,100,200
SteepestLS_Edges_NearestNeighborAny2Regret_w1_1_start104,TSPB,45768,19226,26542,5,100,200
SteepestLS_Edges_NearestNeighborAny2Regret_w1_1_start105,TSPB,45020,19371,25649,9,100,200
SteepestLS_Edges_NearestNeighborAny2Regret_w1_1_start106,TSPB,46085,20083,26002,11,100,200
SteepestLS_Edges_NearestNeighborAny2Regret_w1_1_start107,TSPB,47717,19551,28166,7,100,200
SteepestLS_Edges_NearestNeighborAny2Regret_w1_1_start108,TSPB,46420,20462,25958,8,100,200
SteepestLS_Edges_NearestNeighborAny2Regret_w1_1_start109,TSPB,45768,19226,26542,6,100,200
SteepestLS_Edges_NearestNeighborAny2Regret_w1_1_start110,TSPB,45446,19459,25987,7,100,200
SteepestLS_Edges_NearestNeighborAny2Regret_w1_1_start111,TSPB,48644,18818,29826,8,100,200
SteepestLS_Edges_NearestNeighborAny2Regret_w1_1_start112,TSPB,44768,20108,24660,9,100,200
SteepestLS_Edges_NearestNeighborAny2Regret_w1_1_start113,TSPB,47717,19551,28166,7,100,200
SteepestLS_Edges_NearestNeighborAny2Regret_w1_1_start114,TSPB,45134,19696,25438,7,100,200
SteepestLS_Edges_NearestNeighborAny2Regret_w1_1_start115,TSPB,44485,19913,24572,8,100,200
SteepestLS_Edges_NearestNeighborAny2Regret_w1_1_start116,TSPB,45056,20155,24901,6,100,200
SteepestLS_Edges_NearestNeighborAny2Regret_w1_1_start117,TSPB,45364,19875,25489,7,100,200
SteepestLS_Edges_NearestNeighborAny2Regret_w1_1_start118,TSPB,45685,19884,25801,5,100,200
SteepestLS_Edges_NearestNeighborAny2Regret_w1_1_start119,TSPB,45650,20113,25537,10,100,200
SteepestLS_Edges_NearestNeighborAny2Regret_w1_1_start120,TSPB,45356,20435,24921,7,100,200
SteepestLS_Edges_NearestNeighborAny2Regret_w1_1_start121,TSPB,44320,20087,24233,10,100,200
SteepestLS_Edges_NearestNeighborAny2Regret_w1_1_start122,TSPB,47717,19551,28166,6,100,200
SteepestLS_Edges_NearestNeighborAny2Regret_w1_1_start123,TSPB,47805,19645,28160,9,100,200
SteepestLS_Edges_NearestNeighborAny2Regret_w1_1_start124,TSPB,46085,20083,26002,11,100,200
SteepestLS_Edges_NearestNeighborAny2Regret_w1_1_start125,TSPB,47717,19551,28166,7,100,200
SteepestLS_Edges_NearestNeighborAny2Regret_w1_1_start126,TSPB,47235,19424,27811,8,100,200
SteepestLS_Edges_NearestNeighborAny2Regret_w1_1_start127,TSPB,47717,19551,28166,7,100,200
SteepestLS_Edges_NearestNeighborAny2Regret_w1_1_start128,TSPB,45265,19638,25627,8,100,200
SteepestLS_Edges_NearestNeighborAny2Regret_w1_1_start129,TSPB,44420,20009,24411,7,100,200
SteepestLS_Edges_NearestNeighborAny2Regret_w1_1_start130,TSPB,45540,19838,25702,12,100,200
SteepestLS_Edges_NearestNeighborAny2Regret_w1_1_start131,TSPB,47717,19551,28166,6,100,200
SteepestLS_Edges_NearestNeighborAny2Regret_w1_1_start132,TSPB,47317,19671,27646,9,100,200
SteepestLS_Edges_NearestNeighborAny2Regret_w1_1_start133,TSPB,46963,19204,27759,11,100,200
SteepestLS_Edges_NearestNeighborAny2Regret_w1_1_start134,TSPB,45506,20017,25489,8,100,200
SteepestLS_Edges_NearestNeighborAny2Regret_w1_1_start135,TSPB,47717,19551,28166,6,100,200
SteepestLS_Edges_NearestNeighborAny2Regret_w1_1_start136,TSPB,45345,19807,25538,8,100,200
SteepestLS_Edges_NearestNeighborAny2Regret_w1_1_start137,TSPB,50620,21329,29291,15,100,200
SteepestLS_Edges_NearestNeighborAny2Regret_w1_1_start138,TSPB,49574,19878,29696,9,100,200
SteepestLS_Edges_NearestNeighborAny2Regret_w1_1_start139,TSPB,49186,19551,29635,6,100,200
SteepestLS_Edges_NearestNeighborAny2Regret_w1_1_start140,TSPB,46085,20083,26002,12,100,200
SteepestLS_Edges_NearestNeighborAny2Regret_w1_1_start141,TSPB,44420,20009,24411,6,100,200
SteepestLS_Edges_NearestNeighborAny2Regret_w1_1_start142,TSPB,45877,18603,27274,7,100,200
SteepestLS_Edges_NearestNeighborAny2Regret_w1_1_start143,TSPB,47674,18993,28681,7,100,200
SteepestLS_Edges_NearestNeighborAny2Regret_w1_1_start144,TSPB,45795,19037,26758,6,100,200
SteepestLS_Edges_NearestNeighborAny2Regret_w1_1_start145,TSPB,46979,19401,27578,10,100,200
SteepestLS_Edges_NearestNeighborAny2Regret_w1_1_start146,TSPB,46867,20034,26833,6,100,200
SteepestLS_Edges_NearestNeighborAny2Regret_w1_1_start147,TSPB,45364,19875,25489,8,100,200
SteepestLS_Edges_NearestNeighborAny2Regret_w1_1_start148,TSPB,47717,19551,28166,7,100,200
SteepestLS_Edges_NearestNeighborAny2Regret_w1_1_start149,TSPB,46085,20083,26002,11,100,200
SteepestLS_Edges_NearestNeighborAny2Regret_w1_1_start150,TSPB,45583,20181,25402,9,100,200
SteepestLS_Edges_NearestNeighborAny2Regret_w1_1_start151,TSPB,44320,20087,24233,12,100,200
SteepestLS_Edges_NearestNeighborAny2Regret_w1_1_start152,TSPB,45506,20017,25489,8,100,200
SteepestLS_Edges_NearestNeighborAny2Regret_w1_1_start153,TSPB,44420,20009,24411,6,100,200
SteepestLS_Edges_NearestNeighborAny2Regret_w1_1_start154,TSPB,45570,19805,25765,9,100,200
SteepestLS_Edges_NearestNeighborAny2Regret_w1_1_start155,TSPB,45364,19875,25489,7,100,200
SteepestLS_Edges_NearestNeighborAny2Regret_w1_1_start156,TSPB,44439,20314,24125,10,100,200
SteepestLS_Edges_NearestNeighborAny2Regret_w1_1_start157,TSPB,45887,19334,26553,7,100,200
SteepestLS_Edges_NearestNeighborAny2Regret_w1_1_start158,TSPB,47717,19551,28166,7,100,200
SteepestLS_Edges_NearestNeighborAny2Regret_w1_1_start159,TSPB,46494,18981,27513,6,100,200
SteepestLS_Edges_NearestNeighborAny2Regret_w1_1_start160,TSPB,49574,19878,29696,9,100,200
SteepestLS_Edges_NearestNeighborAny2Regret_w1_1_start161,TSPB,45472,19702,25770,7,100,200
SteepestLS_Edges_NearestNeighborAny2Regret_w1_1_start162,TSPB,45877,18603,27274,7,100,200
SteepestLS_Edges_NearestNeighborAny2Regret_w1_1_start163,TSPB,44420,20009,24411,6,100,200
SteepestLS_Edges_NearestNeighborAny2Regret_w1_1_start164,TSPB,45295,19778,25517,8,100,200
SteepestLS_Edges_NearestNeighborAny2Regret_w1_1_start165,TSPB,44571,20072,24499,7,100,200
SteepestLS_Edges_NearestNeighborAny2Regret_w1_1_start166,TSPB,47717,19551,28166,7,100,200
SteepestLS_Edges_NearestNeighborAny2Regret_w1_1_start167,TSPB,45281,19420,25861,11,100,200
SteepestLS_Edges_NearestNeighborAny2Regret_w1_1_start168,TSPB,47317,19671,27646,9,100,200
SteepestLS_Edges_NearestNeighborAny2Regret_w1_1_start169,TSPB,47317,19671,27646,9,100,200
SteepestLS_Edges_NearestNeighborAny2Regret_w1_1_start170,TSPB,45525,19686,25839,7,100,200
SteepestLS_Edges_NearestNeighborAny2Regret_w1_1_start171,TSPB,46739,19269,27470,8,100,200
SteepestLS_Edges_NearestNeighborAny2Regret_w1_1_start172,TSPB,44420,20009,24411,9,100,200
SteepestLS_Edges_NearestNeighborAny2Regret_w1_1_start173,TSPB,44691,20011,24680,6,100,200
SteepestLS_Edges_NearestNeighborAny2Regret_w1_1_start174,TSPB,46214,20069,26145,13,100,200
SteepestLS_Edges_NearestNeighborAny2Regret_w1_1_start175,TSPB,45877,18603,27274,7,100,200
SteepestLS_Edges_NearestNeighborAny2Regret_w1_1_start176,TSPB,47717,19551,28166,7,100,200
SteepestLS_Edges_NearestNeighborAny2Regret_w1_1_start177,TSPB,45877,18603,27274,6,100,200
SteepestLS_Edges_NearestNeighborAny2Regret_w1_1_start178,TSPB,44592,19918,24674,8,100,200
SteepestLS_Edges_NearestNeighborAny2Regret_w1_1_start179,TSPB,44420,20009,24411,6,100,200
SteepestLS_Edges_NearestNeighborAny2Regret_w1_1_start180,TSPB,47520,19639,27881,9,100,200
SteepestLS_Edges_NearestNeighborAny2Regret_w1_1_start181,TSPB,48442,19533,28909,8,100,200
SteepestLS_Edges_NearestNeighborAny2Regret_w1_1_start182,TSPB,49458,19543,29915,9,100,200
SteepestLS_Edges_NearestNeighborAny2Regret_w1_1_start183,TSPB,46085,20083,26002,11,100,200
SteepestLS_Edges_NearestNeighborAny2Regret_w1_1_start184,TSPB,45936,20967,24969,8,100,200
SteepestLS_Edges_NearestNeighborAny2Regret_w1_1_start185,TSPB,47717,19551,28166,7,100,200
SteepestLS_Edges_NearestNeighborAny2Regret_w1_1_start186,TSPB,44420,20009,24411,7,100,200
SteepestLS_Edges_NearestNeighborAny2Regret_w1_1_start187,TSPB,46330,19913,26417,6,100,200
SteepestLS_Edges_NearestNeighborAny2Regret_w1_1_start188,TSPB,47317,19671,27646,9,100,200
SteepestLS_Edges_NearestNeighborAny2Regret_w1_1_start189,TSPB,45875,19843,26032,9,100,200
SteepestLS_Edges_NearestNeighborAny2Regret_w1_1_start190,TSPB,45364,19875,25489,7,100,200
SteepestLS_Edges_NearestNeighborAny2Regret_w1_1_start191,TSPB,45695,18756,26939,11,100,200
SteepestLS_Edges_NearestNeighborAny2Regret_w1_1_start192,TSPB,45583,20181,25402,8,100,200
SteepestLS_Edges_NearestNeighborAny2Regret_w1_1_start193,TSPB,44781,19427,25354,6,100,200
SteepestLS_Edges_NearestNeighborAny2Regret_w1_1_start194,TSPB,47717,19551,28166,8,100,200
SteepestLS_Edges_NearestNeighborAny2Regret_w1_1_start195,TSPB,47317,19671,27646,9,100,200
SteepestLS_Edges_NearestNeighborAny2Regret_w1_1_start196,TSPB,45661,19536,26125,8,100,200
SteepestLS_Edges_NearestNeighborAny2Regret_w1_1_start197,TSPB,44827,19998,24829,6,100,200
SteepestLS_Edges_NearestNeighborAny2Regret_w1_1_start198,TSPB,44781,19427,25354,7,100,200
SteepestLS_Edges_NearestNeighborAny2Regret_w1_1_start199,TSPB,46066,20353,25713,12,100,200
GreedyLS_Nodes_Random_start0,TSPB,62973,36242,26731,187,100,200
GreedyLS_Nodes_Random_start1,TSPB,59028,31600,27428,209,100,200
GreedyLS_Nodes_Random_start2,TSPB,62799,37068,25731,212,100,200
GreedyLS_Nodes_Random_start3,TSPB,59277,32512,26765,216,100,200
GreedyLS_Nodes_Random_start4,TSPB,55926,28210,27716,223,100,200
GreedyLS_Nodes_Random_start5,TSPB,59287,32832,26455,214,100,200
GreedyLS_Nodes_Random_start6,TSPB,58936,32801,26135,228,100,200
GreedyLS_Nodes_Random_start7,TSPB,59359,31529,27830,216,100,200
GreedyLS_Nodes_Random_start8,TSPB,58598,32530,26068,217,100,200
GreedyLS_Nodes_Random_start9,TSPB,63750,38962,24788,209,100,200
GreedyLS_Nodes_Random_start10,TSPB,55588,29279,26309,212,100,200
GreedyLS_Nodes_Random_start11,TSPB,63762,36483,27279,209,100,200
GreedyLS_Nodes_Random_start12,TSPB,64322,36007,28315,219,100,200
GreedyLS_Nodes_Random_start13,TSPB,63101,36723,26378,228,100,200
GreedyLS_Nodes_Random_start14,TSPB,61913,36321,25592,232,100,200
GreedyLS_Nodes_Random_start15,TSPB,65870,36418,29452,215,100,200
GreedyLS_Nodes_Random_start16,TSPB,61230,35904,25326,205,100,200
GreedyLS_Nodes_Random_start17,TSPB,65006,36878,28128,192,100,200
GreedyLS_Nodes_Random_start18,TSPB,60687,33068,27619,196,100,200
GreedyLS_Nodes_Random_start19,TSPB,67911,37792,30119,210,100,200
GreedyLS_Nodes_Random_start20,TSPB,59170,32380,26790,238,100,200
GreedyLS_Nodes_Random_start21,TSPB,61393,33474,27919,196,100,200
GreedyLS_Nodes_Random_start22,TSPB,55371,28486,26885,238,100,200
GreedyLS_Nodes_Random_start23,TSPB,60289,35463,24826,240,100,200
GreedyLS_Nodes_Random_start24,TSPB,64835,38835,26000,238,100,200
GreedyLS_Nodes_Random_start25,TSPB,55896,28011,27885,187,100,200
GreedyLS_Nodes_Random_start26,TSPB,59587,34216,25371,211,100,200
GreedyLS_Nodes_Random_start27,TSPB,63123,37859,25264,229,100,200
GreedyLS_Nodes_Random_start28,TSPB,63412,36238,27174,205,100,200
GreedyLS_Nodes_Random_start29,TSPB,61953,34820,27133,245,100,200
GreedyLS_Nodes_Random_start30,TSPB,69566,41861,27705,227,100,200
GreedyLS_Nodes_Random_start31,TSPB,56541,30989,25552,225,100,200
GreedyLS_Nodes_Random_start32,TSPB,57472,32375,25097,220,100,200
GreedyLS_Nodes_Random_start33,TSPB,58517,32191,26326,231,100,200
GreedyLS_Nodes_Random_start34,TSPB,58684,31088,27596,217,100,200
GreedyLS_Nodes_Random_start35,TSPB,64612,38092,26520,234,100,200
GreedyLS_Nodes_Random_start36,TSPB,59475,33782,25693,220,100,200
GreedyLS_Nodes_Random_start37,TSPB,61896,36517,25379,224,100,200
GreedyLS_Nodes_Random_start38,TSPB,62694,34340,28354,197,100,200
GreedyLS_Nodes_Random_start39,TSPB,57983,31230,26753,212,100,200
GreedyLS_Nodes_Random_start40,TSPB,60917,34592,26325,203,100,200
GreedyLS_Nodes_Random_start41,TSPB,60672,34977,25695,224,100,200
GreedyLS_Nodes_Random_start42,TSPB,61590,35479,26111,222,100,200
GreedyLS_Nodes_Random_start43,TSPB,60076,35021,25055,223,100,200
GreedyLS_Nodes_Random_start44,TSPB,57407,29830,27577,237,100,200
GreedyLS_Nodes_Random_start45,TSPB,62145,34178,27967,185,100,200
GreedyLS_Nodes_Random_start46,TSPB,58257,32914,25343,220,100,200
GreedyLS_Nodes_Random_start47,TSPB,57864,31626,26238,198,100,200
GreedyLS_Nodes_Random_start48,TSPB,62137,36602,25535,220,100,200
GreedyLS_Nodes_Random_start49,TSPB,61138,35345,25793,225,100,200
GreedyLS_Nodes_Random_start50,TSPB,59964,33630,26334,224,100,200
GreedyLS_Nodes_Random_start51,TSPB,62850,37019,25831,228,100,200
GreedyLS_Nodes_Random_start52,TSPB,59411,33918,25493,228,100,200
GreedyLS_Nodes_Random_start53,TSPB,58132,30623,27509,204,100,200
GreedyLS_Nodes_Random_start54,TSPB,60055,34402,25653,209,100,200
GreedyLS_Nodes_Random_start55,TSPB,60678,35475,25203,227,100,200
GreedyLS_Nodes_Random_start56,TSPB,57583,30997,26586,221,100,200
GreedyLS_Nodes_Random_start57,TSPB,57027,32448,24579,227,100,200
GreedyLS_Nodes_Random_start58,TSPB,59128,31052,28076,184,100,200
GreedyLS_Nodes_Random_start59,TSPB,58460,33451,25009,226,100,200
GreedyLS_Nodes_Random_start60,TSPB,60847,35148,25699,204,100,200
GreedyLS_Nodes_Random_start61,TSPB,60189,33760,26429,204,100,200
GreedyLS_Nodes_Random_start62,TSPB,59888,33686,26202,205,100,200
GreedyLS_Nodes_Random_start63,TSPB,67053,40388,26665,244,100,200
GreedyLS_Nodes_Random_start64,TSPB,61108,34409,26699,175,100,200
GreedyLS_Nodes_Random_start65,TSPB,57985,32908,25077,242,100,200
GreedyLS_Nodes_Random_start66,TSPB,62284,36816,25468,207,100,200
GreedyLS_Nodes_Random_start67,TSPB,57061,29424,27637,221,100,200
GreedyLS_Nodes_Random_start68,TSPB,60068,35047,25021,197,100,200
GreedyLS_Nodes_Random_start69,TSPB,62727,35514,27213,221,100,200
GreedyLS_Nodes_Random_start70,TSPB,57697,31616,26081,230,100,200
GreedyLS_Nodes_Random_start71,TSPB,63505,36626,26879,200,100,200
GreedyLS_Nodes_Random_start72,TSPB,61671,34941,26730,213,100,200
GreedyLS_Nodes_Random_start73,TSPB,64971,35827,29144,191,100,200
GreedyLS_Nodes_Random_start74,TSPB,63979,38055,25924,203,100,200
GreedyLS_Nodes_Random_start75,TSPB,59819,33024,26795,200,100,200
GreedyLS_Nodes_Random_start76,TSPB,57577,31262,26315,218,100,200
GreedyLS_Nodes_Random_start77,TSPB,61231,34076,27155,227,100,200
GreedyLS_Nodes_Random_start78,TSPB,59834,34827,25007,213,100,200
GreedyLS_Nodes_Random_start79,TSPB,64590,39401,25189,210,100,200
GreedyLS_Nodes_Random_start80,TSPB,61446,33898,27548,214,100,200
GreedyLS_Nodes_Random_start81,TSPB,64010,37177,26833,196,100,200
GreedyLS_Nodes_Random_start82,TSPB,58862,31217,27645,204,100,200
GreedyLS_Nodes_Random_start83,TSPB,57388,32033,25355,190,100,200
GreedyLS_Nodes_Random_start84,TSPB,59124,32498,26626,181,100,200
GreedyLS_Nodes_Random_start85,TSPB,65725,38403,27322,231,100,200
GreedyLS_Nodes_Random_start86,TSPB,59211,33521,25690,210,100,200
GreedyLS_Nodes_Random_start87,TSPB,62484,34274,28210,197,100,200
GreedyLS_Nodes_Random_start88,TSPB,55810,28295,27515,240,100,200
GreedyLS_Nodes_Random_start89,TSPB,59483,33651,25832,222,100,200
GreedyLS_Nodes_Random_start90,TSPB,59704,32291,27413,253,100,200
GreedyLS_Nodes_Random_start91,TSPB,64580,37042,27538,195,100,200
GreedyLS_Nodes_Random_start92,TSPB,57596,30358,27238,217,100,200
GreedyLS_Nodes_Random_start93,TSPB,56770,30448,26322,246,100,200
GreedyLS_Nodes_Random_start94,TSPB,60470,34468,26002,201,100,200
GreedyLS_Nodes_Random_start95,TSPB,57430,32041,25389,205,100,200
GreedyLS_Nodes_Random_start96,TSPB,59177,33190,25987,219,100,200
GreedyLS_Nodes_Random_start97,TSPB,61184,33762,27422,224,100,200
GreedyLS_Nodes_Random_start98,TSPB,59540,33227,26313,206,100,200
GreedyLS_Nodes_Random_start99,TSPB,61285,35486,25799,204,100,200
GreedyLS_Nodes_Random_start100,TSPB,58181,31573,26608,204,100,200
GreedyLS_Nodes_Random_start101,TSPB,62342,35649,26693,220,100,200
GreedyLS_Nodes_Random_start102,TSPB,60000,33477,26523,214,100,200
GreedyLS_Nodes_Random_start103,TSPB,59562,33394,26168,225,100,200
GreedyLS_Nodes_Random_start104,TSPB,67696,42162,25534,204,100,200
GreedyLS_Nodes_Random_start105,TSPB,62230,35518,26712,214,100,200
GreedyLS_Nodes_Random_start106,TSPB,64890,36320,28570,194,100,200
GreedyLS_Nodes_Random_start107,TSPB,67756,39830,27926,170,100,200
GreedyLS_Nodes_Random_start108,TSPB,58398,29900,28498,240,100,200
GreedyLS_Nodes_Random_start109,TSPB,56907,31003,25904,223,100,200
GreedyLS_Nodes_Random_start110,TSPB,59154,32932,26222,225,100,200
GreedyLS_Nodes_Random_start111,TSPB,59148,32096,27052,214,100,200
GreedyLS_Nodes_Random_start112,TSPB,60514,33472,27042,208,100,200
GreedyLS_Nodes_Random_start113,TSPB,59284,33488,25796,187,100,200
GreedyLS_Nodes_Random_start114,TSPB,62626,36342,26284,187,100,200
GreedyLS_Nodes_Random_start115,TSPB,63222,36282,26940,185,100,200
GreedyLS_Nodes_Random_start116,TSPB,59545,33252,26293,203,100,200
GreedyLS_Nodes_Random_start117,TSPB,58814,31206,27608,200,100,200
GreedyLS_Nodes_Random_start118,TSPB,63635,36628,27007,191,100,200
GreedyLS_Nodes_Random_start119,TSPB,60357,34699,25658,200,100,200
GreedyLS_Nodes_Random_start120,TSPB,62521,33907,28614,231,100,200
GreedyLS_Nodes_Random_start121,TSPB,60759,33584,27175,189,100,200
GreedyLS_Nodes_Random_start122,TSPB,62355,33985,28370,226,100,200
GreedyLS_Nodes_Random_start123,TSPB,62422,36963,25459,206,100,200
GreedyLS_Nodes_Random_start124,TSPB,61242,33245,27997,200,100,200
GreedyLS_Nodes_Random_start125,TSPB,60779,32933,27846,217,100,200
GreedyLS_Nodes_Random_start126,TSPB,60041,32041,28000,223,100,200
GreedyLS_Nodes_Random_start127,TSPB,61567,35371,26196,225,100,200
GreedyLS_Nodes_Random_start128,TSPB,59961,32751,27210,210,100,200
GreedyLS_Nodes_Random_start129,TSPB,61914,36622,25292,233,100,200
GreedyLS_Nodes_Random_start130,TSPB,59727,33343,26384,216,100,200
GreedyLS_Nodes_Random_start131,TSPB,60219,33885,26334,213,100,200
GreedyLS_Nodes_Random_start132,TSPB,63573,39434,24139,209,100,200
GreedyLS_Nodes_Random_start133,TSPB,59599,34478,25121,201,100,200
GreedyLS_Nodes_Random_start134,TSPB,59737,33920,25817,213,100,200
GreedyLS_Nodes_Random_start135,TSPB,60111,34600,25511,199,100,200
GreedyLS_Nodes_Random_start136,TSPB,59208,32560,26648,240,100,200
GreedyLS_Nodes_Random_start137,TSPB,66320,41023,25297,208,100,200
GreedyLS_Nodes_Random_start138,TSPB,62521,32368,30153,222,100,200
GreedyLS_Nodes_Random_start139,TSPB,60722,32077,28645,209,100,200
GreedyLS_Nodes_Random_start140,TSPB,66022,40592,25430,200,100,200
GreedyLS_Nodes_Random_start141,TSPB,61677,34328,27349,213,100,200
GreedyLS_Nodes_Random_start142,TSPB,58301,32868,25433,206,100,200
GreedyLS_Nodes_Random_start143,TSPB,60872,35055,25817,205,100,200
GreedyLS_Nodes_Random_start144,TSPB,62922,35998,26924,212,100,200
GreedyLS_Nodes_Random_start145,TSPB,59249,33823,25426,199,100,200
GreedyLS_Nodes_Random_start146,TSPB,61940,36028,25912,192,100,200
GreedyLS_Nodes_Random_start147,TSPB,64584,36606,27978,257,100,200
GreedyLS_Nodes_Random_start148,TSPB,59740,32823,26917,195,100,200
GreedyLS_Nodes_Random_start149,TSPB,55543,30079,25464,236,100,200
GreedyLS_Nodes_Random_start150,TSPB,53522,26492,27030,229,100,200
GreedyLS_Nodes_Random_start151,TSPB,58215,31576,26639,201,100,200
GreedyLS_Nodes_Random_start152,TSPB,59139,32907,26232,194,100,200
GreedyLS_Nodes_Random_start153,TSPB,60739,31488,29251,200,100,200
GreedyLS_Nodes_Random_start154,TSPB,64774,38587,26187,225,100,200
GreedyLS_Nodes_Random_start155,TSPB,61444,35151,26293,230,100,200
GreedyLS_Nodes_Random_start156,TSPB,60911,36527,24384,194,100,200
GreedyLS_Nodes_Random_start157,TSPB,59796,31626,28170,219,100,200
GreedyLS_Nodes_Random_start158,TSPB,58235,31485,26750,199,100,200
GreedyLS_Nodes_Random_start159,TSPB,62132,36313,25819,196,100,200
GreedyLS_Nodes_Random_start160,TSPB,62063,36130,25933,201,100,200
GreedyLS_Nodes_Random_start161,TSPB,58510,32284,26226,222,100,200
GreedyLS_Nodes_Random_start162,TSPB,60346,32728,27618,233,100,200
GreedyLS_Nodes_Random_start163,TSPB,61558,34399,27159,191,100,200
GreedyLS_Nodes_Random_start164,TSPB,65437,39485,25952,200,100,200
GreedyLS_Nodes_Random_start165,TSPB,59594,32457,27137,213,100,200
GreedyLS_Nodes_Random_start166,TSPB,65267,37370,27897,186,100,200
GreedyLS_Nodes_Random_start167,TSPB,58447,32959,25488,205,100,200
GreedyLS_Nodes_Random_start168,TSPB,58210,31046,27164,201,100,200
GreedyLS_Nodes_Random_start169,TSPB,56992,30234,26758,244,100,200
GreedyLS_Nodes_Random_start170,TSPB,57823,32787,25036,167,100,200
GreedyLS_Nodes_Random_start171,TSPB,63732,36683,27049,223,100,200
GreedyLS_Nodes_Random_start172,TSPB,61861,33534,28327,223,100,200
GreedyLS_Nodes_Random_start173,TSPB,58886,31623,27263,224,100,200
GreedyLS_Nodes_Random_start174,TSPB,57980,31218,26762,179,100,200
GreedyLS_Nodes_Random_start175,TSPB,60578,34638,25940,230,100,200
GreedyLS_Nodes_Random_start176,TSPB,65028,39633,25395,189,100,200
GreedyLS_Nodes_Random_start177,TSPB,56710,29308,27402,197,100,200
GreedyLS_Nodes_Random_start178,TSPB,62899,33304,29595,219,100,200
GreedyLS_Nodes_Random_start179,TSPB,63854,36300,27554,215,100,200
GreedyLS_Nodes_Random_start180,TSPB,61979,36724,25255,204,100,200
GreedyLS_Nodes_Random_start181,TSPB,58604,31151,27453,203,100,200
GreedyLS_Nodes_Random_start182,TSPB,61404,33592,27812,227,100,200
GreedyLS_Nodes_Random_start183,TSPB,58278,31721,26557,225,100,200
GreedyLS_Nodes_Random_start184,TSPB,59889,33879,26010,190,100,200
GreedyLS_Nodes_Random_start185,TSPB,60675,35514,25161,197,100,200
GreedyLS_Nodes_Random_start186,TSPB,66074,39266,26808,215,100,200
GreedyLS_Nodes_Random_start187,TSPB,61448,35581,25867,199,100,200
GreedyLS_Nodes_Random_start188,TSPB,59400,32425,26975,230,100,200
GreedyLS_Nodes_Random_start189,TSPB,58543,30908,27635,206,100,200
GreedyLS_Nodes_Random_start190,TSPB,62892,32804,30088,207,100,200
GreedyLS_Nodes_Random_start191,TSPB,63276,37565,25711,181,100,200
GreedyLS_Nodes_Random_start192,TSPB,63673,35962,27711,187,100,200
GreedyLS_Nodes_Random_start193,TSPB,60043,32095,27948,216,100,200
GreedyLS_Nodes_Random_start194,TSPB,61138,34905,26233,220,100,200
GreedyLS_Nodes_Random_start195,TSPB,62739,36146,26593,191,100,200
GreedyLS_Nodes_Random_start196,TSPB,63493,37184,26309,195,100,200
GreedyLS_Nodes_Random_start197,TSPB,60459,33057,27402,208,100,200
GreedyLS_Nodes_Random_start198,TSPB,61064,34955,26109,235,100,200
GreedyLS_Nodes_Random_start199,TSPB,58375,30070,28305,222,100,200
GreedyLS_Nodes_NearestNeighborAny2Regret_w1_1_start0,TSPB,45804,19262,26542,9,100,200
GreedyLS_Nodes_NearestNeighborAny2Regret_w1_1_start1,TSPB,44628,20217,24411,9,100,200
GreedyLS_Nodes_NearestNeighborAny2Regret_w1_1_start2,TSPB,45826,19506,26320,14,100,200
GreedyLS_Nodes_NearestNeighborAny2Regret_w1_1_start3,TSPB,48742,20998,27744,8,100,200
GreedyLS_Nodes_NearestNeighborAny2Regret_w1_1_start4,TSPB,48338,21840,26498,11,100,200
GreedyLS_Nodes_NearestNeighborAny2Regret_w1_1_start5,TSPB,47068,20307,26761,9,100,200
GreedyLS_Nodes_NearestNeighborAny2Regret_w1_1_start6,TSPB,46075,20800,25275,6,100,200
GreedyLS_Nodes_NearestNeighborAny2Regret_w1_1_start7,TSPB,49765,20046,29719,15,100,200
GreedyLS_Nodes_NearestNeighborAny2Regret_w1_1_start8,TSPB,45836,19071,26765,10,100,200
GreedyLS_Nodes_NearestNeighborAny2Regret_w1_1_start9,TSPB,45889,20756,25133,10,100,200
GreedyLS_Nodes_NearestNeighborAny2Regret_w1_1_start10,TSPB,46670,21803,24867,9,100,200
GreedyLS_Nodes_NearestNeighborAny2Regret_w1_1_start11,TSPB,49715,20145,29570,13,100,200
GreedyLS_Nodes_NearestNeighborAny2Regret_w1_1_start12,TSPB,46298,19472,26826,8,100,200
GreedyLS_Nodes_NearestNeighborAny2Regret_w1_1_start13,TSPB,48713,20724,27989,6,100,200
GreedyLS_Nodes_NearestNeighborAny2Regret_w1_1_start14,TSPB,47368,19507,27861,15,100,200
GreedyLS_Nodes_NearestNeighborAny2Regret_w1_1_start15,TSPB,48742,20998,27744,8,100,200
GreedyLS_Nodes_NearestNeighborAny2Regret_w1_1_start16,TSPB,44628,20217,24411,9,100,200
GreedyLS_Nodes_NearestNeighborAny2Regret_w1_1_start17,TSPB,45085,20485,24600,10,100,200
GreedyLS_Nodes_NearestNeighborAny2Regret_w1_1_start18,TSPB,48338,21840,26498,9,100,200
GreedyLS_Nodes_NearestNeighborAny2Regret_w1_1_start19,TSPB,44845,20396,24449,10,100,200
GreedyLS_Nodes_NearestNeighborAny2Regret_w1_1_start20,TSPB,48179,20369,27810,10,100,200
GreedyLS_Nodes_NearestNeighborAny2Regret_w1_1_start21,TSPB,45847,19700,26147,15,100,200
GreedyLS_Nodes_NearestNeighborAny2Regret_w1_1_start22,TSPB,48088,19975,28113,8,100,200
GreedyLS_Nodes_NearestNeighborAny2Regret_w1_1_start23,TSPB,48540,21870,26670,12,100,200
GreedyLS_Nodes_NearestNeighborAny2Regret_w1_1_start24,TSPB,45051,19588,25463,9,100,200
GreedyLS_Nodes_NearestNeighborAny2Regret_w1_1_start25,TSPB,48088,19975,28113,8,100,200
GreedyLS_Nodes_NearestNeighborAny2Regret_w1_1_start26,TSPB,44836,20465,24371,11,100,200
GreedyLS_Nodes_NearestNeighborAny2Regret_w1_1_start27,TSPB,46075,20800,25275,9,100,200
GreedyLS_Nodes_NearestNeighborAny2Regret_w1_1_start28,TSPB,48338,21840,26498,10,100,200
GreedyLS_Nodes_NearestNeighborAny2Regret_w1_1_start29,TSPB,45976,19434,26542,9,100,200
GreedyLS_Nodes_NearestNeighborAny2Regret_w1_1_start30,TSPB,44816,20368,24448,13,100,200
GreedyLS_Nodes_NearestNeighborAny2Regret_w1_1_start31,TSPB,46466,20915,25551,9,100,200
GreedyLS_Nodes_NearestNeighborAny2Regret_w1_1_start32,TSPB,48089,19923,28166,9,100,200
GreedyLS_Nodes_NearestNeighborAny2Regret_w1_1_start33,TSPB,45836,19071,26765,9,100,200
GreedyLS_Nodes_NearestNeighborAny2Regret_w1_1_start34,TSPB,46094,20515,25579,12,100,200
GreedyLS_Nodes_NearestNeighborAny2Regret_w1_1_start35,TSPB,45976,19434,26542,10,100,200
GreedyLS_Nodes_NearestNeighborAny2Regret_w1_1_start36,TSPB,48179,20369,27810,10,100,200
GreedyLS_Nodes_NearestNeighborAny2Regret_w1_1_start37,TSPB,47951,23252,24699,12,100,200
GreedyLS_Nodes_NearestNeighborAny2Regret_w1_1_start38,TSPB,45670,20143,25527,10,100,200
GreedyLS_Nodes_NearestNeighborAny2Regret_w1_1_start39,TSPB,49640,21324,28316,16,100,200
GreedyLS_Nodes_NearestNeighborAny2Regret_w1_1_start40,TSPB,48179,20369,27810,10,100,200
GreedyLS_Nodes_NearestNeighborAny2Regret_w1_1_start41,TSPB,47697,19730,27967,12,100,200
GreedyLS_Nodes_NearestNeighborAny2Regret_w1_1_start42,TSPB,44628,20217,24411,12,100,200
GreedyLS_Nodes_NearestNeighborAny2Regret_w1_1_start43,TSPB,48742,20998,27744,8,100,200
GreedyLS_Nodes_NearestNeighborAny2Regret_w1_1_start44,TSPB,48824,20682,28142,7,100,200
GreedyLS_Nodes_NearestNeighborAny2Regret_w1_1_start45,TSPB,46676,19975,26701,16,100,200
GreedyLS_Nodes_NearestNeighborAny2Regret_w1_1_start46,TSPB,46082,19134,26948,10,100,200
GreedyLS_Nodes_NearestNeighborAny2Regret_w1_1_start47,TSPB,48088,19975,28113,7,100,200
GreedyLS_Nodes_NearestNeighborAny2Regret_w1_1_start48,TSPB,52416,23859,28557,14,100,200
GreedyLS_Nodes_NearestNeighborAny2Regret_w1_1_start49,TSPB,45914,18838,27076,8,100,200
GreedyLS_Nodes_NearestNeighborAny2Regret_w1_1_start50,TSPB,47722,19541,28181,13,100,200
GreedyLS_Nodes_NearestNeighborAny2Regret_w1_1_start51,TSPB,46466,20915,25551,9,100,200
GreedyLS_Nodes_NearestNeighborAny2Regret_w1_1_start52,TSPB,48524,19966,28558,12,100,200
GreedyLS_Nodes_NearestNeighborAny2Regret_w1_1_start53,TSPB,45948,20361,25587,10,100,200
GreedyLS_Nodes_NearestNeighborAny2Regret_w1_1_start54,TSPB,46466,20915,25551,9,100,200
GreedyLS_Nodes_NearestNeighborAny2Regret_w1_1_start55,TSPB,48338,21840,26498,9,100,200
GreedyLS_Nodes_NearestNeighborAny2Regret_w1_1_start56,TSPB,47088,20578,26510,14,100,200
GreedyLS_Nodes_NearestNeighborAny2Regret_w1_1_start57,TSPB,48088,19975,28113,9,100,200
GreedyLS_Nodes_NearestNeighborAny2Regret_w1_1_start58,TSPB,48744,20946,27798,10,100,200
GreedyLS_Nodes_NearestNeighborAny2Regret_w1_1_start59,TSPB,48338,21840,26498,12,100,200
GreedyLS_Nodes_NearestNeighborAny2Regret_w1_1_start60,TSPB,48338,21840,26498,10,100,200
GreedyLS_Nodes_NearestNeighborAny2Regret_w1_1_start61,TSPB,48089,19923,28166,9,100,200
GreedyLS_Nodes_NearestNeighborAny2Regret_w1_1_start62,TSPB,48338,21840,26498,10,100,200
GreedyLS_Nodes_NearestNeighborAny2Regret_w1_1_start63,TSPB,48088,19975,28113,7,100,200
GreedyLS_Nodes_NearestNeighborAny2Regret_w1_1_start64,TSPB,45278,19720,25558,10,100,200
GreedyLS_Nodes_NearestNeighborAny2Regret_w1_1_start65,TSPB,48960,20721,28239,8,100,200
GreedyLS_Nodes_NearestNeighborAny2Regret_w1_1_start66,TSPB,48179,20369,27810,9,100,200
GreedyLS_Nodes_NearestNeighborAny2Regret_w1_1_start67,TSPB,45758,20837,24921,11,100,200
GreedyLS_Nodes_NearestNeighborAny2Regret_w1_1_start68,TSPB,50416,19197,31219,13,100,200
GreedyLS_Nodes_NearestNeighborAny2Regret_w1_1_start69,TSPB,46265,20420,25845,10,100,200
GreedyLS_Nodes_NearestNeighborAny2Regret_w1_1_start70,TSPB,48742,20998,27744,8,100,200
GreedyLS_Nodes_NearestNeighborAny2Regret_w1_1_start71,TSPB,46797,19796,27001,8,100,200
GreedyLS_Nodes_NearestNeighborAny2Regret_w1_1_start72,TSPB,44961,20300,24661,10,100,200
GreedyLS_Nodes_NearestNeighborAny2Regret_w1_1_start73,TSPB,45883,20467,25416,5,100,200
GreedyLS_Nodes_NearestNeighborAny2Regret_w1_1_start74,TSPB,47669,21882,25787,13,100,200
GreedyLS_Nodes_NearestNeighborAny2Regret_w1_1_start75,TSPB,44990,20559,24431,20,100,200
GreedyLS_Nodes_NearestNeighborAny2Regret_w1_1_start76,TSPB,50712,20289,30423,16,100,200
GreedyLS_Nodes_NearestNeighborAny2Regret_w1_1_start77,TSPB,44628,20217,24411,8,100,200
GreedyLS_Nodes_NearestNeighborAny2Regret_w1_1_start78,TSPB,46479,19984,26495,13,100,200
GreedyLS_Nodes_NearestNeighborAny2Regret_w1_1_start79,TSPB,48152,19959,28193,7,100,200
GreedyLS_Nodes_NearestNeighborAny2Regret_w1_1_start80,TSPB,46466,20915,25551,7,100,200
GreedyLS_Nodes_NearestNeighborAny2Regret_w1_1_start81,TSPB,48338,21840,26498,9,100,200
GreedyLS_Nodes_NearestNeighborAny2Regret_w1_1_start82,TSPB,46727,20498,26229,13,100,200
GreedyLS_Nodes_NearestNeighborAny2Regret_w1_1_start83,TSPB,48506,21899,26607,13,100,200
GreedyLS_Nodes_NearestNeighborAny2Regret_w1_1_start84,TSPB,45355,19930,25425,11,100,200
GreedyLS_Nodes_NearestNeighborAny2Regret_w1_1_start85,TSPB,45633,19769,25864,8,100,200
GreedyLS_Nodes_NearestNeighborAny2Regret_w1_1_start86,TSPB,48088,19975,28113,7,100,200
GreedyLS_Nodes_NearestNeighborAny2Regret_w1_1_start87,TSPB,45954,19874,26080,11,100,200
GreedyLS_Nodes_NearestNeighborAny2Regret_w1_1_start88,TSPB,48097,20356,27741,10,100,200
GreedyLS_Nodes_NearestNeighborAny2Regret_w1_1_start89,TSPB,48179,20369,27810,9,100,200
GreedyLS_Nodes_NearestNeighborAny2Regret_w1_1_start90,TSPB,44845,20396,24449,10,100,200
GreedyLS_Nodes_NearestNeighborAny2Regret_w1_1_start91,TSPB,48179,20369,27810,10,100,200
GreedyLS_Nodes_NearestNeighborAny2Regret_w1_1_start92,TSPB,48089,19923,28166,9,100,200
GreedyLS_Nodes_NearestNeighborAny2Regret_w1_1_start93,TSPB,51546,20944,30602,13,100,200
GreedyLS_Nodes_NearestNeighborAny2Regret_w1_1_start94,TSPB,48179,20369,27810,12,100,200
GreedyLS_Nodes_NearestNeighborAny2Regret_w1_1_start95,TSPB,51466,23109,28357,11,100,200
GreedyLS_Nodes_NearestNeighborAny2Regret_w1_1_start96,TSPB,48088,19975,28113,10,100,200
GreedyLS_Nodes_NearestNeighborAny2Regret_w1_1_start97,TSPB,44895,20301,24594,8,100,200
GreedyLS_Nodes_NearestNeighborAny2Regret_w1_1_start98,TSPB,45278,19904,25374,11,100,200
GreedyLS_Nodes_NearestNeighborAny2Regret_w1_1_start99,TSPB,48089,19923,28166,8,100,200
GreedyLS_Nodes_NearestNeighborAny2Regret_w1_1_start100,TSPB,48088,19975,28113,7,100,200
GreedyLS_Nodes_NearestNeighborAny2Regret_w1_1_start101,TSPB,48611,21830,26781,13,100,200
GreedyLS_Nodes_NearestNeighborAny2Regret_w1_1_start102,TSPB,48089,19923,28166,7,100,200
GreedyLS_Nodes_NearestNeighborAny2Regret_w1_1_start103,TSPB,44628,20217,24411,8,100,200
GreedyLS_Nodes_NearestNeighborAny2Regret_w1_1_start104,TSPB,45976,19434,26542,8,100,200
GreedyLS_Nodes_NearestNeighborAny2Regret_w1_1_start105,TSPB,45273,19707,25566,11,100,200
GreedyLS_Nodes_NearestNeighborAny2Regret_w1_1_start106,TSPB,48338,21840,26498,9,100,200
GreedyLS_Nodes_NearestNeighborAny2Regret_w1_1_start107,TSPB,48088,19975,28113,9,100,200
GreedyLS_Nodes_NearestNeighborAny2Regret_w1_1_start108,TSPB,45726,20193,25533,14,100,200
GreedyLS_Nodes_NearestNeighborAny2Regret_w1_1_start109,TSPB,45976,19434,26542,9,100,200
GreedyLS_Nodes_NearestNeighborAny2Regret_w1_1_start110,TSPB,45966,19730,26236,10,100,200
GreedyLS_Nodes_NearestNeighborAny2Regret_w1_1_start111,TSPB,49264,19088,30176,10,100,200
GreedyLS_Nodes_NearestNeighborAny2Regret_w1_1_start112,TSPB,45076,20416,24660,6,100,200
GreedyLS_Nodes_NearestNeighborAny2Regret_w1_1_start113,TSPB,48088,19975,28113,8,100,200
GreedyLS_Nodes_NearestNeighborAny2Regret_w1_1_start114,TSPB,45300,19862,25438,9,100,200
GreedyLS_Nodes_NearestNeighborAny2Regret_w1_1_start115,TSPB,45001,20278,24723,10,100,200
GreedyLS_Nodes_NearestNeighborAny2Regret_w1_1_start116,TSPB,45056,20155,24901,7,100,200
GreedyLS_Nodes_NearestNeighborAny2Regret_w1_1_start117,TSPB,46466,20915,25551,7,100,200
GreedyLS_Nodes_NearestNeighborAny2Regret_w1_1_start118,TSPB,45685,19884,25801,5,100,200
GreedyLS_Nodes_NearestNeighborAny2Regret_w1_1_start119,TSPB,46540,20860,25680,15,100,200
GreedyLS_Nodes_NearestNeighborAny2Regret_w1_1_start120,TSPB,45758,20837,24921,12,100,200
GreedyLS_Nodes_NearestNeighborAny2Regret_w1_1_start121,TSPB,44845,20396,24449,11,100,200
GreedyLS_Nodes_NearestNeighborAny2Regret_w1_1_start122,TSPB,48088,19975,28113,8,100,200
GreedyLS_Nodes_NearestNeighborAny2Regret_w1_1_start123,TSPB,48291,19968,28323,9,100,200
GreedyLS_Nodes_NearestNeighborAny2Regret_w1_1_start124,TSPB,48338,21840,26498,10,100,200
GreedyLS_Nodes_NearestNeighborAny2Regret_w1_1_start125,TSPB,48088,19975,28113,8,100,200
GreedyLS_Nodes_NearestNeighborAny2Regret_w1_1_start126,TSPB,48664,20601,28063,6,100,200
GreedyLS_Nodes_NearestNeighborAny2Regret_w1_1_start127,TSPB,48088,19975,28113,8,100,200
GreedyLS_Nodes_NearestNeighborAny2Regret_w1_1_start128,TSPB,46129,20547,25582,11,100,200
GreedyLS_Nodes_NearestNeighborAny2Regret_w1_1_start129,TSPB,44628,20217,24411,12,100,200
GreedyLS_Nodes_NearestNeighborAny2Regret_w1_1_start130,TSPB,47951,21975,25976,13,100,200
GreedyLS_Nodes_NearestNeighborAny2Regret_w1_1_start131,TSPB,48179,20369,27810,7,100,200
GreedyLS_Nodes_NearestNeighborAny2Regret_w1_1_start132,TSPB,48713,20724,27989,6,100,200
GreedyLS_Nodes_NearestNeighborAny2Regret_w1_1_start133,TSPB,48619,20720,27899,7,100,200
GreedyLS_Nodes_NearestNeighborAny2Regret_w1_1_start134,TSPB,45675,19556,26119,8,100,200
GreedyLS_Nodes_NearestNeighborAny2Regret_w1_1_start135,TSPB,48089,19923,28166,8,100,200
GreedyLS_Nodes_NearestNeighborAny2Regret_w1_1_start136,TSPB,46447,20847,25600,10,100,200
GreedyLS_Nodes_NearestNeighborAny2Regret_w1_1_start137,TSPB,52154,22923,29231,26,100,200
GreedyLS_Nodes_NearestNeighborAny2Regret_w1_1_start138,TSPB,49913,20562,29351,11,100,200
GreedyLS_Nodes_NearestNeighborAny2Regret_w1_1_start139,TSPB,49143,19556,29587,11,100,200
GreedyLS_Nodes_NearestNeighborAny2Regret_w1_1_start140,TSPB,47457,21630,25827,16,100,200
GreedyLS_Nodes_NearestNeighborAny2Regret_w1_1_start141,TSPB,44628,20217,24411,11,100,200
GreedyLS_Nodes_NearestNeighborAny2Regret_w1_1_start142,TSPB,47370,20618,26752,11,100,200
GreedyLS_Nodes_NearestNeighborAny2Regret_w1_1_start143,TSPB,47885,19442,28443,14,100,200
GreedyLS_Nodes_NearestNeighborAny2Regret_w1_1_start144,TSPB,46003,19245,26758,10,100,200
GreedyLS_Nodes_NearestNeighborAny2Regret_w1_1_start145,TSPB,48742,20998,27744,8,100,200
GreedyLS_Nodes_NearestNeighborAny2Regret_w1_1_start146,TSPB,46982,20049,26933,9,100,200
GreedyLS_Nodes_NearestNeighborAny2Regret_w1_1_start147,TSPB,46466,20915,25551,8,100,200
GreedyLS_Nodes_NearestNeighborAny2Regret_w1_1_start148,TSPB,48088,19975,28113,8,100,200
GreedyLS_Nodes_NearestNeighborAny2Regret_w1_1_start149,TSPB,48338,21840,26498,10,100,200
GreedyLS_Nodes_NearestNeighborAny2Regret_w1_1_start150,TSPB,46364,21056,25308,11,100,200
GreedyLS_Nodes_NearestNeighborAny2Regret_w1_1_start151,TSPB,44845,20396,24449,10,100,200
GreedyLS_Nodes_NearestNeighborAny2Regret_w1_1_start152,TSPB,45621,19916,25705,8,100,200
GreedyLS_Nodes_NearestNeighborAny2Regret_w1_1_start153,TSPB,44628,20217,24411,10,100,200
GreedyLS_Nodes_NearestNeighborAny2Regret_w1_1_start154,TSPB,46351,20680,25671,10,100,200
GreedyLS_Nodes_NearestNeighborAny2Regret_w1_1_start155,TSPB,46466,20915,25551,9,100,200
GreedyLS_Nodes_NearestNeighborAny2Regret_w1_1_start156,TSPB,44740,20399,24341,10,100,200
GreedyLS_Nodes_NearestNeighborAny2Regret_w1_1_start157,TSPB,45923,19370,26553,12,100,200
GreedyLS_Nodes_NearestNeighborAny2Regret_w1_1_start158,TSPB,48088,19975,28113,7,100,200
GreedyLS_Nodes_NearestNeighborAny2Regret_w1_1_start159,TSPB,47472,20580,26892,10,100,200
GreedyLS_Nodes_NearestNeighborAny2Regret_w1_1_start160,TSPB,49913,20562,29351,13,100,200
GreedyLS_Nodes_NearestNeighborAny2Regret_w1_1_start161,TSPB,45587,19601,25986,7,100,200
GreedyLS_Nodes_NearestNeighborAny2Regret_w1_1_start162,TSPB,46715,19932,26783,13,100,200
GreedyLS_Nodes_NearestNeighborAny2Regret_w1_1_start163,TSPB,44488,19854,24634,8,100,200
GreedyLS_Nodes_NearestNeighborAny2Regret_w1_1_start164,TSPB,46397,20818,25579,10,100,200
GreedyLS_Nodes_NearestNeighborAny2Regret_w1_1_start165,TSPB,44779,20280,24499,10,100,200
GreedyLS_Nodes_NearestNeighborAny2Regret_w1_1_start166,TSPB,48089,19923,28166,10,100,200
GreedyLS_Nodes_NearestNeighborAny2Regret_w1_1_start167,TSPB,46378,20227,26151,12,100,200
GreedyLS_Nodes_NearestNeighborAny2Regret_w1_1_start168,TSPB,48713,20724,27989,7,100,200
GreedyLS_Nodes_NearestNeighborAny2Regret_w1_1_start169,TSPB,48713,20724,27989,6,100,200
GreedyLS_Nodes_NearestNeighborAny2Regret_w1_1_start170,TSPB,46411,20463,25948,6,100,200
GreedyLS_Nodes_NearestNeighborAny2Regret_w1_1_start171,TSPB,47082,20030,27052,10,100,200
GreedyLS_Nodes_NearestNeighborAny2Regret_w1_1_start172,TSPB,44628,20217,24411,9,100,200
GreedyLS_Nodes_NearestNeighborAny2Regret_w1_1_start173,TSPB,44899,20219,24680,9,100,200
GreedyLS_Nodes_NearestNeighborAny2Regret_w1_1_start174,TSPB,47669,21699,25970,18,100,200
GreedyLS_Nodes_NearestNeighborAny2Regret_w1_1_start175,TSPB,47370,20618,26752,12,100,200
GreedyLS_Nodes_NearestNeighborAny2Regret_w1_1_start176,TSPB,48089,19923,28166,9,100,200
GreedyLS_Nodes_NearestNeighborAny2Regret_w1_1_start177,TSPB,46609,19716,26893,13,100,200
GreedyLS_Nodes_NearestNeighborAny2Regret_w1_1_start178,TSPB,44895,20323,24572,10,100,200
GreedyLS_Nodes_NearestNeighborAny2Regret_w1_1_start179,TSPB,44628,20217,24411,10,100,200
GreedyLS_Nodes_NearestNeighborAny2Regret_w1_1_start180,TSPB,48097,20356,27741,10,100,200
GreedyLS_Nodes_NearestNeighborAny2Regret_w1_1_start181,TSPB,48586,19612,28974,12,100,200
GreedyLS_Nodes_NearestNeighborAny2Regret_w1_1_start182,TSPB,49158,20224,28934,19,100,200
GreedyLS_Nodes_NearestNeighborAny2Regret_w1_1_start183,TSPB,48338,21840,26498,11,100,200
GreedyLS_Nodes_NearestNeighborAny2Regret_w1_1_start184,TSPB,46051,20866,25185,9,100,200
GreedyLS_Nodes_NearestNeighborAny2Regret_w1_1_start185,TSPB,48088,19975,28113,8,100,200
GreedyLS_Nodes_NearestNeighborAny2Regret_w1_1_start186,TSPB,44456,20045,24411,12,100,200
GreedyLS_Nodes_NearestNeighborAny2Regret_w1_1_start187,TSPB,46445,19928,26517,8,100,200
GreedyLS_Nodes_NearestNeighborAny2Regret_w1_1_start188,TSPB,48713,20724,27989,10,100,200
GreedyLS_Nodes_NearestNeighborAny2Regret_w1_1_start189,TSPB,46829,20824,26005,15,100,200
GreedyLS_Nodes_NearestNeighborAny2Regret_w1_1_start190,TSPB,46466,20915,25551,9,100,200
GreedyLS_Nodes_NearestNeighborAny2Regret_w1_1_start191,TSPB,46797,19796,27001,7,100,200
GreedyLS_Nodes_NearestNeighborAny2Regret_w1_1_start192,TSPB,46364,21056,25308,10,100,200
GreedyLS_Nodes_NearestNeighborAny2Regret_w1_1_start193,TSPB,45883,20467,25416,6,100,200
GreedyLS_Nodes_NearestNeighborAny2Regret_w1_1_start194,TSPB,48088,19975,28113,8,100,200
GreedyLS_Nodes_NearestNeighborAny2Regret_w1_1_start195,TSPB,48713,20724,27989,7,100,200
GreedyLS_Nodes_NearestNeighborAny2Regret_w1_1_start196,TSPB,47255,20543,26712,10,100,200
GreedyLS_Nodes_NearestNeighborAny2Regret_w1_1_start197,TSPB,44863,20034,24829,12,100,200
GreedyLS_Nodes_NearestNeighborAny2Regret_w1_1_start198,TSPB,45883,20467,25416,7,100,200
GreedyLS_Nodes_NearestNeighborAny2Regret_w1_1_start199,TSPB,48319,22110,26209,12,100,200
GreedyLS_Edges_Random_start0,TSPB,47085,21198,25887,193,100,200
GreedyLS_Edges_Random_start1,TSPB,47881,21688,26193,194,100,200
GreedyLS_Edges_Random_start2,TSPB,49255,21276,27979,206,100,200
GreedyLS_Edges_Random_start3,TSPB,47719,21443,26276,205,100,200
GreedyLS_Edges_Random_start4,TSPB,49494,22364,27130,187,100,200
GreedyLS_Edges_Random_start5,TSPB,49123,21190,27933,200,100,200
GreedyLS_Edges_Random_start6,TSPB,47452,20831,26621,200,100,200
GreedyLS_Edges_Random_start7,TSPB,49930,22355,27575,202,100,200
GreedyLS_Edges_Random_start8,TSPB,48304,21538,26766,205,100,200
GreedyLS_Edges_Random_start9,TSPB,48289,22617,25672,198,100,200
GreedyLS_Edges_Random_start10,TSPB,48564,20789,27775,221,100,200
GreedyLS_Edges_Random_start11,TSPB,49423,21430,27993,201,100,200
GreedyLS_Edges_Random_start12,TSPB,48332,21008,27324,201,100,200
GreedyLS_Edges_Random_start13,TSPB,46553,20202,26351,205,100,200
GreedyLS_Edges_Random_start14,TSPB,47314,18707,28607,198,100,200
GreedyLS_Edges_Random_start15,TSPB,48664,22769,25895,223,100,200
GreedyLS_Edges_Random_start16,TSPB,48151,21191,26960,207,100,200
GreedyLS_Edges_Random_start17,TSPB,47384,21783,25601,217,100,200
GreedyLS_Edges_Random_start18,TSPB,49021,20736,28285,206,100,200
GreedyLS_Edges_Random_start19,TSPB,46772,19744,27028,201,100,200
GreedyLS_Edges_Random_start20,TSPB,48347,21925,26422,214,100,200
GreedyLS_Edges_Random_start21,TSPB,48426,22020,26406,187,100,200
GreedyLS_Edges_Random_start22,TSPB,48300,23086,25214,202,100,200
GreedyLS_Edges_Random_start23,TSPB,49051,22352,26699,199,100,200
GreedyLS_Edges_Random_start24,TSPB,49106,22309,26797,207,100,200
GreedyLS_Edges_Random_start25,TSPB,50824,22833,27991,217,100,200
GreedyLS_Edges_Random_start26,TSPB,47891,21584,26307,196,100,200
GreedyLS_Edges_Random_start27,TSPB,48252,21761,26491,205,100,200
GreedyLS_Edges_Random_start28,TSPB,48072,19890,28182,203,100,200
GreedyLS_Edges_Random_start29,TSPB,46720,20993,25727,209,100,200
GreedyLS_Edges_Random_start30,TSPB,48444,21789,26655,201,100,200
GreedyLS_Edges_Random_start31,TSPB,47433,19585,27848,221,100,200
GreedyLS_Edges_Random_start32,TSPB,47888,22364,25524,222,100,200
GreedyLS_Edges_Random_start33,TSPB,48229,22017,26212,226,100,200
GreedyLS_Edges_Random_start34,TSPB,49319,21229,28090,207,100,200
GreedyLS_Edges_Random_start35,TSPB,48313,21353,26960,204,100,200
GreedyLS_Edges_Random_start36,TSPB,48730,21970,26760,201,100,200
GreedyLS_Edges_Random_start37,TSPB,49445,21777,27668,209,100,200
GreedyLS_Edges_Random_start38,TSPB,48255,20554,27701,219,100,200
GreedyLS_Edges_Random_start39,TSPB,47973,21846,26127,198,100,200
GreedyLS_Edges_Random_start40,TSPB,46345,20499,25846,216,100,200
GreedyLS_Edges_Random_start41,TSPB,49359,21899,27460,188,100,200
GreedyLS_Edges_Random_start42,TSPB,49149,22002,27147,197,100,200
GreedyLS_Edges_Random_start43,TSPB,48101,21020,27081,210,100,200
GreedyLS_Edges_Random_start44,TSPB,46810,22006,24804,188,100,200
GreedyLS_Edges_Random_start45,TSPB,49766,21735,28031,191,100,200
GreedyLS_Edges_Random_start46,TSPB,47253,20210,27043,198,100,200
GreedyLS_Edges_Random_start47,TSPB,47510,21427,26083,215,100,200
GreedyLS_Edges_Random_start48,TSPB,47300,21249,26051,218,100,200
GreedyLS_Edges_Random_start49,TSPB,47816,21235,26581,193,100,200
GreedyLS_Edges_Random_start50,TSPB,48392,21409,26983,218,100,200
GreedyLS_Edges_Random_start51,TSPB,50113,22628,27485,196,100,200
GreedyLS_Edges_Random_start52,TSPB,48300,21359,26941,192,100,200
GreedyLS_Edges_Random_start53,TSPB,47666,21309,26357,204,100,200
GreedyLS_Edges_Random_start54,TSPB,48956,20281,28675,192,100,200
GreedyLS_Edges_Random_start55,TSPB,48188,20910,27278,200,100,200
GreedyLS_Edges_Random_start56,TSPB,47686,20691,26995,202,100,200
GreedyLS_Edges_Random_start57,TSPB,48564,19911,28653,228,100,200
GreedyLS_Edges_Random_start58,TSPB,47324,20767,26557,223,100,200
GreedyLS_Edges_Random_start59,TSPB,48914,21976,26938,205,100,200
GreedyLS_Edges_Random_start60,TSPB,48030,20567,27463,210,100,200
GreedyLS_Edges_Random_start61,TSPB,47674,21450,26224,211,100,200
GreedyLS_Edges_Random_start62,TSPB,47441,20812,26629,214,100,200
GreedyLS_Edges_Random_start63,TSPB,50003,20950,29053,194,100,200
GreedyLS_Edges_Random_start64,TSPB,46813,20216,26597,216,100,200
GreedyLS_Edges_Random_start65,TSPB,48460,21690,26770,231,100,200
GreedyLS_Edges_Random_start66,TSPB,49679,20811,28868,202,100,200
GreedyLS_Edges_Random_start67,TSPB,47597,20293,27304,197,100,200
GreedyLS_Edges_Random_start68,TSPB,48428,22581,25847,216,100,200
GreedyLS_Edges_Random_start69,TSPB,47546,21907,25639,202,100,200
GreedyLS_Edges_Random_start70,TSPB,47612,21677,25935,207,100,200
GreedyLS_Edges_Random_start71,TSPB,48251,21471,26780,211,100,200
GreedyLS_Edges_Random_start72,TSPB,48328,22370,25958,187,100,200
GreedyLS_Edges_Random_start73,TSPB,50323,21043,29280,216,100,200
GreedyLS_Edges_Random_start74,TSPB,46171,20502,25669,210,100,200
GreedyLS_Edges_Random_start75,TSPB,47461,20703,26758,213,100,200
GreedyLS_Edges_Random_start76,TSPB,47924,22399,25525,216,100,200
GreedyLS_Edges_Random_start77,TSPB,46829,22521,24308,202,100,200
GreedyLS_Edges_Random_start78,TSPB,47636,21403,26233,206,100,200
GreedyLS_Edges_Random_start79,TSPB,48865,22269,26596,189,100,200
GreedyLS_Edges_Random_start80,TSPB,48082,22451,25631,215,100,200
GreedyLS_Edges_Random_start81,TSPB,47643,21225,26418,198,100,200
GreedyLS_Edges_Random_start82,TSPB,47160,20702,26458,198,100,200
GreedyLS_Edges_Random_start83,TSPB,47400,20359,27041,194,100,200
GreedyLS_Edges_Random_start84,TSPB,46907,21587,25320,208,100,200
GreedyLS_Edges_Random_start85,TSPB,48123,21063,27060,197,100,200
GreedyLS_Edges_Random_start86,TSPB,48057,20054,28003,187,100,200
GreedyLS_Edges_Random_start87,TSPB,47752,20782,26970,211,100,200
GreedyLS_Edges_Random_start88,TSPB,47627,19685,27942,224,100,200
GreedyLS_Edges_Random_start89,TSPB,49551,21065,28486,188,100,200
GreedyLS_Edges_Random_start90,TSPB,46930,20337,26593,191,100,200
GreedyLS_Edges_Random_start91,TSPB,47546,20387,27159,203,100,200
GreedyLS_Edges_Random_start92,TSPB,47504,20156,27348,205,100,200
GreedyLS_Edges_Random_start93,TSPB,46832,20068,26764,216,100,200
GreedyLS_Edges_Random_start94,TSPB,48277,21498,26779,221,100,200
GreedyLS_Edges_Random_start95,TSPB,48732,21031,27701,209,100,200
GreedyLS_Edges_Random_start96,TSPB,47859,21624,26235,191,100,200
GreedyLS_Edges_Random_start97,TSPB,48153,20570,27583,213,100,200
GreedyLS_Edges_Random_start98,TSPB,47931,22089,25842,221,100,200
GreedyLS_Edges_Random_start99,TSPB,50031,22041,27990,194,100,200
GreedyLS_Edges_Random_start100,TSPB,47923,21247,26676,215,100,200
GreedyLS_Edges_Random_start101,TSPB,47379,21834,25545,221,100,200
GreedyLS_Edges_Random_start102,TSPB,47647,21379,26268,202,100,200
GreedyLS_Edges_Random_start103,TSPB,48963,21869,27094,197,100,200
GreedyLS_Edges_Random_start104,TSPB,51130,23252,27878,205,100,200
GreedyLS_Edges_Random_start105,TSPB,49372,22767,26605,197,100,200
GreedyLS_Edges_Random_start106,TSPB,49342,22302,27040,206,100,200
GreedyLS_Edges_Random_start107,TSPB,48317,22231,26086,215,100,200
GreedyLS_Edges_Random_start108,TSPB,48245,20406,27839,205,100,200
GreedyLS_Edges_Random_start109,TSPB,48917,20943,27974,184,100,200
GreedyLS_Edges_Random_start110,TSPB,48151,20421,27730,214,100,200
GreedyLS_Edges_Random_start111,TSPB,46499,21540,24959,202,100,200
GreedyLS_Edges_Random_start112,TSPB,49212,20923,28289,198,100,200
GreedyLS_Edges_Random_start113,TSPB,49543,22990,26553,196,100,200
GreedyLS_Edges_Random_start114,TSPB,47605,20749,26856,212,100,200
GreedyLS_Edges_Random_start115,TSPB,47242,21045,26197,231,100,200
GreedyLS_Edges_Random_start116,TSPB,46359,20016,26343,208,100,200
GreedyLS_Edges_Random_start117,TSPB,48916,22655,26261,218,100,200
GreedyLS_Edges_Random_start118,TSPB,46649,20686,25963,223,100,200
GreedyLS_Edges_Random_start119,TSPB,47281,20689,26592,219,100,200
GreedyLS_Edges_Random_start120,TSPB,48414,22131,26283,223,100,200
GreedyLS_Edges_Random_start121,TSPB,46282,20518,25764,216,100,200
GreedyLS_Edges_Random_start122,TSPB,48597,21852,26745,197,100,200
GreedyLS_Edges_Random_start123,TSPB,47649,21411,26238,200,100,200
GreedyLS_Edges_Random_start124,TSPB,48965,22493,26472,172,100,200
GreedyLS_Edges_Random_start125,TSPB,47413,20971,26442,212,100,200
GreedyLS_Edges_Random_start126,TSPB,47289,20565,26724,214,100,200
GreedyLS_Edges_Random_start127,TSPB,48769,21406,27363,204,100,200
GreedyLS_Edges_Random_start128,TSPB,46740,21068,25672,208,100,200
GreedyLS_Edges_Random_start129,TSPB,49325,22306,27019,202,100,200
GreedyLS_Edges_Random_start130,TSPB,48271,20678,27593,210,100,200
GreedyLS_Edges_Random_start131,TSPB,48192,22219,25973,207,100,200
GreedyLS_Edges_Random_start132,TSPB,46209,20326,25883,202,100,200
GreedyLS_Edges_Random_start133,TSPB,47264,20567,26697,194,100,200
GreedyLS_Edges_Random_start134,TSPB,47860,21883,25977,209,100,200
GreedyLS_Edges_Random_start135,TSPB,48640,22317,26323,187,100,200
GreedyLS_Edges_Random_start136,TSPB,50236,22032,28204,207,100,200
GreedyLS_Edges_Random_start137,TSPB,47734,21219,26515,201,100,200
GreedyLS_Edges_Random_start138,TSPB,48811,19532,29279,204,100,200
GreedyLS_Edges_Random_start139,TSPB,49148,22046,27102,192,100,200
GreedyLS_Edges_Random_start140,TSPB,45536,19310,26226,221,100,200
GreedyLS_Edges_Random_start141,TSPB,48457,21350,27107,211,100,200
GreedyLS_Edges_Random_start142,TSPB,48102,20866,27236,203,100,200
GreedyLS_Edges_Random_start143,TSPB,48160,22385,25775,202,100,200
GreedyLS_Edges_Random_start144,TSPB,48247,22396,25851,206,100,200
GreedyLS_Edges_Random_start145,TSPB,49306,21665,27641,199,100,200
GreedyLS_Edges_Random_start146,TSPB,48423,21714,26709,212,100,200
GreedyLS_Edges_Random_start147,TSPB,50089,22706,27383,180,100,200
GreedyLS_Edges_Random_start148,TSPB,48735,21835,26900,204,100,200
GreedyLS_Edges_Random_start149,TSPB,47646,22360,25286,218,100,200
GreedyLS_Edges_Random_start150,TSPB,47164,21106,26058,199,100,200
GreedyLS_Edges_Random_start151,TSPB,51754,20088,31666,200,100,200
GreedyLS_Edges_Random_start152,TSPB,47072,21354,25718,217,100,200
GreedyLS_Edges_Random_start153,TSPB,47686,22252,25434,215,100,200
GreedyLS_Edges_Random_start154,TSPB,50834,21613,29221,210,100,200
GreedyLS_Edges_Random_start155,TSPB,48606,21082,27524,206,100,200
GreedyLS_Edges_Random_start156,TSPB,49724,23485,26239,202,100,200
GreedyLS_Edges_Random_start157,TSPB,49427,20343,29084,200,100,200
GreedyLS_Edges_Random_start158,TSPB,47167,20856,26311,202,100,200
GreedyLS_Edges_Random_start159,TSPB,48302,21018,27284,196,100,200
GreedyLS_Edges_Random_start160,TSPB,47300,22196,25104,197,100,200
GreedyLS_Edges_Random_start161,TSPB,46965,20984,25981,216,100,200
GreedyLS_Edges_Random_start162,TSPB,49104,21459,27645,204,100,200
GreedyLS_Edges_Random_start163,TSPB,48387,22340,26047,194,100,200
GreedyLS_Edges_Random_start164,TSPB,48623,20938,27685,206,100,200
GreedyLS_Edges_Random_start165,TSPB,47015,20764,26251,220,100,200
GreedyLS_Edges_Random_start166,TSPB,50081,24182,25899,182,100,200
GreedyLS_Edges_Random_start167,TSPB,49141,20856,28285,191,100,200
GreedyLS_Edges_Random_start168,TSPB,47207,20300,26907,222,100,200
GreedyLS_Edges_Random_start169,TSPB,47737,20881,26856,208,100,200
GreedyLS_Edges_Random_start170,TSPB,47374,21345,26029,207,100,200
GreedyLS_Edges_Random_start171,TSPB,50393,21224,29169,194,100,200
GreedyLS_Edges_Random_start172,TSPB,48528,21040,27488,211,100,200
GreedyLS_Edges_Random_start173,TSPB,48169,23194,24975,202,100,200
GreedyLS_Edges_Random_start174,TSPB,48098,21252,26846,202,100,200
GreedyLS_Edges_Random_start175,TSPB,48759,21619,27140,197,100,200
GreedyLS_Edges_Random_start176,TSPB,49060,23345,25715,192,100,200
GreedyLS_Edges_Random_start177,TSPB,48760,22729,26031,211,100,200
GreedyLS_Edges_Random_start178,TSPB,48217,22440,25777,207,100,200
GreedyLS_Edges_Random_start179,TSPB,48190,21371,26819,207,100,200
GreedyLS_Edges_Random_start180,TSPB,46925,21379,25546,193,100,200
GreedyLS_Edges_Random_start181,TSPB,49248,22494,26754,213,100,200
GreedyLS_Edges_Random_start182,TSPB,46377,20447,25930,211,100,200
GreedyLS_Edges_Random_start183,TSPB,47956,21067,26889,200,100,200
GreedyLS_Edges_Random_start184,TSPB,47498,20981,26517,215,100,200
GreedyLS_Edges_Random_start185,TSPB,46640,19843,26797,218,100,200
GreedyLS_Edges_Random_start186,TSPB,47603,21019,26584,191,100,200
GreedyLS_Edges_Random_start187,TSPB,50357,21821,28536,195,100,200
GreedyLS_Edges_Random_start188,TSPB,49573,21452,28121,193,100,200
GreedyLS_Edges_Random_start189,TSPB,48222,21303,26919,217,100,200
GreedyLS_Edges_Random_start190,TSPB,48584,21499,27085,216,100,200
GreedyLS_Edges_Random_start191,TSPB,46824,21511,25313,213,100,200
GreedyLS_Edges_Random_start192,TSPB,47889,22249,25640,203,100,200
GreedyLS_Edges_Random_start193,TSPB,48005,22121,25884,219,100,200
GreedyLS_Edges_Random_start194,TSPB,46705,20625,26080,205,100,200
GreedyLS_Edges_Random_start195,TSPB,47445,19574,27871,216,100,200
GreedyLS_Edges_Random_start196,TSPB,47291,20672,26619,181,100,200
GreedyLS_Edges_Random_start197,TSPB,47737,21646,26091,196,100,200
GreedyLS_Edges_Random_start198,TSPB,49716,22007,27709,217,100,200
GreedyLS_Edges_Random_start199,TSPB,49375,22329,27046,208,100,200
GreedyLS_Edges_NearestNeighborAny2Regret_w1_1_start0,TSPB,45836,19071,26765,6,100,200
GreedyLS_Edges_NearestNeighborAny2Regret_w1_1_start1,TSPB,44456,20045,24411,8,100,200
GreedyLS_Edges_NearestNeighborAny2Regret_w1_1_start2,TSPB,45776,20626,25150,13,100,200
GreedyLS_Edges_NearestNeighborAny2Regret_w1_1_start3,TSPB,47478,20059,27419,16,100,200
GreedyLS_Edges_NearestNeighborAny2Regret_w1_1_start4,TSPB,46034,20188,25846,16,100,200
GreedyLS_Edges_NearestNeighborAny2Regret_w1_1_start5,TSPB,46441,19480,26961,11,100,200
GreedyLS_Edges_NearestNeighborAny2Regret_w1_1_start6,TSPB,45366,20368,24998,13,100,200
GreedyLS_Edges_NearestNeighborAny2Regret_w1_1_start7,TSPB,49381,19258,30123,14,100,200
GreedyLS_Edges_NearestNeighborAny2Regret_w1_1_start8,TSPB,45768,19226,26542,9,100,200
GreedyLS_Edges_NearestNeighborAny2Regret_w1_1_start9,TSPB,45774,20857,24917,14,100,200
GreedyLS_Edges_NearestNeighborAny2Regret_w1_1_start10,TSPB,46105,21359,24746,11,100,200
GreedyLS_Edges_NearestNeighborAny2Regret_w1_1_start11,TSPB,49046,20012,29034,19,100,200
GreedyLS_Edges_NearestNeighborAny2Regret_w1_1_start12,TSPB,46122,19073,27049,7,100,200
GreedyLS_Edges_NearestNeighborAny2Regret_w1_1_start13,TSPB,47493,19740,27753,14,100,200
GreedyLS_Edges_NearestNeighborAny2Regret_w1_1_start14,TSPB,47607,19845,27762,11,100,200
GreedyLS_Edges_NearestNeighborAny2Regret_w1_1_start15,TSPB,47289,19831,27458,18,100,200
GreedyLS_Edges_NearestNeighborAny2Regret_w1_1_start16,TSPB,44420,20009,24411,8,100,200
GreedyLS_Edges_NearestNeighborAny2Regret_w1_1_start17,TSPB,44546,20121,24425,15,100,200
GreedyLS_Edges_NearestNeighborAny2Regret_w1_1_start18,TSPB,45825,20013,25812,22,100,200
GreedyLS_Edges_NearestNeighborAny2Regret_w1_1_start19,TSPB,44320,20087,24233,12,100,200
GreedyLS_Edges_NearestNeighborAny2Regret_w1_1_start20,TSPB,47876,19964,27912,9,100,200
GreedyLS_Edges_NearestNeighborAny2Regret_w1_1_start21,TSPB,45414,19486,25928,18,100,200
GreedyLS_Edges_NearestNeighborAny2Regret_w1_1_start22,TSPB,47971,19858,28113,10,100,200
GreedyLS_Edges_NearestNeighborAny2Regret_w1_1_start23,TSPB,46346,19845,26501,23,100,200
GreedyLS_Edges_NearestNeighborAny2Regret_w1_1_start24,TSPB,44713,20207,24506,13,100,200
GreedyLS_Edges_NearestNeighborAny2Regret_w1_1_start25,TSPB,47769,19959,27810,10,100,200
GreedyLS_Edges_NearestNeighborAny2Regret_w1_1_start26,TSPB,44628,20257,24371,11,100,200
GreedyLS_Edges_NearestNeighborAny2Regret_w1_1_start27,TSPB,44772,19774,24998,12,100,200
GreedyLS_Edges_NearestNeighborAny2Regret_w1_1_start28,TSPB,45318,19852,25466,21,100,200
GreedyLS_Edges_NearestNeighborAny2Regret_w1_1_start29,TSPB,45804,19262,26542,9,100,200
GreedyLS_Edges_NearestNeighborAny2Regret_w1_1_start30,TSPB,44673,19944,24729,15,100,200
GreedyLS_Edges_NearestNeighborAny2Regret_w1_1_start31,TSPB,45110,19588,25522,12,100,200
GreedyLS_Edges_NearestNeighborAny2Regret_w1_1_start32,TSPB,47717,19551,28166,12,100,200
GreedyLS_Edges_NearestNeighborAny2Regret_w1_1_start33,TSPB,45804,19262,26542,7,100,200
GreedyLS_Edges_NearestNeighborAny2Regret_w1_1_start34,TSPB,45085,19722,25363,16,100,200
GreedyLS_Edges_NearestNeighborAny2Regret_w1_1_start35,TSPB,45804,19262,26542,7,100,200
GreedyLS_Edges_NearestNeighborAny2Regret_w1_1_start36,TSPB,47971,19858,28113,8,100,200
GreedyLS_Edges_NearestNeighborAny2Regret_w1_1_start37,TSPB,45748,21192,24556,23,100,200
GreedyLS_Edges_NearestNeighborAny2Regret_w1_1_start38,TSPB,44567,19982,24585,13,100,200
GreedyLS_Edges_NearestNeighborAny2Regret_w1_1_start39,TSPB,49904,20055,29849,13,100,200
GreedyLS_Edges_NearestNeighborAny2Regret_w1_1_start40,TSPB,47769,19959,27810,11,100,200
GreedyLS_Edges_NearestNeighborAny2Regret_w1_1_start41,TSPB,47451,19303,28148,10,100,200
GreedyLS_Edges_NearestNeighborAny2Regret_w1_1_start42,TSPB,44456,20045,24411,10,100,200
GreedyLS_Edges_NearestNeighborAny2Regret_w1_1_start43,TSPB,47047,19534,27513,17,100,200
GreedyLS_Edges_NearestNeighborAny2Regret_w1_1_start44,TSPB,47633,19830,27803,14,100,200
GreedyLS_Edges_NearestNeighborAny2Regret_w1_1_start45,TSPB,46565,19995,26570,12,100,200
GreedyLS_Edges_NearestNeighborAny2Regret_w1_1_start46,TSPB,46050,19325,26725,9,100,200
GreedyLS_Edges_NearestNeighborAny2Regret_w1_1_start47,TSPB,47884,19972,27912,12,100,200
GreedyLS_Edges_NearestNeighborAny2Regret_w1_1_start48,TSPB,51237,22217,29020,24,100,200
GreedyLS_Edges_NearestNeighborAny2Regret_w1_1_start49,TSPB,45882,19029,26853,8,100,200
GreedyLS_Edges_NearestNeighborAny2Regret_w1_1_start50,TSPB,47584,19589,27995,9,100,200
GreedyLS_Edges_NearestNeighborAny2Regret_w1_1_start51,TSPB,45504,19411,26093,12,100,200
GreedyLS_Edges_NearestNeighborAny2Regret_w1_1_start52,TSPB,48482,19880,28602,11,100,200
GreedyLS_Edges_NearestNeighborAny2Regret_w1_1_start53,TSPB,45833,20462,25371,14,100,200
GreedyLS_Edges_NearestNeighborAny2Regret_w1_1_start54,TSPB,45351,19862,25489,15,100,200
GreedyLS_Edges_NearestNeighborAny2Regret_w1_1_start55,TSPB,45410,19632,25778,24,100,200
GreedyLS_Edges_NearestNeighborAny2Regret_w1_1_start56,TSPB,46254,19767,26487,12,100,200
GreedyLS_Edges_NearestNeighborAny2Regret_w1_1_start57,TSPB,47876,19964,27912,9,100,200
GreedyLS_Edges_NearestNeighborAny2Regret_w1_1_start58,TSPB,47242,19769,27473,17,100,200
GreedyLS_Edges_NearestNeighborAny2Regret_w1_1_start59,TSPB,46857,20703,26154,18,100,200
GreedyLS_Edges_NearestNeighborAny2Regret_w1_1_start60,TSPB,46793,20927,25866,14,100,200
GreedyLS_Edges_NearestNeighborAny2Regret_w1_1_start61,TSPB,47717,19551,28166,10,100,200
GreedyLS_Edges_NearestNeighborAny2Regret_w1_1_start62,TSPB,45694,19445,26249,21,100,200
GreedyLS_Edges_NearestNeighborAny2Regret_w1_1_start63,TSPB,47717,19551,28166,11,100,200
GreedyLS_Edges_NearestNeighborAny2Regret_w1_1_start64,TSPB,45163,19821,25342,14,100,200
GreedyLS_Edges_NearestNeighborAny2Regret_w1_1_start65,TSPB,47641,19672,27969,18,100,200
GreedyLS_Edges_NearestNeighborAny2Regret_w1_1_start66,TSPB,47769,19959,27810,11,100,200
GreedyLS_Edges_NearestNeighborAny2Regret_w1_1_start67,TSPB,45547,20626,24921,11,100,200
GreedyLS_Edges_NearestNeighborAny2Regret_w1_1_start68,TSPB,50208,18989,31219,12,100,200
GreedyLS_Edges_NearestNeighborAny2Regret_w1_1_start69,TSPB,46150,20305,25845,8,100,200
GreedyLS_Edges_NearestNeighborAny2Regret_w1_1_start70,TSPB,47040,19548,27492,19,100,200
GreedyLS_Edges_NearestNeighborAny2Regret_w1_1_start71,TSPB,46088,19364,26724,12,100,200
GreedyLS_Edges_NearestNeighborAny2Regret_w1_1_start72,TSPB,44543,19882,24661,10,100,200
GreedyLS_Edges_NearestNeighborAny2Regret_w1_1_start73,TSPB,44938,19522,25416,10,100,200
GreedyLS_Edges_NearestNeighborAny2Regret_w1_1_start74,TSPB,46204,20500,25704,20,100,200
GreedyLS_Edges_NearestNeighborAny2Regret_w1_1_start75,TSPB,44614,20387,24227,15,100,200
GreedyLS_Edges_NearestNeighborAny2Regret_w1_1_start76,TSPB,50543,19281,31262,16,100,200
GreedyLS_Edges_NearestNeighborAny2Regret_w1_1_start77,TSPB,44420,20009,24411,8,100,200
GreedyLS_Edges_NearestNeighborAny2Regret_w1_1_start78,TSPB,46111,19636,26475,17,100,200
GreedyLS_Edges_NearestNeighborAny2Regret_w1_1_start79,TSPB,47776,20013,27763,11,100,200
GreedyLS_Edges_NearestNeighborAny2Regret_w1_1_start80,TSPB,46037,20652,25385,12,100,200
GreedyLS_Edges_NearestNeighborAny2Regret_w1_1_start81,TSPB,45396,19488,25908,22,100,200
GreedyLS_Edges_NearestNeighborAny2Regret_w1_1_start82,TSPB,45661,19249,26412,17,100,200
GreedyLS_Edges_NearestNeighborAny2Regret_w1_1_start83,TSPB,46752,20187,26565,16,100,200
GreedyLS_Edges_NearestNeighborAny2Regret_w1_1_start84,TSPB,45240,20031,25209,15,100,200
GreedyLS_Edges_NearestNeighborAny2Regret_w1_1_start85,TSPB,45633,19769,25864,9,100,200
GreedyLS_Edges_NearestNeighborAny2Regret_w1_1_start86,TSPB,47717,19551,28166,9,100,200
GreedyLS_Edges_NearestNeighborAny2Regret_w1_1_start87,TSPB,45678,19420,26258,12,100,200
GreedyLS_Edges_NearestNeighborAny2Regret_w1_1_start88,TSPB,47687,20060,27627,15,100,200
GreedyLS_Edges_NearestNeighborAny2Regret_w1_1_start89,TSPB,47769,19959,27810,12,100,200
GreedyLS_Edges_NearestNeighborAny2Regret_w1_1_start90,TSPB,44320,20087,24233,13,100,200
GreedyLS_Edges_NearestNeighborAny2Regret_w1_1_start91,TSPB,47769,19959,27810,12,100,200
GreedyLS_Edges_NearestNeighborAny2Regret_w1_1_start92,TSPB,47971,19858,28113,12,100,200
GreedyLS_Edges_NearestNeighborAny2Regret_w1_1_start93,TSPB,51413,20412,31001,11,100,200
GreedyLS_Edges_NearestNeighborAny2Regret_w1_1_start94,TSPB,47717,19551,28166,8,100,200
GreedyLS_Edges_NearestNeighborAny2Regret_w1_1_start95,TSPB,48889,20899,27990,22,100,200
GreedyLS_Edges_NearestNeighborAny2Regret_w1_1_start96,TSPB,47717,19551,28166,12,100,200
GreedyLS_Edges_NearestNeighborAny2Regret_w1_1_start97,TSPB,44719,19902,24817,9,100,200
GreedyLS_Edges_NearestNeighborAny2Regret_w1_1_start98,TSPB,45163,20005,25158,15,100,200
GreedyLS_Edges_NearestNeighborAny2Regret_w1_1_start99,TSPB,47876,19964,27912,10,100,200
GreedyLS_Edges_NearestNeighborAny2Regret_w1_1_start100,TSPB,47777,19967,27810,14,100,200
GreedyLS_Edges_NearestNeighborAny2Regret_w1_1_start101,TSPB,46529,20402,26127,18,100,200
GreedyLS_Edges_NearestNeighborAny2Regret_w1_1_start102,TSPB,47947,19781,28166,11,100,200
GreedyLS_Edges_NearestNeighborAny2Regret_w1_1_start103,TSPB,44452,19818,24634,8,100,200
GreedyLS_Edges_NearestNeighborAny2Regret_w1_1_start104,TSPB,45804,19262,26542,8,100,200
GreedyLS_Edges_NearestNeighborAny2Regret_w1_1_start105,TSPB,45074,19011,26063,15,100,200
GreedyLS_Edges_NearestNeighborAny2Regret_w1_1_start106,TSPB,45554,19718,25836,20,100,200
GreedyLS_Edges_NearestNeighborAny2Regret_w1_1_start107,TSPB,47717,19551,28166,11,100,200
GreedyLS_Edges_NearestNeighborAny2Regret_w1_1_start108,TSPB,46084,20282,25802,11,100,200
GreedyLS_Edges_NearestNeighborAny2Regret_w1_1_start109,TSPB,45804,19262,26542,7,100,200
GreedyLS_Edges_NearestNeighborAny2Regret_w1_1_start110,TSPB,45545,19309,26236,10,100,200
GreedyLS_Edges_NearestNeighborAny2Regret_w1_1_start111,TSPB,48918,18683,30235,11,100,200
GreedyLS_Edges_NearestNeighborAny2Regret_w1_1_start112,TSPB,44768,20108,24660,7,100,200
GreedyLS_Edges_NearestNeighborAny2Regret_w1_1_start113,TSPB,47733,19923,27810,12,100,200
GreedyLS_Edges_NearestNeighborAny2Regret_w1_1_start114,TSPB,45134,19696,25438,13,100,200
GreedyLS_Edges_NearestNeighborAny2Regret_w1_1_start115,TSPB,44821,20098,24723,14,100,200
GreedyLS_Edges_NearestNeighborAny2Regret_w1_1_start116,TSPB,45018,19634,25384,8,100,200
GreedyLS_Edges_NearestNeighborAny2Regret_w1_1_start117,TSPB,45200,19822,25378,18,100,200
GreedyLS_Edges_NearestNeighborAny2Regret_w1_1_start118,TSPB,45685,19884,25801,6,100,200
GreedyLS_Edges_NearestNeighborAny2Regret_w1_1_start119,TSPB,44983,19862,25121,20,100,200
GreedyLS_Edges_NearestNeighborAny2Regret_w1_1_start120,TSPB,45524,20603,24921,13,100,200
GreedyLS_Edges_NearestNeighborAny2Regret_w1_1_start121,TSPB,44320,20087,24233,16,100,200
GreedyLS_Edges_NearestNeighborAny2Regret_w1_1_start122,TSPB,48015,19849,28166,12,100,200
GreedyLS_Edges_NearestNeighborAny2Regret_w1_1_start123,TSPB,47857,20053,27804,16,100,200
GreedyLS_Edges_NearestNeighborAny2Regret_w1_1_start124,TSPB,45029,19538,25491,24,100,200
GreedyLS_Edges_NearestNeighborAny2Regret_w1_1_start125,TSPB,47668,19515,28153,9,100,200
GreedyLS_Edges_NearestNeighborAny2Regret_w1_1_start126,TSPB,47443,19599,27844,13,100,200
GreedyLS_Edges_NearestNeighborAny2Regret_w1_1_start127,TSPB,47876,19964,27912,9,100,200
GreedyLS_Edges_NearestNeighborAny2Regret_w1_1_start128,TSPB,45265,19638,25627,11,100,200
GreedyLS_Edges_NearestNeighborAny2Regret_w1_1_start129,TSPB,44533,19606,24927,11,100,200
GreedyLS_Edges_NearestNeighborAny2Regret_w1_1_start130,TSPB,45755,19873,25882,17,100,200
GreedyLS_Edges_NearestNeighborAny2Regret_w1_1_start131,TSPB,47733,19923,27810,10,100,200
GreedyLS_Edges_NearestNeighborAny2Regret_w1_1_start132,TSPB,47441,19516,27925,14,100,200
GreedyLS_Edges_NearestNeighborAny2Regret_w1_1_start133,TSPB,47331,19475,27856,11,100,200
GreedyLS_Edges_NearestNeighborAny2Regret_w1_1_start134,TSPB,45644,20454,25190,10,100,200
GreedyLS_Edges_NearestNeighborAny2Regret_w1_1_start135,TSPB,47717,19551,28166,9,100,200
GreedyLS_Edges_NearestNeighborAny2Regret_w1_1_start136,TSPB,45456,19638,25818,14,100,200
GreedyLS_Edges_NearestNeighborAny2Regret_w1_1_start137,TSPB,51672,21689,29983,27,100,200
GreedyLS_Edges_NearestNeighborAny2Regret_w1_1_start138,TSPB,49904,20208,29696,12,100,200
GreedyLS_Edges_NearestNeighborAny2Regret_w1_1_start139,TSPB,49143,19556,29587,9,100,200
GreedyLS_Edges_NearestNeighborAny2Regret_w1_1_start140,TSPB,47122,20770,26352,13,100,200
GreedyLS_Edges_NearestNeighborAny2Regret_w1_1_start141,TSPB,44420,20009,24411,9,100,200
GreedyLS_Edges_NearestNeighborAny2Regret_w1_1_start142,TSPB,45369,18482,26887,14,100,200
GreedyLS_Edges_NearestNeighborAny2Regret_w1_1_start143,TSPB,47791,19413,28378,12,100,200
GreedyLS_Edges_NearestNeighborAny2Regret_w1_1_start144,TSPB,45831,19073,26758,9,100,200
GreedyLS_Edges_NearestNeighborAny2Regret_w1_1_start145,TSPB,47478,19953,27525,17,100,200
GreedyLS_Edges_NearestNeighborAny2Regret_w1_1_start146,TSPB,46867,20034,26833,11,100,200
GreedyLS_Edges_NearestNeighborAny2Regret_w1_1_start147,TSPB,45216,19776,25440,13,100,200
GreedyLS_Edges_NearestNeighborAny2Regret_w1_1_start148,TSPB,47717,19551,28166,11,100,200
GreedyLS_Edges_NearestNeighborAny2Regret_w1_1_start149,TSPB,45640,19913,25727,21,100,200
GreedyLS_Edges_NearestNeighborAny2Regret_w1_1_start150,TSPB,45432,20141,25291,14,100,200
GreedyLS_Edges_NearestNeighborAny2Regret_w1_1_start151,TSPB,44320,20087,24233,16,100,200
GreedyLS_Edges_NearestNeighborAny2Regret_w1_1_start152,TSPB,45644,20454,25190,12,100,200
GreedyLS_Edges_NearestNeighborAny2Regret_w1_1_start153,TSPB,44456,20045,24411,8,100,200
GreedyLS_Edges_NearestNeighborAny2Regret_w1_1_start154,TSPB,45419,19765,25654,13,100,200
GreedyLS_Edges_NearestNeighborAny2Regret_w1_1_start155,TSPB,45273,19831,25442,13,100,200
GreedyLS_Edges_NearestNeighborAny2Regret_w1_1_start156,TSPB,44439,20314,24125,11,100,200
GreedyLS_Edges_NearestNeighborAny2Regret_w1_1_start157,TSPB,45923,19370,26553,11,100,200
GreedyLS_Edges_NearestNeighborAny2Regret_w1_1_start158,TSPB,47668,19515,28153,10,100,200
GreedyLS_Edges_NearestNeighborAny2Regret_w1_1_start159,TSPB,45675,18495,27180,19,100,200
GreedyLS_Edges_NearestNeighborAny2Regret_w1_1_start160,TSPB,49876,20180,29696,13,100,200
GreedyLS_Edges_NearestNeighborAny2Regret_w1_1_start161,TSPB,45472,19702,25770,10,100,200
GreedyLS_Edges_NearestNeighborAny2Regret_w1_1_start162,TSPB,45422,18468,26954,14,100,200
GreedyLS_Edges_NearestNeighborAny2Regret_w1_1_start163,TSPB,44488,19854,24634,8,100,200
GreedyLS_Edges_NearestNeighborAny2Regret_w1_1_start164,TSPB,45092,19766,25326,14,100,200
GreedyLS_Edges_NearestNeighborAny2Regret_w1_1_start165,TSPB,44571,20072,24499,8,100,200
GreedyLS_Edges_NearestNeighborAny2Regret_w1_1_start166,TSPB,47884,19972,27912,10,100,200
GreedyLS_Edges_NearestNeighborAny2Regret_w1_1_start167,TSPB,45865,20044,25821,15,100,200
GreedyLS_Edges_NearestNeighborAny2Regret_w1_1_start168,TSPB,47542,19776,27766,10,100,200
GreedyLS_Edges_NearestNeighborAny2Regret_w1_1_start169,TSPB,47569,19832,27737,11,100,200
GreedyLS_Edges_NearestNeighborAny2Regret_w1_1_start170,TSPB,45600,19582,26018,10,100,200
GreedyLS_Edges_NearestNeighborAny2Regret_w1_1_start171,TSPB,45768,19125,26643,17,100,200
GreedyLS_Edges_NearestNeighborAny2Regret_w1_1_start172,TSPB,44452,19818,24634,7,100,200
GreedyLS_Edges_NearestNeighborAny2Regret_w1_1_start173,TSPB,44723,19820,24903,7,100,200
GreedyLS_Edges_NearestNeighborAny2Regret_w1_1_start174,TSPB,45490,19890,25600,24,100,200
GreedyLS_Edges_NearestNeighborAny2Regret_w1_1_start175,TSPB,45947,19356,26591,13,100,200
GreedyLS_Edges_NearestNeighborAny2Regret_w1_1_start176,TSPB,47716,19603,28113,12,100,200
GreedyLS_Edges_NearestNeighborAny2Regret_w1_1_start177,TSPB,45864,18907,26957,12,100,200
GreedyLS_Edges_NearestNeighborAny2Regret_w1_1_start178,TSPB,44822,20148,24674,11,100,200
GreedyLS_Edges_NearestNeighborAny2Regret_w1_1_start179,TSPB,44420,20009,24411,9,100,200
GreedyLS_Edges_NearestNeighborAny2Regret_w1_1_start180,TSPB,47679,20052,27627,12,100,200
GreedyLS_Edges_NearestNeighborAny2Regret_w1_1_start181,TSPB,48569,19963,28606,12,100,200
GreedyLS_Edges_NearestNeighborAny2Regret_w1_1_start182,TSPB,48695,19265,29430,19,100,200
GreedyLS_Edges_NearestNeighborAny2Regret_w1_1_start183,TSPB,45403,19972,25431,24,100,200
GreedyLS_Edges_NearestNeighborAny2Regret_w1_1_start184,TSPB,45936,20967,24969,13,100,200
GreedyLS_Edges_NearestNeighborAny2Regret_w1_1_start185,TSPB,47668,19515,28153,10,100,200
GreedyLS_Edges_NearestNeighborAny2Regret_w1_1_start186,TSPB,44452,19818,24634,9,100,200
GreedyLS_Edges_NearestNeighborAny2Regret_w1_1_start187,TSPB,46361,19844,26517,8,100,200
GreedyLS_Edges_NearestNeighborAny2Regret_w1_1_start188,TSPB,47489,19723,27766,19,100,200
GreedyLS_Edges_NearestNeighborAny2Regret_w1_1_start189,TSPB,46327,19985,26342,18,100,200
GreedyLS_Edges_NearestNeighborAny2Regret_w1_1_start190,TSPB,45216,19776,25440,11,100,200
GreedyLS_Edges_NearestNeighborAny2Regret_w1_1_start191,TSPB,45548,18410,27138,14,100,200
GreedyLS_Edges_NearestNeighborAny2Regret_w1_1_start192,TSPB,45583,20181,25402,12,100,200
GreedyLS_Edges_NearestNeighborAny2Regret_w1_1_start193,TSPB,44580,19441,25139,12,100,200
GreedyLS_Edges_NearestNeighborAny2Regret_w1_1_start194,TSPB,47717,19551,28166,8,100,200
GreedyLS_Edges_NearestNeighborAny2Regret_w1_1_start195,TSPB,47729,19906,27823,12,100,200
GreedyLS_Edges_NearestNeighborAny2Regret_w1_1_start196,TSPB,45591,19639,25952,17,100,200
GreedyLS_Edges_NearestNeighborAny2Regret_w1_1_start197,TSPB,44895,19843,25052,8,100,200
GreedyLS_Edges_NearestNeighborAny2Regret_w1_1_start198,TSPB,44667,19556,25111,8,100,200
GreedyLS_Edges_NearestNeighborAny2Regret_w1_1_start199,TSPB,44943,19740,25203,19,100,200
